name,Size,Ties,Pairs,Density,WeakComp,nWeakComp,2StepReach,ReachEffic,Broker,nBroker,EgoBetween,nEgoBetween,Closeness_Centrality,Betweenness_Centrality,in_degree,out_degree,degree
org.apache.camel.component.irc.IrcErrorLogger,1,0,0,0,1,1.0,-1,-1.0,0,0,0.0,0.0,0.002158894645941278,0.0,1,0,1
org.apache.camel.ProducerTemplate,4,6,12,0.5,1,0.25,203,50.75,6,0.5,0.0,0.0,0.004145077720207254,0.00022362923627086334,3,3,6
org.apache.camel.impl.JndiRegistry,2,1,2,0.5,1,0.5,0,0.0,1,0.5,0.0,0.0,0.17638931898587457,2.1732275564537488e-05,3,1,4
org.apache.camel.component.cxf.CxfSoapConsumer,5,10,20,0.5,1,0.2,204,40.8,10,0.5,0.0,0.0,0.0,0.0,0,4,4
org.apache.camel.processor.TryProcessor,6,9,30,0.3,1,0.16666666666666666,202,33.666666666666664,21,0.7,0.0,0.0,0.11918716151267203,5.285260751474498e-06,1,5,6
org.apache.camel.component.cxf.AsyncProcessorDecorator,5,9,20,0.45,1,0.2,203,40.6,11,0.55,0.0,0.0,0.0,0.0,0,4,4
org.apache.camel.component.cxf.interceptors.DOMOutInterceptor,4,6,12,0.5,1,0.25,208,52.0,6,0.5,0.6666666666666666,0.16666666666666666,0.004145077720207254,5.697331928708103e-05,4,3,7
org.apache.camel.builder.xml.Namespaces,2,1,2,0.5,1,0.5,0,0.0,1,0.5,0.0,0.0,0.002072538860103627,4.299873153741965e-06,1,1,2
org.apache.camel.component.file.strategy.DefaultFileRenamer,2,1,2,0.5,1,0.5,0,0.0,1,0.5,0.0,0.0,0.0058320279551753226,0.0,2,1,3
org.apache.camel.processor.resequencer.Timeout,2,2,2,1.0,1,0.5,0,0.0,0,0.0,0.0,0.0,0.09576821919843591,0.0,3,1,4
org.apache.camel.component.seda.SedaEndpoint,9,13,72,0.18055555555555555,1,0.1111111111111111,218,24.22222222222222,59,0.8194444444444444,0.3571428571428571,0.03968253968253968,0.004317789291882556,0.00024652606081453934,4,8,12
org.apache.camel.model.ChoiceType,13,43,156,0.27564102564102566,1,0.07692307692307693,202,15.538461538461538,113,0.7243589743589743,0.1893939393939394,0.014568764568764568,0.14218819268178418,0.002226732623658303,5,13,18
org.apache.camel.component.file.remote.FtpProducer,8,17,56,0.30357142857142855,1,0.125,240,30.0,39,0.6964285714285714,0.09523809523809523,0.011904761904761904,0.003573342862247633,2.230559198503644e-05,1,7,8
org.apache.camel.management.InstrumentationAgentImpl,9,18,72,0.25,1,0.1111111111111111,212,23.555555555555557,54,0.75,0.0,0.0,0.0028209556706966033,0.0002447549225869266,1,8,9
org.apache.camel.CamelExchangeException,3,3,6,0.5,1,0.3333333333333333,202,67.33333333333333,3,0.5,0.0,0.0,0.09786499236225346,0.0003436412109279629,6,2,8
org.apache.camel.model.WhenType,6,12,30,0.4,1,0.16666666666666666,202,33.666666666666664,18,0.6,0.0,0.0,0.11959302017843594,2.5378326014707238e-05,2,5,7
org.apache.camel.model.ThrottlerType,6,15,30,0.5,1,0.16666666666666666,202,33.666666666666664,15,0.5,0.15000000000000002,0.025000000000000005,0.14188183514301383,0.001760255731617408,2,6,8
org.apache.camel.component.mail.MessageHeaderAccessException,2,1,2,0.5,1,0.5,0,0.0,1,0.5,0.0,0.0,0.0037996545768566492,1.1645489791384487e-06,1,1,2
org.apache.camel.processor.ChoiceProcessor,7,12,42,0.2857142857142857,1,0.14285714285714285,202,28.857142857142858,30,0.7142857142857143,0.0,0.0,0.1196201757234356,1.0784346744818263e-05,2,6,8
org.apache.camel.processor.loadbalancer.TopicLoadBalancer,4,6,12,0.5,1,0.25,205,51.25,6,0.5,0.0,0.0,0.01885860720899347,7.632274847891988e-05,1,3,4
org.apache.camel.component.jms.JmsEndpoint,13,29,156,0.1858974358974359,1,0.07692307692307693,230,17.692307692307693,127,0.8141025641025641,0.21212121212121213,0.016317016317016316,0.0062176165803108805,0.00035987378848514445,6,12,18
org.apache.camel.language.simple.SimpleLanguage,5,7,20,0.35,1,0.2,4,0.8,13,0.65,0.0,0.0,0.0,0.0,0,4,4
org.apache.camel.component.cxf.phase.AbstractPhaseManagerImpl,1,0,0,0,1,1.0,-1,-1.0,0,0,0.0,0.0,0.005313893240149415,0.0,5,0,5
org.apache.camel.util.ReportingTypeConverterLoader,4,4,12,0.3333333333333333,1,0.25,14,3.5,8,0.6666666666666666,0.0,0.0,0.0,0.0,0,3,3
org.apache.camel.model.language.RubyExpression,2,1,2,0.5,1,0.5,203,101.5,1,0.5,0.0,0.0,0.0,0.0,0,1,1
org.apache.camel.impl.DefaultEndpoint,10,28,90,0.3111111111111111,1,0.1,209,20.9,62,0.6888888888888889,0.0,0.0,0.11421653610981511,0.004736223878076696,17,9,26
org.apache.camel.Converter,1,0,0,0,1,1.0,-1,-1.0,0,0,0.0,0.0,0.12174544460683605,0.0,14,0,14
org.apache.camel.processor.validation.ValidatingProcessor,5,9,20,0.45,1,0.2,208,41.6,11,0.55,0.0,0.0,0.003388881109088363,0.0003915392829244871,2,4,6
org.apache.camel.impl.DefaultLifecycleStrategy,6,13,30,0.43333333333333335,1,0.16666666666666666,202,33.666666666666664,17,0.5666666666666667,0.0,0.0,0.16782645870850918,4.590400068545963e-05,1,5,6
org.apache.camel.impl.CachingInjector,2,1,2,0.5,1,0.5,2,1.0,1,0.5,0.0,0.0,0.11725675190035802,2.1499365768709824e-06,2,1,3
org.apache.camel.Headers,1,0,0,0,1,1.0,-1,-1.0,0,0,0.0,0.0,0.09097399868481046,0.0,2,0,2
org.apache.camel.component.irc.IrcBinding,3,8,6,1.3333333333333333,1,0.3333333333333333,209,69.66666666666667,-2,-0.3333333333333333,0.0,0.0,0.004616109279321714,0.0,3,2,5
org.apache.camel.bam.processor.ProcessContext,6,18,30,0.6,1,0.16666666666666666,225,37.5,12,0.4,0.05,0.008333333333333333,0.005699481865284974,3.6086941387610016e-05,2,5,7
org.apache.camel.processor.resequencer.ResequencerEngine,7,13,42,0.30952380952380953,1,0.14285714285714285,5,0.7142857142857143,29,0.6904761904761905,0.0,0.0,0.10291954224872285,0.0037328273815922432,1,6,7
org.apache.camel.RuntimeCamelException,1,0,0,0,1,1.0,-1,-1.0,0,0,0.0,0.0,0.1580203247535646,0.0,16,0,16
org.apache.camel.processor.resequencer.Element,3,4,6,0.6666666666666666,1,0.3333333333333333,1,0.3333333333333333,2,0.3333333333333333,0.0,0.0,0.095997377365348,8.993901346576944e-05,16,2,18
org.apache.camel.impl.converter.ArrayTypeConverter,2,1,2,0.5,1,0.5,0,0.0,1,0.5,0.0,0.0,0.13771793805075452,0.0,1,1,2
org.apache.camel.management.PerformanceCounter,2,1,2,0.5,1,0.5,0,0.0,1,0.5,0.0,0.0,0.004521902967498823,1.2899619461225896e-05,3,1,4
org.apache.camel.component.direct.DirectEndpoint,7,7,42,0.16666666666666666,1,0.14285714285714285,217,31.0,35,0.8333333333333334,0.16666666666666666,0.023809523809523808,0.0010362694300518134,2.1678527150115736e-05,1,6,7
org.apache.camel.spring.spi.SpringTransactionPolicy,3,3,6,0.5,1,0.3333333333333333,203,67.66666666666667,3,0.5,0.0,0.0,0.0,0.0,0,2,2
org.apache.camel.builder.NoErrorHandlerBuilder,4,6,12,0.5,1,0.25,202,50.5,6,0.5,0.0,0.0,0.17015738174612738,0.0008272990073777014,2,3,5
org.apache.camel.processor.loadbalancer.LoadBalancer,2,1,2,0.5,1,0.5,203,101.5,1,0.5,0.0,0.0,0.023226252158894647,0.0,3,1,4
org.apache.camel.spring.remoting.CamelProxyFactoryBean,5,8,20,0.4,1,0.2,210,42.0,12,0.6,0.0,0.0,0.001865284974093264,3.137643189886649e-05,1,4,5
org.apache.camel.processor.Throttler,4,7,12,0.5833333333333334,1,0.25,202,50.5,5,0.4166666666666667,0.0,0.0,0.11918716151267203,0.0010014177006726541,1,3,4
org.apache.camel.model.language.ELExpression,2,1,2,0.5,1,0.5,203,101.5,1,0.5,0.0,0.0,0.0,0.0,0,1,1
org.apache.camel.processor.Delayer,5,9,20,0.45,1,0.2,202,40.4,11,0.55,0.08333333333333333,0.016666666666666666,0.11951162746960307,0.0013853605410255303,2,4,6
org.apache.camel.spring.EndpointFactoryBean,7,9,42,0.21428571428571427,1,0.14285714285714285,204,29.142857142857142,33,0.7857142857142857,0.0,0.0,0.001865284974093264,1.5605964587969622e-05,1,6,7
org.apache.camel.ExchangePattern,1,1,0,0,1,1.0,-1,-1.0,-1,0,0.0,0.0,0.2948062545232267,0.0,48,1,49
org.apache.camel.component.cxf.spring.CxfEndpointBean,1,0,0,0,1,1.0,-1,-1.0,0,0,0.0,0.0,0.007335162044092249,0.0,5,0,5
org.apache.camel.model.RedeliveryPolicyType,2,3,2,1.5,1,0.5,0,0.0,-1,-0.5,0.0,0.0,0.16416594479884844,0.0,2,2,4
org.apache.camel.processor.loadbalancer.LoadBalancerSupport,3,3,6,0.5,1,0.3333333333333333,204,68.0,3,0.5,0.0,0.0,0.01813056994818653,5.374841442177456e-06,2,2,4
org.apache.camel.component.cxf.transport.CamelConstants,1,0,0,0,1,1.0,-1,-1.0,0,0,0.0,0.0,0.0037009622501850484,0.0,3,0,3
org.apache.camel.processor.DeadLetterChannel,13,28,156,0.1794871794871795,1,0.07692307692307693,204,15.692307692307692,128,0.8205128205128205,0.06439393939393939,0.004953379953379953,0.0010362694300518134,0.00018763571474641498,1,12,13
org.apache.camel.component.cxf.util.UriUtils,1,0,0,0,1,1.0,-1,-1.0,0,0,0.0,0.0,0.004210872604654988,0.0,1,0,1
org.apache.camel.processor.resequencer.SequenceSender,3,4,6,0.6666666666666666,1,0.3333333333333333,202,67.33333333333333,2,0.3333333333333333,0.0,0.0,0.10279165929483129,0.0,1,2,3
org.apache.camel.processor.Interceptor,4,5,12,0.4166666666666667,1,0.25,202,50.5,7,0.5833333333333334,0.0,0.0,0.1700475319193061,6.186954389607411e-05,3,3,6
org.apache.camel.spi.InstrumentationAgent,2,1,2,0.5,1,0.5,209,104.5,1,0.5,0.0,0.0,0.005595854922279792,3.9604903083930454e-05,4,1,5
org.apache.camel.ResolveEndpointFailedException,2,1,2,0.5,1,0.5,0,0.0,1,0.5,0.0,0.0,0.1680833631443507,0.00029433655516686167,1,1,2
org.apache.camel.component.file.FileEndpoint,15,34,210,0.1619047619047619,1,0.06666666666666667,226,15.066666666666666,176,0.8380952380952381,0.43131868131868134,0.028754578754578757,0.00932642487046632,0.0011305093353146307,8,14,22
org.apache.camel.language.juel.JuelLanguage,4,5,12,0.4166666666666667,1,0.25,2,0.5,7,0.5833333333333334,0.0,0.0,0.0,0.0,0,3,3
org.apache.camel.impl.DefaultProducer,5,9,20,0.45,1,0.2,203,40.6,11,0.55,0.0,0.0,0.010689937278429233,5.973240456073214e-05,5,4,9
org.apache.camel.model.ExceptionType,9,25,72,0.3472222222222222,1,0.1111111111111111,202,22.444444444444443,47,0.6527777777777778,0.26785714285714285,0.02976190476190476,0.21038628350080288,0.03251998925495688,8,9,17
org.apache.camel.spring.SpringRouteBuilder,3,3,6,0.5,1,0.3333333333333333,226,75.33333333333333,3,0.5,0.0,0.0,0.0010362694300518134,0.00010418874190830417,1,2,3
org.apache.camel.impl.MessageSupport,4,7,12,0.5833333333333334,1,0.25,204,51.0,5,0.4166666666666667,0.0,0.0,0.11105880683924926,0.0004712481815119787,6,3,9
org.apache.camel.builder.ExpressionClause,4,5,12,0.4166666666666667,1,0.25,203,50.75,7,0.5833333333333334,0.0,0.0,0.0,0.0,0,3,3
org.apache.camel.management.Counter,1,0,0,0,1,1.0,-1,-1.0,0,0,0.0,0.0,0.0038071637756251406,0.0,1,0,1
org.apache.camel.language.juel.JuelExpression,2,3,2,1.5,1,0.5,203,101.5,-1,-0.5,0.0,0.0,0.0010362694300518134,9.137230451701676e-06,2,2,4
org.apache.camel.processor.resequencer.TimeoutHandler,2,2,2,1.0,1,0.5,0,0.0,0,0.0,0.0,0.0,0.09576821919843591,0.0,3,1,4
org.apache.camel.component.file.strategy.RenameFileProcessStrategy,6,12,30,0.4,1,0.16666666666666666,226,37.666666666666664,18,0.6,0.05,0.008333333333333333,0.006623113313809417,1.934942919183884e-05,1,5,6
org.apache.camel.component.cxf.invoker.CxfClient,5,11,20,0.55,1,0.2,204,40.8,9,0.45,0.0,0.0,0.004607413312076525,4.83735729795971e-06,2,4,6
org.apache.camel.bam.processor.BamProcessorSupport,5,7,20,0.35,1,0.2,204,40.8,13,0.65,0.25,0.05,0.003367875647668394,0.00024119551751611604,2,4,6
org.apache.camel.Properties,1,0,0,0,1,1.0,-1,-1.0,0,0,0.0,0.0,0.14159108233812434,0.0,7,0,7
org.apache.camel.spring.CamelProxyFactoryType,2,1,2,0.5,1,0.5,0,0.0,1,0.5,0.0,0.0,0.0025906735751295338,0.0,1,1,2
org.apache.camel.util.ExpressionComparator,1,0,0,0,1,1.0,-1,-1.0,0,0,0.0,0.0,0.11542189433312089,0.0,2,0,2
org.apache.camel.component.jdbc.JdbcComponent,5,9,20,0.45,1,0.2,217,43.4,11,0.55,0.25,0.05,0.001381692573402418,0.00011529034893470642,1,4,5
org.apache.camel.component.validator.jing.JingValidator,4,6,12,0.5,1,0.25,207,51.75,6,0.5,0.0,0.0,0.002072538860103627,0.00016633854539386327,2,3,5
org.apache.camel.language.ognl.RootObject,4,8,12,0.6666666666666666,1,0.25,203,50.75,4,0.3333333333333333,0.0,0.0,0.001381692573402418,8.547960136763268e-05,1,3,4
org.apache.camel.NoTypeConversionAvailableException,2,1,2,0.5,1,0.5,0,0.0,1,0.5,0.0,0.0,0.0,0.0,0,1,1
org.apache.camel.view.XmlGraphGenerator,7,15,42,0.35714285714285715,1,0.14285714285714285,206,29.428571428571427,27,0.6428571428571429,0.0,0.0,0.0010362694300518134,1.62678534316571e-05,1,6,7
org.apache.camel.model.TryType,9,24,72,0.3333333333333333,1,0.1111111111111111,202,22.444444444444443,48,0.6666666666666666,0.3571428571428571,0.03968253968253968,0.14188183514301383,0.0023368057368498103,1,8,9
org.apache.camel.component.mail.MailBinding,6,13,30,0.43333333333333335,1,0.16666666666666666,224,37.333333333333336,17,0.5666666666666667,0.30000000000000004,0.05000000000000001,0.00545404963185165,5.460838905252295e-05,2,5,7
org.apache.camel.impl.ScheduledPollConsumer,4,6,12,0.5,1,0.25,204,51.0,6,0.5,0.0,0.0,0.015852394793377987,0.00017597556123835365,5,3,8
org.apache.camel.language.ognl.OgnlExpression,7,10,42,0.23809523809523808,1,0.14285714285714285,208,29.714285714285715,32,0.7619047619047619,0.16666666666666666,0.023809523809523808,0.0010362694300518134,0.00022036849912927567,1,6,7
org.apache.camel.processor.Resequencer,5,6,20,0.3,1,0.2,202,40.4,14,0.7,0.16666666666666666,0.03333333333333333,0.11953874605990705,0.001349828721719376,2,4,6
org.apache.camel.impl.converter.TypeConverterLoader,2,1,2,0.5,1,0.5,2,1.0,1,0.5,0.0,0.0,0.138696879725568,0.0,2,1,3
org.apache.camel.component.file.strategy.FileProcessStrategy,2,2,2,1.0,1,0.5,226,113.0,0,0.0,0.0,0.0,0.006924163918982572,0.0,3,1,4
org.apache.camel.component.bean.MethodInfo,6,7,30,0.23333333333333334,1,0.16666666666666666,202,33.666666666666664,23,0.7666666666666667,0.0,0.0,0.09067250497177459,0.0,1,5,6
org.apache.camel.model.OtherwiseType,4,4,12,0.3333333333333333,1,0.25,202,50.5,8,0.6666666666666666,0.0,0.0,0.2097162634896538,0.0011937057941266388,7,3,10
org.apache.camel.model.BeanRef,7,10,42,0.23809523809523808,1,0.14285714285714285,202,28.857142857142858,32,0.7619047619047619,0.0,0.0,0.14192005762015364,0.014292986039298905,1,6,7
org.apache.camel.component.cxf.interceptors.DOMInInterceptor,7,11,42,0.2619047619047619,1,0.14285714285714285,267,38.142857142857146,31,0.7380952380952381,0.0,0.0,0.0029892387405340776,4.8373572979597104e-05,1,6,7
org.apache.camel.component.mina.MinaExchange,4,6,12,0.5,1,0.25,207,51.75,6,0.5,0.0,0.0,0.005246113989637305,0.00013141921656745472,2,3,5
org.apache.camel.builder.ProcessorFactory,2,1,2,0.5,1,0.5,202,101.0,1,0.5,0.0,0.0,0.13279739195513243,0.0,1,1,2
org.apache.camel.component.event.EventEndpoint,10,19,90,0.2111111111111111,1,0.1,221,22.1,71,0.7888888888888889,0.3194444444444444,0.03194444444444444,0.024649127219679056,0.001001333681520499,4,9,13
org.apache.camel.converter.ObjectConverter,2,1,2,0.5,1,0.5,0,0.0,1,0.5,0.0,0.0,0.0,0.0,0,1,1
org.apache.camel.util.FactoryFinder,4,3,12,0.25,1,0.25,2,0.5,9,0.75,0.0,0.0,0.16937672663119407,0.0007045751674135136,4,3,7
org.apache.camel.impl.ReflectionInjector,3,2,6,0.3333333333333333,1,0.3333333333333333,1,0.3333333333333333,4,0.6666666666666666,0.0,0.0,0.17164719026882908,0.00015977060727990607,5,2,7
org.apache.camel.converter.jaxb.LongHeader,2,1,2,0.5,1,0.5,0,0.0,1,0.5,0.0,0.0,0.0015544041450777201,0.0,1,1,2
org.apache.camel.model.language.JavaScriptExpression,2,1,2,0.5,1,0.5,203,101.5,1,0.5,0.0,0.0,0.0,0.0,0,1,1
org.apache.camel.spi.ComponentResolver,3,4,6,0.6666666666666666,1,0.3333333333333333,202,67.33333333333333,2,0.3333333333333333,0.0,0.0,0.16830902680064228,0.0,3,2,5
org.apache.camel.InvalidPayloadException,4,7,12,0.5833333333333334,1,0.25,202,50.5,5,0.4166666666666667,0.0,0.0,0.09981190865593224,0.0006302929669164828,6,3,9
org.apache.camel.converter.jaxb.JaxbDataFormat,4,5,12,0.4166666666666667,1,0.25,204,51.0,7,0.5833333333333334,0.0,0.0,0.0,0.0,0,3,3
org.apache.camel.component.cxf.CxfSoapProducer,7,19,42,0.4523809523809524,1,0.14285714285714285,204,29.142857142857142,23,0.5476190476190477,0.0,0.0,0.0,0.0,0,6,6
org.apache.camel.converter.jaxb.StringHeader,2,1,2,0.5,1,0.5,0,0.0,1,0.5,0.0,0.0,0.0015544041450777201,0.0,1,1,2
org.apache.camel.bam.TimeExpression,8,24,56,0.42857142857142855,1,0.125,225,28.125,32,0.5714285714285714,0.2698412698412698,0.03373015873015873,0.004478164322723908,0.00010026971539945144,3,8,11
org.apache.camel.processor.UnitOfWorkProcessor,5,9,20,0.45,1,0.2,205,41.0,11,0.55,0.0,0.0,0.0,0.0,0,4,4
org.apache.camel.impl.SerializationDataFormat,4,5,12,0.4166666666666667,1,0.25,202,50.5,7,0.5833333333333334,0.0,0.0,0.1027515611246363,0.0008061238383943866,1,3,4
org.apache.camel.processor.MulticastProcessor,6,10,30,0.3333333333333333,1,0.16666666666666666,202,33.666666666666664,20,0.6666666666666666,0.0,0.0,0.11986513171467812,2.401783201837835e-05,3,5,8
org.apache.camel.impl.DefaultCamelContext,27,81,702,0.11538461538461539,1,0.037037037037037035,202,7.481481481481482,621,0.8846153846153846,0.2469230769230769,0.009145299145299145,0.216882360595311,0.035969916883374024,48,26,74
org.apache.camel.component.irc.IrcConsumer,4,9,12,0.75,1,0.25,224,56.0,3,0.25,0.16666666666666666,0.041666666666666664,0.002763385146804836,3.224904865306474e-06,2,3,5
org.apache.camel.spring.CamelContextFactoryBean,13,26,156,0.16666666666666666,1,0.07692307692307693,240,18.46153846153846,130,0.8333333333333334,0.0,0.0,0.003316062176165803,0.0006698105688710466,3,12,15
org.apache.camel.converter.jaxb.MessageType,6,9,30,0.3,1,0.16666666666666666,207,34.5,21,0.7,0.0,0.0,0.001381692573402418,8.59974630748393e-06,1,5,6
org.apache.camel.component.file.remote.RemoteFileEndpoint,7,13,42,0.30952380952380953,1,0.14285714285714285,240,34.285714285714285,29,0.6904761904761905,0.13333333333333333,0.019047619047619046,0.010362694300518135,0.0002804018428799346,10,6,16
org.apache.camel.processor.Splitter,6,7,30,0.23333333333333334,1,0.16666666666666666,202,33.666666666666664,23,0.7666666666666667,0.0,0.0,0.1196201757234356,1.1877231171394346e-05,2,5,7
org.apache.camel.model.ServiceActivationType,2,1,2,0.5,1,0.5,202,101.0,1,0.5,0.0,0.0,0.15891621535022937,0.0003128232380128013,1,1,2
org.apache.camel.util.jndi.CamelInitialContextFactory,2,2,2,1.0,1,0.5,8,4.0,0,0.0,0.0,0.0,0.0,0.0,0,1,1
org.apache.camel.builder.xml.StreamResultHandlerFactory,4,5,12,0.4166666666666667,1,0.25,206,51.5,7,0.5833333333333334,0.0,0.0,0.0010362694300518134,1.0749682884354912e-06,1,3,4
org.apache.camel.component.cxf.CxfConsumer,8,16,56,0.2857142857142857,1,0.125,267,33.375,40,0.7142857142857143,0.38095238095238093,0.047619047619047616,0.006135805835833106,0.0004983463136022635,3,7,10
org.apache.camel.model.FromType,4,5,12,0.4166666666666667,1,0.25,202,50.5,7,0.5833333333333334,0.16666666666666666,0.041666666666666664,0.17438174574181078,0.00017326933800554045,8,3,11
org.apache.camel.component.mail.MailProducer,4,4,12,0.3333333333333333,1,0.25,226,56.5,8,0.6666666666666666,0.0,0.0,0.0,0.0,0,3,3
org.apache.camel.processor.LoggingLevel,1,0,0,0,1,1.0,-1,-1.0,0,0,0.0,0.0,0.1699215215061738,0.0,7,0,7
org.apache.camel.processor.validation.NoXmlBodyValidationException,3,4,6,0.6666666666666666,1,0.3333333333333333,204,68.0,2,0.3333333333333333,0.0,0.0,0.003045363223009411,3.2249048653064734e-05,1,2,3
org.apache.camel.util.LRUCache,1,0,0,0,1,1.0,-1,-1.0,0,0,0.0,0.0,0.0015544041450777201,0.0,1,0,1
org.apache.camel.EndpointInject,1,0,0,0,1,1.0,-1,-1.0,0,0,0.0,0.0,0.003316062176165803,0.0,3,0,3
org.apache.camel.component.cxf.CxfSoapComponent,7,11,42,0.2619047619047619,1,0.14285714285714285,216,30.857142857142858,31,0.7380952380952381,0.0,0.0,0.0,0.0,0,6,6
org.apache.camel.builder.xml.XPathBuilder,12,20,132,0.15151515151515152,1,0.08333333333333333,209,17.416666666666668,112,0.8484848484848485,0.0,0.0,0.00233160621761658,0.00048469552291064555,3,12,15
org.apache.camel.builder.xml.ResultHandlerFactory,2,1,2,0.5,1,0.5,204,102.0,1,0.5,0.0,0.0,0.004145077720207254,0.0,4,1,5
org.apache.camel.model.language.SqlExpression,2,1,2,0.5,1,0.5,203,101.5,1,0.5,0.0,0.0,0.0,0.0,0,1,1
org.apache.camel.management.InstrumentationProcessor,3,3,6,0.5,1,0.3333333333333333,205,68.33333333333333,3,0.5,0.0,0.0,0.0023982235381199107,3.224904865306474e-06,1,2,3
org.apache.camel.component.cxf.invoker.CxfClientFactoryBean,3,3,6,0.5,1,0.3333333333333333,205,68.33333333333333,3,0.5,0.0,0.0,0.004145077720207254,8.95806907029576e-07,1,2,3
org.apache.camel.component.file.remote.RemoteFileExchange,5,9,20,0.45,1,0.2,209,41.8,11,0.55,0.25,0.05,0.00921734387782929,0.0008396901626155438,7,4,11
org.apache.camel.component.event.CamelEvent,3,5,6,0.8333333333333334,1,0.3333333333333333,221,73.66666666666667,1,0.16666666666666666,0.0,0.0,0.0185997077188787,2.5530496850342916e-05,2,2,4
org.apache.camel.impl.converter.AnnotationTypeConverterLoader,10,16,90,0.17777777777777778,1,0.1,12,1.2,74,0.8222222222222222,0.0,0.0,0.13841837960725442,0.006084182302336369,3,9,12
org.apache.camel.impl.converter.PropertyEditorTypeConverter,3,2,6,0.3333333333333333,1,0.3333333333333333,1,0.3333333333333333,4,0.6666666666666666,0.0,0.0,0.13771793805075452,0.0,1,2,3
org.apache.camel.spi.Registry,1,0,0,0,1,1.0,-1,-1.0,0,0,0.0,0.0,0.2582643368656502,0.0,14,0,14
org.apache.camel.component.jms.JmsComponent,7,13,42,0.30952380952380953,1,0.14285714285714285,217,31.0,29,0.6904761904761905,0.0,0.0,0.012351211314941884,0.00033095683129007143,11,7,18
org.apache.camel.impl.EventDrivenPollingConsumer,7,14,42,0.3333333333333333,1,0.14285714285714285,204,29.142857142857142,28,0.6666666666666666,0.0,0.0,0.08732436427707516,0.0011543769947603294,2,6,8
org.apache.camel.component.cxf.spring.NamespaceHandler,2,1,2,0.5,1,0.5,4,2.0,1,0.5,0.0,0.0,0.0,0.0,0,1,1
org.apache.camel.impl.DefaultConsumer,9,12,72,0.16666666666666666,1,0.1111111111111111,203,22.555555555555557,60,0.8333333333333334,0.0,0.0,0.02488392436578965,0.0006107869375934218,7,8,15
org.apache.camel.builder.ValueBuilder,3,3,6,0.5,1,0.3333333333333333,1,0.3333333333333333,3,0.5,0.0,0.0,0.17161219286629037,1.630965775398514e-05,8,3,11
org.apache.camel.component.xmpp.XmppComponent,5,10,20,0.5,1,0.2,224,44.8,10,0.5,0.25,0.05,0.002878526194588371,0.00010140534187574799,2,5,7
org.apache.camel.component.bean.BeanComponent,9,13,72,0.18055555555555555,1,0.1111111111111111,223,24.77777777777778,59,0.8194444444444444,0.0,0.0,0.0010362694300518134,5.45162489135142e-05,1,8,9
org.apache.camel.language.XPath,1,0,0,0,1,1.0,-1,-1.0,0,0,0.0,0.0,0.00233160621761658,0.0,2,0,2
org.apache.camel.component.bean.MethodInvocation,1,0,0,0,1,1.0,-1,-1.0,0,0,0.0,0.0,0.10389105415195561,0.0,6,0,6
org.apache.camel.component.irc.IrcExchange,6,14,30,0.4666666666666667,1,0.16666666666666666,209,34.833333333333336,16,0.5333333333333333,0.30000000000000004,0.05000000000000001,0.005077720207253886,0.0008258175133833553,5,6,11
org.apache.camel.impl.BinaryPredicateSupport,3,2,6,0.3333333333333333,1,0.3333333333333333,1,0.3333333333333333,4,0.6666666666666666,0.0,0.0,0.0,0.0,0,2,2
org.apache.camel.model.config.StreamResequencerConfig,3,4,6,0.6666666666666666,1,0.3333333333333333,202,67.33333333333333,2,0.3333333333333333,0.0,0.0,0.1192681127204008,0.0007660315025997739,3,3,6
org.apache.camel.spring.spi.TransactionInterceptor,3,4,6,0.6666666666666666,1,0.3333333333333333,203,67.66666666666667,2,0.3333333333333333,0.0,0.0,0.001381692573402418,1.1179670199729109e-05,1,2,3
org.apache.camel.CamelTemplate,11,26,110,0.23636363636363636,1,0.09090909090909091,204,18.545454545454547,84,0.7636363636363637,0.0,0.0,0.00233160621761658,0.0003408366119866131,2,10,12
org.apache.camel.component.cxf.interceptors.RawMessageContentRedirectInterceptor,2,2,2,1.0,1,0.5,203,101.5,0,0.0,0.0,0.0,0.0030847090010844677,0.0,1,1,2
org.apache.camel.component.cxf.interceptors.XMLMessageInInterceptor,4,5,12,0.4166666666666667,1,0.25,204,51.0,7,0.5833333333333334,0.0,0.0,0.0028221805754602577,1.612452432653237e-06,1,3,4
org.apache.camel.model.language.PythonExpression,2,1,2,0.5,1,0.5,203,101.5,1,0.5,0.0,0.0,0.0,0.0,0,1,1
org.apache.camel.component.file.strategy.DeleteFileProcessStrategy,4,7,12,0.5833333333333334,1,0.25,226,56.5,5,0.4166666666666667,0.0,0.0,0.006623113313809417,0.0,1,3,4
org.apache.camel.util.ResolverUtil,4,5,12,0.4166666666666667,1,0.25,2,0.5,7,0.5833333333333334,0.0,0.0,0.11723915383492664,0.0023122567884247417,2,3,5
org.apache.camel.builder.xml.XPathLanguage,5,9,20,0.45,1,0.2,210,42.0,11,0.55,0.0,0.0,0.0010362694300518134,3.8583683209916734e-05,1,4,5
org.apache.camel.Consumer,1,0,0,0,1,1.0,-1,-1.0,0,0,0.0,0.0,0.23396191778684428,0.0,27,0,27
org.apache.camel.component.irc.IrcConfiguration,1,1,0,0,1,1.0,-1,-1.0,-1,0,0.0,0.0,0.0062176165803108805,0.0,7,1,8
org.apache.camel.builder.xml.InvalidXPathExpression,2,1,2,0.5,1,0.5,1,0.5,1,0.5,0.0,0.0,0.002072538860103627,0.0,1,1,2
org.apache.camel.processor.ErrorHandlerSupport,5,6,20,0.3,1,0.2,202,40.4,14,0.7,0.0,0.0,0.117224578078774,0.0009500928055955684,3,4,7
org.apache.camel.model.CatchType,6,10,30,0.3333333333333333,1,0.16666666666666666,202,33.666666666666664,20,0.6666666666666666,0.0,0.0,0.11907939735217232,1.4332910512473215e-06,1,5,6
org.apache.camel.converter.CollectionConverter,3,2,6,0.3333333333333333,1,0.3333333333333333,1,0.3333333333333333,4,0.6666666666666666,0.0,0.0,0.0,0.0,0,2,2
org.apache.camel.processor.resequencer.Sequence,2,1,2,0.5,1,0.5,0,0.0,1,0.5,0.0,0.0,0.0905894048184402,0.0,1,1,2
org.apache.camel.processor.validation.SchemaValidationException,3,4,6,0.6666666666666666,1,0.3333333333333333,204,68.0,2,0.3333333333333333,0.0,0.0,0.0035633124261430778,6.449809730612948e-06,1,2,3
org.apache.camel.component.mail.MailEndpoint,13,30,156,0.19230769230769232,1,0.07692307692307693,224,17.23076923076923,126,0.8076923076923077,0.3106060606060606,0.023892773892773892,0.006476683937823835,0.00040142131283317614,6,12,18
org.apache.camel.spring.handler.BeanDefinitionParser,2,1,2,0.5,1,0.5,2,1.0,1,0.5,0.0,0.0,0.0037009622501850484,3.224904865306474e-06,3,1,4
org.apache.camel.RuntimeExpressionException,2,1,2,0.5,1,0.5,0,0.0,1,0.5,0.0,0.0,0.0051016341171781585,8.062262163266183e-06,4,1,5
org.apache.camel.component.cxf.CxfMessage,5,13,20,0.65,1,0.2,210,42.0,7,0.35,0.16666666666666666,0.03333333333333333,0.007481865284974094,2.2574334057145313e-05,4,5,9
org.apache.camel.component.timer.TimerComponent,4,5,12,0.4166666666666667,1,0.25,216,54.0,7,0.5833333333333334,0.3333333333333333,0.08333333333333333,0.001381692573402418,2.0066074717462503e-05,1,3,4
org.apache.camel.converter.jaxb.HeaderType,1,0,0,0,1,1.0,-1,-1.0,0,0,0.0,0.0,0.005077720207253886,0.0,5,0,5
org.apache.camel.spi.ExchangeConverter,2,2,2,1.0,1,0.5,202,101.0,0,0.0,0.0,0.0,0.2518199110353778,7.713520222989429e-05,4,1,5
org.apache.camel.component.jms.MessagePropertyNamesAccessException,2,1,2,0.5,1,0.5,0,0.0,1,0.5,0.0,0.0,0.003573342862247633,3.5832276281183037e-07,1,1,2
org.apache.camel.spi.UnitOfWork,3,5,6,0.8333333333333334,1,0.3333333333333333,202,67.33333333333333,1,0.16666666666666666,0.5,0.16666666666666666,0.246863755335525,0.0007610775482123278,3,2,5
org.apache.camel.bam.processor.NoCorrelationKeyException,3,3,6,0.5,1,0.3333333333333333,204,68.0,3,0.5,0.5,0.16666666666666666,0.0027363989637305703,2.499301270612517e-05,1,2,3
org.apache.camel.impl.ServiceSupport,3,3,6,0.5,1,0.3333333333333333,1,0.3333333333333333,3,0.5,0.0,0.0,0.22188034778255172,0.0004240082204038497,36,2,38
org.apache.camel.component.cxf.interceptors.XMLMessageOutInterceptor,5,7,20,0.35,1,0.2,208,41.6,13,0.65,0.25,0.05,0.003426033625885587,1.343710360544364e-05,1,4,5
org.apache.camel.language.NamespacePrefix,1,0,0,0,1,1.0,-1,-1.0,0,0,0.0,0.0,0.002072538860103627,0.0,2,0,2
org.apache.camel.builder.xml.DomResultHandler,3,4,6,0.6666666666666666,1,0.3333333333333333,204,68.0,2,0.3333333333333333,0.0,0.0,0.001381692573402418,0.0001096467654204201,1,2,3
org.apache.camel.model.dataformat.DataFormatType,5,4,20,0.2,1,0.2,202,40.4,16,0.8,0.0,0.0,0.14261160094369527,0.0012078611774664493,8,4,12
org.apache.camel.converter.jaxp.BytesSource,1,0,0,0,1,1.0,-1,-1.0,0,0,0.0,0.0,0.0033914272256241164,0.0,2,0,2
org.apache.camel.builder.RouteBuilder,13,43,156,0.27564102564102566,1,0.07692307692307693,202,15.538461538461538,113,0.7243589743589743,0.33712121212121215,0.025932400932400936,0.2775591432486883,0.10399090072902158,102,13,115
org.apache.camel.component.cxf.interceptors.FaultOutInterceptor,2,2,2,1.0,1,0.5,203,101.5,0,0.0,0.0,0.0,0.0029075909250968358,5.374841442177456e-07,1,1,2
org.apache.camel.component.bean.ProxyHelper,4,7,12,0.5833333333333334,1,0.25,209,52.25,5,0.4166666666666667,0.0,0.0,0.0033914272256241164,4.300299728459598e-05,3,3,6
org.apache.camel.impl.DefaultExchange,9,22,72,0.3055555555555556,1,0.1111111111111111,206,22.88888888888889,50,0.6944444444444444,0.0,0.0,0.14254499038469612,0.0032582158165328453,40,8,48
org.apache.camel.util.ExpressionListComparator,2,2,2,1.0,1,0.5,202,101.0,0,0.0,0.0,0.0,0.10303290707725608,1.4332910512473215e-06,1,1,2
org.apache.camel.model.language.PhpExpression,2,1,2,0.5,1,0.5,203,101.5,1,0.5,0.0,0.0,0.0,0.0,0,1,1
org.apache.camel.Producer,3,5,6,0.8333333333333334,1,0.3333333333333333,202,67.33333333333333,1,0.16666666666666666,0.0,0.0,0.23794365577507243,8.256780234506891e-05,42,2,44
org.apache.camel.spring.remoting.SendBeforeInterceptor,10,19,90,0.2111111111111111,1,0.1,209,20.9,71,0.7888888888888889,0.0,0.0,0.0,0.0,0,9,9
org.apache.camel.component.cxf.DataFormat,1,0,0,0,1,1.0,-1,-1.0,0,0,0.0,0.0,0.0061694180021689355,0.0,5,0,5
org.apache.camel.processor.idempotent.NoMessageIdException,4,4,12,0.3333333333333333,1,0.25,202,50.5,8,0.6666666666666666,0.0,0.0,0.10295236542622832,2.687420721088728e-06,1,3,4
org.apache.camel.bam.processor.JpaBamProcessorSupport,7,10,42,0.23809523809523808,1,0.14285714285714285,225,32.142857142857146,32,0.7619047619047619,0.0,0.0,0.0032150923342633185,0.00010420872529315331,1,6,7
org.apache.camel.component.bean.ParameterMappingStrategy,2,1,2,0.5,1,0.5,0,0.0,1,0.5,0.0,0.0,0.10375378757897342,2.544091615963996e-06,4,1,5
org.apache.camel.builder.xml.DomResultHandlerFactory,4,5,12,0.4166666666666667,1,0.25,206,51.5,7,0.5833333333333334,0.0,0.0,0.0010362694300518134,1.0749682884354912e-06,1,3,4
org.apache.camel.component.bean.BeanInfo,21,42,420,0.1,1,0.047619047619047616,202,9.619047619047619,378,0.9,0.034210526315789476,0.0016290726817042608,0.103194369027622,0.00986159271396732,2,20,22
org.apache.camel.model.FilterType,6,12,30,0.4,1,0.16666666666666666,202,33.666666666666664,18,0.6,0.0,0.0,0.14230341812155872,0.0003089645037460703,5,5,10
org.apache.camel.impl.PredicateSupport,2,1,2,0.5,1,0.5,0,0.0,1,0.5,0.0,0.0,0.0,0.0,0,1,1
org.apache.camel.component.quartz.QuartzMessage,3,4,6,0.6666666666666666,1,0.3333333333333333,208,69.33333333333333,2,0.3333333333333333,0.5,0.16666666666666666,0.0024870466321243526,2.2395172675739397e-06,1,2,3
org.apache.camel.processor.idempotent.MemoryMessageIdRepository,3,2,6,0.3333333333333333,1,0.3333333333333333,1,0.3333333333333333,4,0.6666666666666666,0.0,0.0,0.001381692573402418,3.224904865306474e-06,1,2,3
org.apache.camel.component.velocity.VelocityEndpoint,5,8,20,0.4,1,0.2,233,46.6,12,0.6,0.25,0.05,0.0010362694300518134,2.3802869243928735e-05,1,4,5
org.apache.camel.language.ExpressionEvaluationException,4,4,12,0.3333333333333333,1,0.25,203,50.75,8,0.6666666666666666,0.0,0.0,0.001381692573402418,1.612452432653237e-06,1,3,4
org.apache.camel.model.ResequencerType,14,33,182,0.1813186813186813,1,0.07142857142857142,202,14.428571428571429,149,0.8186813186813187,0.1794871794871795,0.01282051282051282,0.14192005762015364,0.013542464051152484,3,14,17
org.apache.camel.component.xmpp.XmppPrivateChatProducer,5,8,20,0.4,1,0.2,224,44.8,12,0.6,0.125,0.025,0.002878526194588371,2.5423853170934633e-06,1,4,5
org.apache.camel.impl.DefaultPollingEndpoint,7,12,42,0.2857142857142857,1,0.14285714285714285,214,30.571428571428573,30,0.7142857142857143,0.0,0.0,0.014130946773433819,0.0009513709785676762,4,6,10
org.apache.camel.component.cxf.CxfBinding,6,14,30,0.4666666666666667,1,0.16666666666666666,210,35.0,16,0.5333333333333333,0.2,0.03333333333333333,0.007058363476390654,3.628017973469782e-05,4,5,9
org.apache.camel.component.jms.JmsProducer,4,5,12,0.4166666666666667,1,0.25,230,57.5,7,0.5833333333333334,0.3333333333333333,0.08333333333333333,0.0033914272256241164,1.2111309383039868e-05,1,3,4
org.apache.camel.component.cxf.interceptors.PayloadContentRedirectInterceptor,2,2,2,1.0,1,0.5,203,101.5,0,0.0,0.0,0.0,0.0030847090010844677,0.0,1,1,2
org.apache.camel.processor.resequencer.ElementComparator,3,2,6,0.3333333333333333,1,0.3333333333333333,3,1.0,4,0.6666666666666666,0.0,0.0,0.0905894048184402,0.0,1,2,3
org.apache.camel.component.cxf.CxfExchange,8,25,56,0.44642857142857145,1,0.125,210,26.25,31,0.5535714285714286,0.16666666666666666,0.020833333333333332,0.00869984335462104,0.0006218277771123213,6,7,13
org.apache.camel.component.xmpp.XmppMessage,5,12,20,0.6,1,0.2,209,41.8,8,0.4,0.16666666666666666,0.03333333333333333,0.0041968911917098445,5.518170547302189e-06,3,5,8
org.apache.camel.component.file.remote.SftpProducer,8,18,56,0.32142857142857145,1,0.125,243,30.375,38,0.6785714285714286,0.08333333333333333,0.010416666666666666,0.001381692573402418,9.638882319638238e-06,1,7,8
org.apache.camel.component.jdbc.JdbcProducer,5,6,20,0.3,1,0.2,217,43.4,14,0.7,0.25,0.05,0.001381692573402418,3.6728083188212612e-06,1,4,5
org.apache.camel.impl.DefaultMessage,2,2,2,1.0,1,0.5,205,102.5,0,0.0,0.0,0.0,0.11073094465907769,0.0002472785386164441,14,2,16
org.apache.camel.bam.model.ProcessInstance,4,8,12,0.6666666666666666,1,0.25,225,56.25,4,0.3333333333333333,0.3333333333333333,0.08333333333333333,0.007836787564766839,2.944210243308155e-05,6,3,9
org.apache.camel.builder.BuilderSupport,12,24,132,0.18181818181818182,1,0.08333333333333333,202,16.833333333333332,108,0.8181818181818182,0.0,0.0,0.20642917472022349,0.012043407308978241,3,12,15
org.apache.camel.component.mail.MailMessage,7,10,42,0.23809523809523808,1,0.14285714285714285,224,32.0,32,0.7619047619047619,0.16666666666666666,0.023809523809523808,0.004710315591144607,4.210292463039007e-05,4,7,11
org.apache.camel.processor.loadbalancer.QueueLoadBalancer,4,6,12,0.5,1,0.25,205,51.25,6,0.5,0.0,0.0,0.0039012496190185915,1.1824651172790403e-05,3,3,6
org.apache.camel.component.cxf.spring.CxfEndpointBeanDefinitionParser,3,2,6,0.3333333333333333,1,0.3333333333333333,3,1.0,4,0.6666666666666666,0.0,0.0,0.0010362694300518134,4.299873153741965e-06,1,2,3
org.apache.camel.component.irc.IrcProducer,5,8,20,0.4,1,0.2,224,44.8,12,0.6,0.16666666666666666,0.03333333333333333,0.0023686158401184307,7.050000358322764e-06,1,4,5
org.apache.camel.Route,3,2,6,0.3333333333333333,1,0.3333333333333333,202,67.33333333333333,4,0.6666666666666666,0.0,0.0,0.17109686712764222,4.8524449175879845e-05,5,2,7
org.apache.camel.component.file.remote.RemoteFileMessage,4,7,12,0.5833333333333334,1,0.25,209,52.25,5,0.4166666666666667,0.5,0.125,0.005649339796088919,4.299873153741965e-06,2,4,6
org.apache.camel.converter.jaxp.StringSource,1,0,0,0,1,1.0,-1,-1.0,0,0,0.0,0.0,0.0033914272256241164,0.0,2,0,2
org.apache.camel.component.mock.MockEndpoint,10,19,90,0.2111111111111111,1,0.1,212,21.2,71,0.7888888888888889,0.1111111111111111,0.01111111111111111,0.0704687885516901,0.0018699925363385042,2,9,11
org.apache.camel.builder.xml.StringResultHandlerFactory,4,5,12,0.4166666666666667,1,0.25,206,51.5,7,0.5833333333333334,0.0,0.0,0.0010362694300518134,1.0749682884354912e-06,1,3,4
org.apache.camel.component.jms.JmsMessage,7,11,42,0.2619047619047619,1,0.14285714285714285,213,30.428571428571427,31,0.7380952380952381,0.13333333333333333,0.019047619047619046,0.004417780201799836,3.300152645496958e-05,3,7,10
org.apache.camel.ExpectedBodyTypeException,3,3,6,0.5,1,0.3333333333333333,203,67.66666666666667,3,0.5,0.0,0.0,0.0010362694300518134,5.374841442177456e-07,1,2,3
org.apache.camel.component.cxf.phase.PayloadPhaseManagerImpl,2,1,2,0.5,1,0.5,0,0.0,1,0.5,0.0,0.0,0.003442320290631886,1.0749682884354912e-06,2,1,3
org.apache.camel.model.config.BatchResequencerConfig,1,1,0,0,1,1.0,-1,-1.0,-1,0,0.0,0.0,0.11938666900851849,0.0,3,1,4
org.apache.camel.builder.xml.ResultHandler,2,2,2,1.0,1,0.5,203,101.5,0,0.0,0.0,0.0,0.008290155440414507,0.0005487713112463182,8,1,9
org.apache.camel.spring.CamelTemplateFactoryBean,4,6,12,0.5,1,0.25,203,50.75,6,0.5,0.0,0.0,0.0,0.0,0,3,3
org.apache.camel.processor.CatchProcessor,2,1,2,0.5,1,0.5,202,101.0,1,0.5,0.0,0.0,0.16442173966479723,7.166455256236607e-07,4,1,5
org.apache.camel.AsyncProcessor,2,2,2,1.0,1,0.5,202,101.0,0,0.0,0.0,0.0,0.160269928167329,0.0008253197006878772,22,1,23
org.apache.camel.model.language.LanguageExpression,2,1,2,0.5,1,0.5,202,101.0,1,0.5,0.0,0.0,0.14195830069685,0.0,1,1,2
org.apache.camel.model.ThreadType,4,10,12,0.8333333333333334,1,0.25,202,50.5,2,0.16666666666666666,0.0,0.0,0.14188183514301383,0.0,2,4,6
org.apache.camel.util.CamelContextHelper,7,10,42,0.23809523809523808,1,0.14285714285714285,202,28.857142857142858,32,0.7619047619047619,0.0,0.0,0.17438174574181078,0.0002269025409599009,7,6,13
org.apache.camel.component.jms.RuntimeJmsException,1,0,0,0,1,1.0,-1,-1.0,0,0,0.0,0.0,0.006486279025139129,0.0,4,0,4
org.apache.camel.component.cxf.invoker.InvokingContextFactory,6,5,30,0.16666666666666666,1,0.16666666666666666,267,44.5,25,0.8333333333333334,0.0,0.0,0.003822305274781279,0.0003629809587283842,1,5,6
org.apache.camel.component.ibatis.IBatisPollingConsumer,4,5,12,0.4166666666666667,1,0.25,223,55.75,7,0.5833333333333334,0.3333333333333333,0.08333333333333333,0.0023686158401184307,1.934942919183884e-05,1,3,4
org.apache.camel.component.cxf.phase.RawMessagePhaseManagerImpl,2,1,2,0.5,1,0.5,0,0.0,1,0.5,0.0,0.0,0.003442320290631886,1.0749682884354912e-06,2,1,3
org.apache.camel.spi.Injector,1,0,0,0,1,1.0,-1,-1.0,0,0,0.0,0.0,0.2629657044164816,0.0,16,0,16
org.apache.camel.impl.PollingConsumerSupport,6,7,30,0.23333333333333334,1,0.16666666666666666,203,33.833333333333336,23,0.7666666666666667,0.0,0.0,0.07436505717077709,0.00012738591383271364,6,5,11
org.apache.camel.component.bean.AmbiguousMethodCallException,3,4,6,0.6666666666666666,1,0.3333333333333333,202,67.33333333333333,2,0.3333333333333333,0.0,0.0,0.09067250497177459,0.0004969040913293058,1,2,3
org.apache.camel.builder.xml.XsltBuilder,11,21,110,0.19090909090909092,1,0.09090909090909091,217,19.727272727272727,89,0.8090909090909091,0.0,0.0,0.0,0.0,1,11,12
org.apache.camel.processor.MarshalProcessor,3,4,6,0.6666666666666666,1,0.3333333333333333,202,67.33333333333333,2,0.3333333333333333,0.0,0.0,0.11921413303598334,3.045743483900558e-06,1,2,3
org.apache.camel.bam.ProcessBuilder,9,18,72,0.25,1,0.1111111111111111,225,25.0,54,0.75,0.08928571428571427,0.00992063492063492,0.005699481865284974,0.00015683787328273817,3,9,12
org.apache.camel.component.cxf.interceptors.AbstractMessageOutInterceptor,4,4,12,0.3333333333333333,1,0.25,203,50.75,8,0.6666666666666666,0.0,0.0,0.003252984906510475,2.687420721088728e-06,2,3,5
org.apache.camel.component.cxf.transport.CamelTransportBase,6,10,30,0.3333333333333333,1,0.16666666666666666,204,34.0,20,0.6666666666666666,0.0,0.0,0.002763385146804836,0.00011340915442994432,2,5,7
org.apache.camel.component.xmpp.XmppConsumer,4,5,12,0.4166666666666667,1,0.25,224,56.0,7,0.5833333333333334,0.16666666666666666,0.041666666666666664,0.002878526194588371,2.230559198503644e-05,1,3,4
org.apache.camel.component.validator.jing.RelaxNGCompactSyntaxComponent,3,3,6,0.5,1,0.3333333333333333,226,75.33333333333333,3,0.5,0.0,0.0,0.0,0.0,0,2,2
org.apache.camel.impl.converter.InstanceMethodTypeConverter,3,2,6,0.3333333333333333,1,0.3333333333333333,3,1.0,4,0.6666666666666666,0.0,0.0,0.11695602964344824,0.0,1,2,3
org.apache.camel.builder.script.ScriptEvaluationException,2,1,2,0.5,1,0.5,0,0.0,1,0.5,0.0,0.0,0.0015544041450777201,3.224904865306474e-06,1,1,2
org.apache.camel.management.ManagedService,3,3,6,0.5,1,0.3333333333333333,2,0.6666666666666666,3,0.5,0.0,0.0,0.003918393782383419,6.603376628960875e-06,2,2,4
org.apache.camel.model.language.SimpleExpression,2,1,2,0.5,1,0.5,203,101.5,1,0.5,0.0,0.0,0.0,0.0,0,1,1
org.apache.camel.component.direct.DirectComponent,3,3,6,0.5,1,0.3333333333333333,215,71.66666666666667,3,0.5,0.0,0.0,0.001381692573402418,1.7289073305670816e-05,1,2,3
org.apache.camel.view.RouteDotGenerator,6,13,30,0.43333333333333335,1,0.16666666666666666,205,34.166666666666664,17,0.5666666666666667,0.0,0.0,0.004616109279321714,5.364626916666132e-05,3,5,8
org.apache.camel.component.mock.MockComponent,3,3,6,0.5,1,0.3333333333333333,215,71.66666666666667,3,0.5,0.0,0.0,0.0,0.0,0,2,2
org.apache.camel.processor.BatchProcessor,10,18,90,0.2,1,0.1,202,20.2,72,0.8,0.07638888888888888,0.007638888888888888,0.11959302017843594,0.0008685405096085983,3,9,12
org.apache.camel.model.dataformat.XMLBeansDataFormat,2,1,2,0.5,1,0.5,202,101.0,1,0.5,0.0,0.0,0.11918716151267203,0.0,1,1,2
org.apache.camel.component.seda.QueueComponent,2,1,2,0.5,1,0.5,219,109.5,1,0.5,0.0,0.0,0.0,0.0,0,1,1
org.apache.camel.component.jms.MessageListenerProcessor,3,4,6,0.6666666666666666,1,0.3333333333333333,231,77.0,2,0.3333333333333333,0.0,0.0,0.0,0.0,0,2,2
org.apache.camel.component.jms.JmsConfiguration,2,2,2,1.0,1,0.5,0,0.0,0,0.0,0.0,0.0,0.009834400081276035,4.299873153741965e-06,4,2,6
org.apache.camel.component.jms.MessagePropertyAccessException,2,1,2,0.5,1,0.5,0,0.0,1,0.5,0.0,0.0,0.003573342862247633,3.5832276281183037e-07,1,1,2
org.apache.camel.impl.DefaultLanguageResolver,7,10,42,0.23809523809523808,1,0.14285714285714285,202,28.857142857142858,32,0.7619047619047619,0.0,0.0,0.16782645870850918,0.0007664523896545052,1,6,7
org.apache.camel.Endpoint,8,15,56,0.26785714285714285,1,0.125,202,25.25,41,0.7321428571428571,0.42857142857142855,0.05357142857142857,0.3148877787722716,0.011082135202116067,127,7,134
org.apache.camel.model.language.XQueryExpression,2,1,2,0.5,1,0.5,203,101.5,1,0.5,0.0,0.0,0.0010362694300518134,0.00012188348777044408,1,1,2
org.apache.camel.model.dataformat.ArtixDSContentType,1,0,0,0,1,1.0,-1,-1.0,0,0,0.0,0.0,0.11949468680449997,0.0,2,0,2
org.apache.camel.component.cxf.interceptors.RawMessageInInterceptor,3,3,6,0.5,1,0.3333333333333333,267,89.0,3,0.5,0.0,0.0,0.002951400275464026,9.9254325438403e-05,1,2,3
org.apache.camel.converter.jaxb.PropertyType,1,0,0,0,1,1.0,-1,-1.0,0,0,0.0,0.0,0.0010362694300518134,0.0,1,0,1
org.apache.camel.processor.ThreadProcessor,5,8,20,0.4,1,0.2,204,40.8,12,0.6,0.16666666666666666,0.03333333333333333,0.0010362694300518134,2.1499365768709824e-06,1,4,5
org.apache.camel.spring.CamelServiceExporterType,2,1,2,0.5,1,0.5,0,0.0,1,0.5,0.0,0.0,0.0025906735751295338,0.0,1,1,2
org.apache.camel.component.bean.BeanExchange,6,13,30,0.43333333333333335,1,0.16666666666666666,207,34.5,17,0.5666666666666667,0.0,0.0,0.00466321243523316,0.00020606118309986045,3,5,8
org.apache.camel.model.InterceptType,6,8,30,0.26666666666666666,1,0.16666666666666666,202,33.666666666666664,22,0.7333333333333333,0.0,0.0,0.20888471605313652,0.0018018920543214716,3,5,8
org.apache.camel.model.RecipientListType,7,12,42,0.2857142857142857,1,0.14285714285714285,202,28.857142857142858,30,0.7142857142857143,0.0,0.0,0.14218819268178418,0.00032256660426473177,3,6,9
org.apache.camel.impl.DefaultExchangeConverter,3,4,6,0.6666666666666666,1,0.3333333333333333,202,67.33333333333333,2,0.3333333333333333,0.0,0.0,0.16787994069025186,1.158943741725785e-05,1,2,3
org.apache.camel.Expression,1,0,0,0,1,1.0,-1,-1.0,0,0,0.0,0.0,0.21859890351152317,0.0,44,0,44
org.apache.camel.converter.NIOConverter,3,3,6,0.5,1,0.3333333333333333,2,0.6666666666666666,3,0.5,0.0,0.0,0.004231433506044905,2.1499365768709824e-06,3,2,5
org.apache.camel.util.URISupport,2,2,2,1.0,1,0.5,0,0.0,0,0.0,0.0,0.0,0.053507159173212984,0.00020961881624492079,3,1,4
org.apache.camel.component.xmpp.XmppExchange,8,25,56,0.44642857142857145,1,0.125,209,26.125,31,0.5535714285714286,0.15079365079365079,0.018849206349206348,0.006456755679553606,0.0006273199266018475,5,7,12
org.apache.camel.CamelException,1,0,0,0,1,1.0,-1,-1.0,0,0,0.0,0.0,0.0963281488545136,0.0,5,0,5
org.apache.camel.impl.DefaultUnitOfWork,4,8,12,0.6666666666666666,1,0.25,203,50.75,4,0.3333333333333333,0.0,0.0,0.0010362694300518134,1.612452432653237e-06,1,3,4
org.apache.camel.component.mail.RuntimeMailException,1,0,0,0,1,1.0,-1,-1.0,0,0,0.0,0.0,0.005649339796088919,0.0,3,0,3
org.apache.camel.component.cxf.interceptors.PayloadInInterceptor,3,3,6,0.5,1,0.3333333333333333,267,89.0,3,0.5,0.0,0.0,0.0032383419689119173,0.00015766093577673136,2,2,4
org.apache.camel.component.cxf.invoker.InvokingContext,3,6,6,1.0,1,0.3333333333333333,203,67.66666666666667,0,0.0,0.0,0.0,0.009844559585492229,5.254473392413323e-05,6,2,8
org.apache.camel.spring.CamelBeanPostProcessor,11,19,110,0.17272727272727273,1,0.09090909090909091,227,20.636363636363637,91,0.8272727272727273,0.0,0.0,0.0,0.0,0,10,10
org.apache.camel.Service,1,0,0,0,1,1.0,-1,-1.0,0,0,0.0,0.0,0.19430935104425665,0.0,19,0,19
org.apache.camel.converter.jaxb.ObjectHeader,2,1,2,0.5,1,0.5,0,0.0,1,0.5,0.0,0.0,0.0,0.0,0,1,1
org.apache.camel.builder.sql.SqlBuilder,3,3,6,0.5,1,0.3333333333333333,2,0.6666666666666666,3,0.5,0.0,0.0,0.0010362694300518134,2.1499365768709824e-06,2,3,5
org.apache.camel.component.jms.JmsBinding,7,18,42,0.42857142857142855,1,0.14285714285714285,213,30.428571428571427,24,0.5714285714285714,0.13333333333333333,0.019047619047619046,0.005595854922279792,0.00010607377558552499,3,6,9
org.apache.camel.component.quartz.QuartzExchange,5,8,20,0.4,1,0.2,208,41.6,12,0.6,0.25,0.05,0.003730569948186528,0.0004349232114319295,2,4,6
org.apache.camel.component.validator.SpringValidator,2,1,2,0.5,1,0.5,209,104.5,1,0.5,0.0,0.0,0.0038380349261178275,6.449809730612947e-05,2,1,3
org.apache.camel.component.cxf.transport.CamelConduit,5,7,20,0.35,1,0.2,204,40.8,13,0.65,0.16666666666666666,0.03333333333333333,0.002763385146804836,0.00022036849912927567,2,4,6
org.apache.camel.component.xmpp.RuntimeXmppException,1,0,0,0,1,1.0,-1,-1.0,0,0,0.0,0.0,0.002869669190912714,0.0,2,0,2
org.apache.camel.spring.remoting.CamelServiceExporter,8,14,56,0.25,1,0.125,203,25.375,42,0.75,0.0,0.0,0.001865284974093264,1.9941670017992766e-05,1,7,8
org.apache.camel.builder.DeadLetterChannelBuilder,11,18,110,0.16363636363636364,1,0.09090909090909091,202,18.363636363636363,92,0.8363636363636363,0.0,0.0,0.16159731714294795,0.004360339809730328,2,11,13
org.apache.camel.spi.TypeConverterAware,2,1,2,0.5,1,0.5,0,0.0,1,0.5,0.0,0.0,0.1380679800308153,0.0,2,1,3
org.apache.camel.component.file.FileProducer,8,21,56,0.375,1,0.125,226,28.25,35,0.625,0.0873015873015873,0.010912698412698412,0.006623113313809417,0.0001822055840848156,1,7,8
org.apache.camel.component.jms.JmsIOConverter,4,5,12,0.4166666666666667,1,0.25,204,51.0,7,0.5833333333333334,0.0,0.0,0.0,0.0,0,3,3
org.apache.camel.processor.loadbalancer.RandomLoadBalancer,4,7,12,0.5833333333333334,1,0.25,206,51.5,5,0.4166666666666667,0.0,0.0,0.0,0.0,0,3,3
org.apache.camel.component.bean.DefaultParameterMappingStrategy,3,3,6,0.5,1,0.3333333333333333,1,0.3333333333333333,3,0.5,0.0,0.0,0.1034435109384559,1.827446090340335e-06,2,2,4
org.apache.camel.model.ExpressionNode,8,20,56,0.35714285714285715,1,0.125,202,25.25,36,0.6428571428571429,0.09523809523809523,0.011904761904761904,0.14261160094369527,0.0006957620626514408,10,7,17
org.apache.camel.converter.HasAnnotation,1,0,0,0,1,1.0,-1,-1.0,0,0,0.0,0.0,0.001381692573402418,0.0,1,0,1
org.apache.camel.processor.ErrorHandler,1,0,0,0,1,1.0,-1,-1.0,0,0,0.0,0.0,0.10143740598362025,0.0,1,0,1
org.apache.camel.model.IdempotentConsumerType,8,16,56,0.2857142857142857,1,0.125,202,25.25,40,0.7142857142857143,0.0,0.0,0.14192005762015364,0.001904127161582067,1,7,8
org.apache.camel.component.cxf.invoker.RawMessageInvokingContext,8,15,56,0.26785714285714285,1,0.125,267,33.375,41,0.7321428571428571,0.0,0.0,0.003330866025166543,0.00014462236631307646,1,7,8
org.apache.camel.processor.Aggregator,5,6,20,0.3,1,0.2,202,40.4,14,0.7,0.0,0.0,0.11921413303598334,0.0007747833938898803,1,4,5
org.apache.camel.component.cxf.CxfComponent,5,9,20,0.45,1,0.2,267,53.4,11,0.55,0.25,0.05,0.005068709168731696,0.00012463020237728383,3,4,7
org.apache.camel.component.validator.ValidatorComponent,4,4,12,0.3333333333333333,1,0.25,223,55.75,8,0.6666666666666666,0.3333333333333333,0.08333333333333333,0.00466321243523316,0.00019745375844745916,3,3,6
org.apache.camel.builder.xml.StreamResultHandler,3,4,6,0.6666666666666666,1,0.3333333333333333,204,68.0,2,0.3333333333333333,0.0,0.0,0.001381692573402418,0.0001096467654204201,1,2,3
org.apache.camel.component.file.strategy.FileRenamer,1,0,0,0,1,1.0,-1,-1.0,0,0,0.0,0.0,0.006300994580429992,0.0,3,0,3
org.apache.camel.processor.UnmarshalProcessor,3,4,6,0.6666666666666666,1,0.3333333333333333,202,67.33333333333333,2,0.3333333333333333,0.0,0.0,0.11921413303598334,3.045743483900558e-06,1,2,3
org.apache.camel.component.cxf.invoker.AbstractInvokingContext,4,9,12,0.75,1,0.25,204,51.0,3,0.25,0.0,0.0,0.0033580376467501802,2.1499365768709824e-06,2,3,5
org.apache.camel.Property,1,0,0,0,1,1.0,-1,-1.0,0,0,0.0,0.0,0.09078639119482632,0.0,1,0,1
org.apache.camel.management.CamelNamingStrategy,7,10,42,0.23809523809523808,1,0.14285714285714285,208,29.714285714285715,32,0.7619047619047619,0.0,0.0,0.004710315591144607,0.00026803566437647237,3,6,9
org.apache.camel.util.ServiceHelper,2,1,2,0.5,1,0.5,0,0.0,1,0.5,0.0,0.0,0.20359061038796916,0.00013089035042574866,24,1,25
org.apache.camel.language.ognl.OgnlLanguage,5,7,20,0.35,1,0.2,208,41.6,13,0.65,0.25,0.05,0.0010362694300518134,2.1499365768709824e-06,1,4,5
org.apache.camel.component.mina.MinaEndpoint,10,18,90,0.2,1,0.1,214,21.4,72,0.8,0.2222222222222222,0.02222222222222222,0.004145077720207254,0.00040452755236794106,4,9,13
org.apache.camel.bam.rules.ProcessRules,7,15,42,0.35714285714285715,1,0.14285714285714285,225,32.142857142857146,27,0.6428571428571429,0.06666666666666667,0.009523809523809523,0.006599400054540496,0.00018557612743172504,4,6,10
org.apache.camel.component.rmi.RmiEndpoint,11,17,110,0.15454545454545454,1,0.09090909090909091,215,19.545454545454547,93,0.8454545454545455,0.18333333333333335,0.016666666666666666,0.002072538860103627,3.305527486939135e-05,2,10,12
org.apache.camel.model.ProcessorRef,4,4,12,0.3333333333333333,1,0.25,202,50.5,8,0.6666666666666666,0.0,0.0,0.14195830069685,6.499221302072116e-06,2,3,5
org.apache.camel.bam.model.TemporalEntity,2,1,2,0.5,1,0.5,0,0.0,1,0.5,0.0,0.0,0.005526770293609672,1.7378653996373773e-06,1,1,2
org.apache.camel.model.OutputType,3,4,6,0.6666666666666666,1,0.3333333333333333,202,67.33333333333333,2,0.3333333333333333,0.0,0.0,0.16671115629304126,0.0010397747568190747,13,2,15
org.apache.camel.spring.handler.ScriptDefinitionParser,3,2,6,0.3333333333333333,1,0.3333333333333333,4,1.3333333333333333,4,0.6666666666666666,0.0,0.0,0.001865284974093264,3.224904865306474e-06,1,2,3
org.apache.camel.processor.DelegateAsyncProcessor,5,7,20,0.35,1,0.2,203,40.6,13,0.65,0.0,0.0,0.05804422620562805,8.790619103864871e-05,2,4,6
org.apache.camel.model.ProcessorType,46,177,2070,0.08550724637681159,1,0.021739130434782608,202,4.391304347826087,1893,0.9144927536231884,0.6469276094276095,0.014063643683208903,0.17554390332756092,0.07443349656394779,18,46,64
org.apache.camel.component.ref.RefComponent,5,9,20,0.45,1,0.2,215,43.0,11,0.55,0.0,0.0,0.0,0.0,0,4,4
org.apache.camel.impl.DefaultScheduledPollConsumer,5,8,20,0.4,1,0.2,205,41.0,12,0.6,0.0,0.0,0.010266545590513326,6.112404640773054e-05,1,4,5
org.apache.camel.component.cxf.invoker.FaultChainInitiatorObserver,3,3,6,0.5,1,0.3333333333333333,204,68.0,3,0.5,0.0,0.0,0.0030847090010844677,1.719949261496786e-05,1,2,3
org.apache.camel.component.bean.ParameterInfo,2,1,2,0.5,1,0.5,0,0.0,1,0.5,0.0,0.0,0.0909113767617784,0.0,2,1,3
org.apache.camel.component.rmi.RmiConsumer,7,11,42,0.2619047619047619,1,0.14285714285714285,215,30.714285714285715,31,0.7380952380952381,0.1,0.014285714285714287,0.001381692573402418,1.751686420488691e-05,1,6,7
org.apache.camel.processor.FilterProcessor,4,5,12,0.4166666666666667,1,0.25,202,50.5,7,0.5833333333333334,0.0,0.0,0.12033057420877351,2.39384891208986e-05,6,3,9
org.apache.camel.spring.SpringCamelContext,9,16,72,0.2222222222222222,1,0.1111111111111111,224,24.88888888888889,56,0.7777777777777778,0.0,0.0,0.03294882946938467,0.004394608731212268,23,9,32
org.apache.camel.processor.aggregate.AggregationCollection,4,5,12,0.4166666666666667,1,0.25,202,50.5,7,0.5833333333333334,0.0,0.0,0.10279165929483129,2.1499365768709824e-06,1,3,4
org.apache.camel.component.file.FileMessage,3,5,6,0.8333333333333334,1,0.3333333333333333,208,69.33333333333333,1,0.16666666666666666,0.5,0.16666666666666666,0.0064879477359765705,4.0311310816330926e-06,2,3,5
org.apache.camel.component.mail.MessageHeaderNamesAccessException,2,1,2,0.5,1,0.5,0,0.0,1,0.5,0.0,0.0,0.0037996545768566492,1.1645489791384487e-06,1,1,2
org.apache.camel.component.bean.NoBeanAvailableException,2,1,2,0.5,1,0.5,0,0.0,1,0.5,0.0,0.0,0.001381692573402418,2.1499365768709824e-06,1,1,2
org.apache.camel.InvalidHeaderTypeException,2,1,2,0.5,1,0.5,0,0.0,1,0.5,0.0,0.0,0.0,0.0,0,1,1
org.apache.camel.Exchange,5,9,20,0.45,1,0.2,202,40.4,11,0.55,0.5,0.1,0.360086981466856,0.03952856621763122,170,5,175
org.apache.camel.language.LanguageAnnotation,1,0,0,0,1,1.0,-1,-1.0,0,0,0.0,0.0,0.0911152139294057,0.0,4,0,4
org.apache.camel.model.ProceedType,4,9,12,0.75,1,0.25,202,50.5,3,0.25,0.0,0.0,0.14188183514301383,0.0,1,3,4
org.apache.camel.model.dataformat.JaxbDataFormat,3,3,6,0.5,1,0.3333333333333333,202,67.33333333333333,3,0.5,0.0,0.0,0.11918716151267203,1.282283601205193e-06,1,2,3
org.apache.camel.CamelContext,10,17,90,0.18888888888888888,1,0.1,202,20.2,73,0.8111111111111111,0.40277777777777773,0.04027777777777777,0.3608268862232948,0.0857338084539311,128,9,137
org.apache.camel.processor.aggregate.UseLatestAggregationStrategy,3,4,6,0.6666666666666666,1,0.3333333333333333,202,67.33333333333333,2,0.3333333333333333,0.0,0.0,0.11921413303598334,1.4332910512473215e-06,1,2,3
org.apache.camel.component.file.FileExchange,6,14,30,0.4666666666666667,1,0.16666666666666666,208,34.666666666666664,16,0.5333333333333333,0.2,0.03333333333333333,0.008650596981302095,0.0010486418031620446,7,5,12
org.apache.camel.builder.xml.MessageVariableResolver,2,2,2,1.0,1,0.5,203,101.5,0,0.0,0.0,0.0,0.002072538860103627,0.0,1,1,2
org.apache.camel.spring.RouteBuilderFinder,5,9,20,0.45,1,0.2,225,45.0,11,0.55,0.0,0.0,0.0025906735751295338,2.1499365768709824e-05,1,4,5
org.apache.camel.bam.model.EntitySupport,1,0,0,0,1,1.0,-1,-1.0,0,0,0.0,0.0,0.007065473386716909,0.0,3,0,3
org.apache.camel.component.ResourceBasedComponent,3,3,6,0.5,1,0.3333333333333333,223,74.33333333333333,3,0.5,0.5,0.16666666666666666,0.004937519049070405,9.953438516420909e-05,3,2,5
org.apache.camel.component.irc.IrcComponent,5,9,20,0.45,1,0.2,224,44.8,11,0.55,0.16666666666666666,0.03333333333333333,0.0023686158401184307,0.0001526454969578398,2,5,7
org.apache.camel.builder.LoggingErrorHandlerBuilder,7,12,42,0.2857142857142857,1,0.14285714285714285,202,28.857142857142858,30,0.7142857142857143,0.0,0.0,0.16159731714294795,0.001927928014290955,1,6,7
org.apache.camel.model.DelayerType,7,13,42,0.30952380952380953,1,0.14285714285714285,202,28.857142857142858,29,0.6904761904761905,0.0,0.0,0.14192005762015364,0.002136315471188424,1,6,7
org.apache.camel.builder.ProcessorBuilder,3,2,6,0.3333333333333333,1,0.3333333333333333,203,67.66666666666667,4,0.6666666666666666,0.0,0.0,0.0,0.0,0,2,2
org.apache.camel.view.GraphGeneratorSupport,11,30,110,0.2727272727272727,1,0.09090909090909091,205,18.636363636363637,80,0.7272727272727273,0.03888888888888889,0.0035353535353535356,0.0056419113413932066,0.0008651115598366902,5,10,15
org.apache.camel.model.RouteType,11,32,110,0.2909090909090909,1,0.09090909090909091,202,18.363636363636363,78,0.7090909090909091,0.15925925925925924,0.014478114478114477,0.2203292571668801,0.041670089194039,17,11,28
org.apache.camel.component.xmpp.XmppEndpoint,13,29,156,0.1858974358974359,1,0.07692307692307693,224,17.23076923076923,127,0.8141025641025641,0.2840909090909091,0.021853146853146856,0.0051813471502590676,0.00013861716079375662,5,12,17
org.apache.camel.processor.Logger,3,3,6,0.5,1,0.3333333333333333,202,67.33333333333333,3,0.5,0.0,0.0,0.15000206545729225,0.0016065749698551284,18,2,20
org.apache.camel.model.ToType,8,22,56,0.39285714285714285,1,0.125,202,25.25,34,0.6071428571428571,0.10714285714285714,0.013392857142857142,0.1423803388881109,0.0002375901930193204,4,7,11
org.apache.camel.util.NoFactoryAvailableException,1,0,0,0,1,1.0,-1,-1.0,0,0,0.0,0.0,0.1697970639032815,0.0,5,0,5
org.apache.camel.processor.idempotent.MessageIdRepository,1,0,0,0,1,1.0,-1,-1.0,0,0,0.0,0.0,0.1433485539483655,0.0,5,0,5
org.apache.camel.impl.ScheduledPollEndpoint,6,9,30,0.3,1,0.16666666666666666,210,35.0,21,0.7,0.0,0.0,0.06244172788546192,0.0011628598545369827,6,5,11
org.apache.camel.spi.Policy,2,1,2,0.5,1,0.5,202,101.0,1,0.5,0.0,0.0,0.14261160094369527,0.0,4,1,5
org.apache.camel.component.file.remote.RemoteFileComponent,6,12,30,0.4,1,0.16666666666666666,240,40.0,18,0.6,0.275,0.04583333333333334,0.00609570252971655,0.000599586152788203,4,6,10
org.apache.camel.component.file.FileConsumer,7,10,42,0.23809523809523808,1,0.14285714285714285,229,32.714285714285715,32,0.7619047619047619,0.0,0.0,0.0,0.0,0,6,6
org.apache.camel.component.jmx.JMXEndpoint,9,14,72,0.19444444444444445,1,0.1111111111111111,219,24.333333333333332,58,0.8055555555555556,0.25,0.027777777777777776,0.002072538860103627,0.00025154257949390495,2,8,10
org.apache.camel.component.file.remote.SftpEndpoint,7,18,42,0.42857142857142855,1,0.14285714285714285,243,34.714285714285715,24,0.5714285714285714,0.16666666666666666,0.023809523809523808,0.002072538860103627,1.4937580174718178e-05,2,6,8
org.apache.camel.component.bean.DefaultAnnotationExpressionFactory,6,9,30,0.3,1,0.16666666666666666,203,33.833333333333336,21,0.7,0.0,0.0,0.002072538860103627,3.941550390930134e-06,2,5,7
org.apache.camel.processor.loadbalancer.StickyLoadBalancer,5,11,20,0.55,1,0.2,207,41.4,9,0.45,0.0,0.0,0.0,0.0,0,4,4
org.apache.camel.component.quartz.QuartzComponent,5,7,20,0.35,1,0.2,224,44.8,13,0.65,0.25,0.05,0.0023686158401184307,0.00023273063444628382,1,4,5
org.apache.camel.impl.converter.AsyncProcessorTypeConverter,5,6,20,0.3,1,0.2,202,40.4,14,0.7,0.0,0.0,0.15238856056870417,0.0021485085180718644,8,4,12
org.apache.camel.impl.ProcessorEndpoint,9,17,72,0.2361111111111111,1,0.1111111111111111,217,24.11111111111111,55,0.7638888888888888,0.0,0.0,0.003626943005181347,0.00023185809525112517,2,8,10
org.apache.camel.management.ManagedRoute,3,3,6,0.5,1,0.3333333333333333,203,67.66666666666667,3,0.5,0.0,0.0,0.003918393782383419,4.299873153741965e-06,2,2,4
org.apache.camel.util.ObjectHelper,1,0,0,0,1,1.0,-1,-1.0,0,0,0.0,0.0,0.17563923816687957,0.0,46,0,46
org.apache.camel.processor.resequencer.ExpressionResultComparator,1,0,0,0,1,1.0,-1,-1.0,0,0,0.0,0.0,0.11971130984878639,0.0,3,0,3
org.apache.camel.builder.script.ScriptBuilder,4,5,12,0.4166666666666667,1,0.25,204,51.0,7,0.5833333333333334,0.0,0.0,0.001381692573402418,0.0002207268218920875,2,4,6
org.apache.camel.component.cxf.interceptors.SoapMessageInInterceptor,4,5,12,0.4166666666666667,1,0.25,204,51.0,7,0.5833333333333334,0.0,0.0,0.003740932642487047,6.449809730612948e-06,2,3,5
org.apache.camel.spi.LanguageResolver,3,3,6,0.5,1,0.3333333333333333,202,67.33333333333333,3,0.5,0.0,0.0,0.16814786271497298,0.0,3,2,5
org.apache.camel.TypeConverter,1,0,0,0,1,1.0,-1,-1.0,0,0,0.0,0.0,0.2648148783584394,0.0,24,0,24
org.apache.camel.view.NodeData,10,14,90,0.15555555555555556,1,0.1,203,20.3,76,0.8444444444444444,0.0,0.0,0.005246113989637305,0.00030363759031013356,4,9,13
org.apache.camel.component.jmx.JMXMessage,3,5,6,0.8333333333333334,1,0.3333333333333333,208,69.33333333333333,1,0.16666666666666666,0.5,0.16666666666666666,0.0018422567645365571,1.6124524326532365e-06,2,3,5
org.apache.camel.management.ManagedEndpoint,2,1,2,0.5,1,0.5,203,101.5,1,0.5,0.0,0.0,0.003918393782383419,0.0,2,1,3
org.apache.camel.processor.validation.ValidatorErrorHandler,2,2,2,1.0,1,0.5,203,101.5,0,0.0,0.0,0.0,0.00432146400617352,0.0,2,1,3
org.apache.camel.component.irc.IrcEndpoint,11,29,110,0.2636363636363636,1,0.09090909090909091,224,20.363636363636363,81,0.7363636363636363,0.26666666666666666,0.024242424242424242,0.004145077720207254,0.00026932434659844204,4,10,14
org.apache.camel.impl.DefaultComponentResolver,7,12,42,0.2857142857142857,1,0.14285714285714285,202,28.857142857142858,30,0.7142857142857143,0.0,0.0,0.16782645870850918,0.0,1,6,7
org.apache.camel.component.quartz.CamelJob,2,2,2,1.0,1,0.5,224,112.0,0,0.0,0.0,0.0,0.0023686158401184307,0.0,1,1,2
org.apache.camel.spring.Main,7,9,42,0.21428571428571427,1,0.14285714285714285,229,32.714285714285715,33,0.7857142857142857,0.0,0.0,0.002072538860103627,0.0004934104443918905,2,6,8
org.apache.camel.processor.aggregate.AggregationStrategy,2,2,2,1.0,1,0.5,202,101.0,0,0.0,0.0,0.0,0.14268885533207212,5.344696828798049e-06,5,1,6
org.apache.camel.component.ibatis.IBatisProducer,5,7,20,0.35,1,0.2,223,44.6,13,0.65,0.25,0.05,0.0023686158401184307,4.35362156816374e-05,1,4,5
org.apache.camel.processor.DelegateProcessor,5,7,20,0.35,1,0.2,202,40.4,13,0.65,0.0,0.0,0.21190959528801703,0.0004859228778079404,8,4,12
org.apache.camel.model.MarshalType,6,7,30,0.23333333333333334,1,0.16666666666666666,202,33.666666666666664,23,0.7666666666666667,0.0,0.0,0.14192005762015364,0.0007709544592244061,1,5,6
org.apache.camel.component.ResourceBasedEndpoint,5,7,20,0.35,1,0.2,231,46.2,13,0.65,0.0,0.0,0.002763385146804836,9.436685903480132e-05,2,4,6
org.apache.camel.component.mail.JavaMailConnection,1,0,0,0,1,1.0,-1,-1.0,0,0,0.0,0.0,0.005015544041450777,0.0,2,0,2
org.apache.camel.processor.idempotent.IdempotentConsumer,9,14,72,0.19444444444444445,1,0.1111111111111111,202,22.444444444444443,58,0.8055555555555556,0.0,0.0,0.1194303454740445,0.0011574618358964545,2,8,10
org.apache.camel.component.event.EventComponent,3,3,6,0.5,1,0.3333333333333333,221,73.66666666666667,3,0.5,0.5,0.16666666666666666,0.024295311996430077,0.0003260737141587657,2,2,4
org.apache.camel.impl.DefaultComponent,9,16,72,0.2222222222222222,1,0.1111111111111111,214,23.77777777777778,56,0.7777777777777778,0.0,0.0,0.07104013892428061,0.0031164674004310246,26,8,34
org.apache.camel.impl.converter.ToStringTypeConverter,2,1,2,0.5,1,0.5,0,0.0,1,0.5,0.0,0.0,0.13771793805075452,0.0,1,1,2
org.apache.camel.processor.DelayProcessorSupport,5,9,20,0.45,1,0.2,202,40.4,11,0.55,0.08333333333333333,0.016666666666666666,0.10297248903166738,0.0012397870779375156,2,4,6
org.apache.camel.model.RouteContainer,1,0,0,0,1,1.0,-1,-1.0,0,0,0.0,0.0,0.15998970634848406,0.0,5,0,5
org.apache.camel.component.jms.JmsConsumer,4,7,12,0.5833333333333334,1,0.25,230,57.5,5,0.4166666666666667,0.16666666666666666,0.041666666666666664,0.003730569948186528,1.003303735873125e-05,2,3,5
org.apache.camel.spi.ExceptionHandler,1,0,0,0,1,1.0,-1,-1.0,0,0,0.0,0.0,0.12491984165587475,0.0,5,0,5
org.apache.camel.component.rmi.RmiComponent,3,4,6,0.6666666666666666,1,0.3333333333333333,203,67.66666666666667,2,0.3333333333333333,0.0,0.0,0.001865284974093264,6.542973648944022e-05,1,2,3
org.apache.camel.component.cxf.transport.CamelDestination,9,25,72,0.3472222222222222,1,0.1111111111111111,207,23.0,47,0.6527777777777778,0.059523809523809514,0.0066137566137566125,0.0031088082901554403,0.00034316570994489,3,8,11
org.apache.camel.component.file.strategy.FileProcessStrategySupport,5,8,20,0.4,1,0.2,226,45.2,12,0.6,0.3333333333333333,0.06666666666666667,0.0070306895177361505,0.0002655171672435663,4,4,8
org.apache.camel.util.ReportingTypeConverterRegistry,4,5,12,0.4166666666666667,1,0.25,2,0.5,7,0.5833333333333334,0.0,0.0,0.0010362694300518134,2.1499365768709824e-06,1,3,4
org.apache.camel.spring.spi.SpringConverters,4,3,12,0.25,1,0.25,203,50.75,9,0.75,0.0,0.0,0.0,0.0,0,3,3
org.apache.camel.RuntimeTransformException,2,1,2,0.5,1,0.5,0,0.0,1,0.5,0.0,0.0,0.0010362694300518134,5.374841442177456e-07,1,1,2
org.apache.camel.component.file.remote.FtpConsumer,8,14,56,0.25,1,0.125,240,30.0,42,0.75,0.09523809523809523,0.011904761904761904,0.003573342862247633,0.00012258144746876275,1,7,8
org.apache.camel.management.InstrumentationLifecycleStrategy,15,40,210,0.19047619047619047,1,0.06666666666666667,211,14.066666666666666,170,0.8095238095238095,0.0,0.0,0.0025508170585890793,0.00013972028301355584,1,14,15
org.apache.camel.component.velocity.VelocityComponent,4,5,12,0.4166666666666667,1,0.25,233,58.25,7,0.5833333333333334,0.3333333333333333,0.08333333333333333,0.0010362694300518134,1.9618171263947716e-05,1,3,4
org.apache.camel.spi.LifecycleStrategy,3,5,6,0.8333333333333334,1,0.3333333333333333,202,67.33333333333333,1,0.16666666666666666,0.0,0.0,0.24779268762277062,0.0,4,2,6
org.apache.camel.component.quartz.QuartzEndpoint,12,20,132,0.15151515151515152,1,0.08333333333333333,224,18.666666666666668,112,0.8484848484848485,0.2727272727272727,0.022727272727272724,0.004145077720207254,0.0005368481213137545,4,11,15
org.apache.camel.builder.DataTypeExpression,8,12,56,0.21428571428571427,1,0.125,202,25.25,44,0.7857142857142857,0.0,0.0,0.14195830069685,0.005387341787702976,1,7,8
org.apache.camel.model.language.GroovyExpression,2,1,2,0.5,1,0.5,203,101.5,1,0.5,0.0,0.0,0.0010362694300518134,3.224904865306474e-06,1,1,2
org.apache.camel.builder.PredicateBuilder,3,2,6,0.3333333333333333,1,0.3333333333333333,1,0.3333333333333333,4,0.6666666666666666,0.0,0.0,0.0,0.0,0,2,2
org.apache.camel.processor.resequencer.SequenceElementComparator,1,0,0,0,1,1.0,-1,-1.0,0,0,0.0,0.0,0.10372560650815942,0.0,4,0,4
org.apache.camel.impl.converter.TypeConverterRegistry,3,2,6,0.3333333333333333,1,0.3333333333333333,1,0.3333333333333333,4,0.6666666666666666,0.0,0.0,0.14010281841028993,8.062262163266183e-06,6,2,8
org.apache.camel.component.xmpp.XmppBinding,4,10,12,0.8333333333333334,1,0.25,209,52.25,2,0.16666666666666666,0.0,0.0,0.006456755679553606,7.164748957366076e-06,5,3,8
org.apache.camel.component.seda.SedaConsumer,6,8,30,0.26666666666666666,1,0.16666666666666666,218,36.333333333333336,22,0.7333333333333333,0.15000000000000002,0.025000000000000005,0.0025906735751295338,2.7053368592293192e-05,1,5,6
org.apache.camel.processor.StreamResequencer,6,10,30,0.3333333333333333,1,0.16666666666666666,202,33.666666666666664,20,0.6666666666666666,0.0,0.0,0.11921413303598334,0.006027419000001935,1,5,6
org.apache.camel.component.jms.EndpointMessageListener,6,14,30,0.4666666666666667,1,0.16666666666666666,230,38.333333333333336,16,0.5333333333333333,0.0,0.0,0.0026646928201332345,7.847268505579087e-06,1,5,6
org.apache.camel.component.vm.VmComponent,4,6,12,0.5,1,0.25,219,54.75,6,0.5,0.0,0.0,0.0,0.0,0,3,3
org.apache.camel.CamelContextAware,2,1,2,0.5,1,0.5,202,101.0,1,0.5,0.0,0.0,0.1715425769736276,3.5832276281183037e-07,9,1,10
org.apache.camel.impl.RouteContext,14,37,182,0.2032967032967033,1,0.07142857142857142,202,14.428571428571429,145,0.7967032967032966,0.14850427350427348,0.010607448107448106,0.1784577418313043,0.011216768473441456,35,13,48
org.apache.camel.component.mina.MinaComponent,4,6,12,0.5,1,0.25,214,53.5,6,0.5,0.3333333333333333,0.08333333333333333,0.0023686158401184307,0.00013046966124600335,1,3,4
org.apache.camel.util.ProducerCache,11,25,110,0.22727272727272727,1,0.09090909090909091,202,18.363636363636363,85,0.7727272727272727,0.0,0.0,0.1178012642857805,0.0008137151620693858,3,10,13
org.apache.camel.component.seda.SedaComponent,4,5,12,0.4166666666666667,1,0.25,218,54.5,7,0.5833333333333334,0.3333333333333333,0.08333333333333333,0.0037009622501850484,0.0002632597338378518,3,3,6
org.apache.camel.component.timer.TimerConsumer,2,1,2,0.5,1,0.5,217,108.5,1,0.5,0.0,0.0,0.0,0.0,0,1,1
org.apache.camel.component.xmpp.XmppGroupChatProducer,5,8,20,0.4,1,0.2,224,44.8,12,0.6,0.125,0.025,0.002878526194588371,2.5423853170934633e-06,1,4,5
org.apache.camel.spring.spi.ApplicationContextRegistry,2,1,2,0.5,1,0.5,0,0.0,1,0.5,0.0,0.0,0.022803007213247996,0.0,1,1,2
org.apache.camel.component.file.remote.RemoteFileProducer,6,8,30,0.26666666666666666,1,0.16666666666666666,240,40.0,22,0.7333333333333333,0.0,0.0,0.0038380349261178275,6.418755091169255e-05,2,5,7
org.apache.camel.builder.ErrorHandlerBuilder,3,6,6,1.0,1,0.3333333333333333,202,67.33333333333333,0,0.0,0.0,0.0,0.21021837744852764,0.0003508813219807994,9,3,12
org.apache.camel.bam.ActivityBuilder,10,23,90,0.25555555555555554,1,0.1,225,22.5,67,0.7444444444444445,0.22916666666666666,0.022916666666666665,0.004478164322723908,9.261858668602641e-05,3,10,13
org.apache.camel.component.cxf.CxfConstants,1,0,0,0,1,1.0,-1,-1.0,0,0,0.0,0.0,0.005678188657818156,0.0,1,0,1
org.apache.camel.model.language.XPathExpression,2,1,2,0.5,1,0.5,203,101.5,1,0.5,0.0,0.0,0.002072538860103627,0.0003956344002137651,1,1,2
org.apache.camel.impl.ProcessorPollingConsumer,6,9,30,0.3,1,0.16666666666666666,205,34.166666666666664,21,0.7,0.0,0.0,0.0030146019783325482,4.303712326200663e-05,1,5,6
org.apache.camel.processor.resequencer.DefaultExchangeComparator,4,4,12,0.3333333333333333,1,0.25,202,50.5,8,0.6666666666666666,0.0,0.0,0.10283178877337698,0.0002161852230650201,1,3,4
org.apache.camel.component.bean.BeanProcessor,13,26,156,0.16666666666666666,1,0.07692307692307693,202,15.538461538461538,130,0.8333333333333334,0.04166666666666667,0.0032051282051282055,0.11989241098907837,0.013720506197448133,5,12,17
org.apache.camel.component.cxf.phase.FaultPayloadPhaseManagerImpl,2,1,2,0.5,1,0.5,0,0.0,1,0.5,0.0,0.0,0.0030847090010844677,0.0,1,1,2
org.apache.camel.Message,2,4,2,2.0,1,0.5,202,101.0,-2,-1.0,0.0,0.0,0.26687297562614504,0.0039817819322742675,61,2,63
org.apache.camel.builder.ConstantProcessorBuilder,2,1,2,0.5,1,0.5,202,101.0,1,0.5,0.0,0.0,0.13279739195513243,0.0,1,1,2
org.apache.camel.component.ibatis.IBatisEndpoint,7,9,42,0.21428571428571427,1,0.14285714285714285,223,31.857142857142858,33,0.7857142857142857,0.5,0.07142857142857142,0.004145077720207254,0.00010817004130701377,4,6,10
org.apache.camel.model.language.ExpressionType,8,11,56,0.19642857142857142,1,0.125,202,25.25,45,0.8035714285714286,0.0,0.0,0.14556707761426094,0.004590457165187258,26,7,33
org.apache.camel.spi.Synchronization,2,2,2,1.0,1,0.5,202,101.0,0,0.0,0.0,0.0,0.18569166509905194,3.404066246712389e-06,3,1,4
org.apache.camel.util.UuidGenerator,1,0,0,0,1,1.0,-1,-1.0,0,0,0.0,0.0,0.10934917224819918,0.0,2,0,2
org.apache.camel.builder.xml.StringResultHandler,3,4,6,0.6666666666666666,1,0.3333333333333333,204,68.0,2,0.3333333333333333,0.0,0.0,0.001381692573402418,0.0001096467654204201,1,2,3
org.apache.camel.Predicate,1,0,0,0,1,1.0,-1,-1.0,0,0,0.0,0.0,0.22978239213882612,0.0,34,0,34
org.apache.camel.bam.model.ProcessDefinition,3,3,6,0.5,1,0.3333333333333333,1,0.3333333333333333,3,0.5,0.0,0.0,0.00833950160375031,1.0731766746214322e-05,6,3,9
org.apache.camel.spring.util.MainRunner,2,1,2,0.5,1,0.5,0,0.0,1,0.5,0.0,0.0,0.0,0.0,0,1,1
org.apache.camel.impl.LoggingExceptionHandler,3,2,6,0.3333333333333333,1,0.3333333333333333,202,67.33333333333333,4,0.6666666666666666,0.0,0.0,0.12459963431551807,0.00010948606309043175,4,2,6
org.apache.camel.impl.converter.EnumTypeConverter,2,1,2,0.5,1,0.5,0,0.0,1,0.5,0.0,0.0,0.13771793805075452,0.0,1,1,2
org.apache.camel.impl.NoPolicy,3,3,6,0.5,1,0.3333333333333333,203,67.66666666666667,3,0.5,0.0,0.0,0.0,0.0,0,2,2
org.apache.camel.component.jms.JmsPollingConsumer,4,5,12,0.4166666666666667,1,0.25,230,57.5,7,0.5833333333333334,0.16666666666666666,0.041666666666666664,0.0033914272256241164,1.6912834404718395e-05,1,3,4
org.apache.camel.model.InterceptorType,3,2,6,0.3333333333333333,1,0.3333333333333333,202,67.33333333333333,4,0.6666666666666666,0.0,0.0,0.17334888248963815,4.9685290236319e-05,12,2,14
org.apache.camel.component.irc.IrcMessage,4,10,12,0.8333333333333334,1,0.25,209,52.25,2,0.16666666666666666,0.3333333333333333,0.08333333333333333,0.004616109279321714,8.510165616780972e-06,4,4,8
org.apache.camel.util.jndi.JndiContext,7,9,42,0.21428571428571427,1,0.14285714285714285,7,1.0,33,0.7857142857142857,0.0,0.0,0.017504551183307657,0.00018396290642759376,15,7,22
org.apache.camel.processor.validation.DefaultValidationErrorHandler,4,6,12,0.5,1,0.25,206,51.5,6,0.5,0.0,0.0,0.004072779852994337,2.0424397480274334e-05,2,3,5
org.apache.camel.processor.SendProcessor,5,7,20,0.35,1,0.2,202,40.4,13,0.65,0.0,0.0,0.16665841628788686,0.00011660981706516135,3,4,7
org.apache.camel.converter.jaxb.ExchangeType,2,1,2,0.5,1,0.5,0,0.0,1,0.5,0.0,0.0,0.0,0.0,0,1,1
org.apache.camel.impl.EventDrivenConsumerRoute,5,6,20,0.3,1,0.2,202,40.4,14,0.7,0.0,0.0,0.1446080850634121,8.399170875252827e-05,4,4,8
org.apache.camel.processor.LoggingErrorHandler,6,8,30,0.26666666666666666,1,0.16666666666666666,202,33.666666666666664,22,0.7333333333333333,0.0,0.0,0.13276392487046632,0.00035911619178662796,1,5,6
org.apache.camel.component.mail.MailConverters,3,3,6,0.5,1,0.3333333333333333,203,67.66666666666667,3,0.5,0.0,0.0,0.0,0.0,0,2,2
org.apache.camel.util.ExchangeHelper,12,31,132,0.23484848484848486,1,0.08333333333333333,202,16.833333333333332,101,0.7651515151515151,0.0,0.0,0.09533247446362837,0.0026839499763759364,8,11,19
org.apache.camel.builder.ExpressionBuilder,4,4,12,0.3333333333333333,1,0.25,203,50.75,8,0.6666666666666666,0.0,0.0,0.0,0.0,0,3,3
org.apache.camel.util.IOHelper,1,0,0,0,1,1.0,-1,-1.0,0,0,0.0,0.0,0.0010362694300518134,0.0,1,0,1
org.apache.camel.component.cxf.interceptors.AbstractMessageInInterceptor,4,4,12,0.3333333333333333,1,0.25,203,50.75,8,0.6666666666666666,0.0,0.0,0.004352331606217617,3.7623890095242194e-06,3,3,6
org.apache.camel.NoSuchEndpointException,2,1,2,0.5,1,0.5,0,0.0,1,0.5,0.0,0.0,0.179750258714765,0.0004354389402655494,10,1,11
org.apache.camel.util.ExpressionHelper,4,4,12,0.3333333333333333,1,0.25,202,50.5,8,0.6666666666666666,0.0,0.0,0.10335633782342757,0.00020988755831702964,2,3,5
org.apache.camel.MessageDriven,1,0,0,0,1,1.0,-1,-1.0,0,0,0.0,0.0,0.002072538860103627,0.0,2,0,2
org.apache.camel.spi.Language,3,2,6,0.3333333333333333,1,0.3333333333333333,1,0.3333333333333333,4,0.6666666666666666,0.0,0.0,0.2681100729873713,0.0007652963721697191,17,2,19
org.apache.camel.spring.handler.LazyLoadingBeanDefinitionParser,2,1,2,0.5,1,0.5,3,1.5,1,0.5,0.0,0.0,0.0018422567645365571,1.0749682884354912e-06,1,1,2
org.apache.camel.model.FinallyType,4,4,12,0.3333333333333333,1,0.25,202,50.5,8,0.6666666666666666,0.0,0.0,0.11910632011892613,0.0,1,3,4
org.apache.camel.util.CollectionStringBuffer,1,0,0,0,1,1.0,-1,-1.0,0,0,0.0,0.0,0.12441121603587124,0.0,4,0,4
org.apache.camel.component.file.strategy.NoOpFileProcessStrategy,2,1,2,0.5,1,0.5,226,113.0,1,0.5,0.0,0.0,0.006720512039012497,0.0,1,1,2
org.apache.camel.language.IllegalSyntaxException,3,2,6,0.3333333333333333,1,0.3333333333333333,3,1.0,4,0.6666666666666666,0.0,0.0,0.00233160621761658,2.687420721088728e-06,2,2,4
org.apache.camel.component.cxf.CxfEndpoint,14,30,182,0.16483516483516483,1,0.07142857142857142,267,19.071428571428573,152,0.8351648351648352,0.19764957264957264,0.014117826617826618,0.006857665345931119,0.0012662066593494368,7,13,20
org.apache.camel.builder.xml.NamespaceBuilder,2,3,2,1.5,1,0.5,210,105.0,-1,-0.5,0.0,0.0,0.0,0.0,1,2,3
org.apache.camel.component.mail.MailConfiguration,4,6,12,0.5,1,0.25,224,56.0,6,0.5,0.16666666666666666,0.041666666666666664,0.00609570252971655,3.8519697002271764e-05,6,4,10
org.apache.camel.component.jmx.JMXConsumer,2,2,2,1.0,1,0.5,219,109.5,0,0.0,0.0,0.0,0.001381692573402418,0.0,1,1,2
org.apache.camel.component.cxf.CamelInvoker,8,24,56,0.42857142857142855,1,0.125,267,33.375,32,0.5714285714285714,0.11904761904761904,0.01488095238095238,0.0063016384259907575,0.0005702337708443528,3,7,10
org.apache.camel.util.IntrospectionSupport,2,1,2,0.5,1,0.5,0,0.0,1,0.5,0.0,0.0,0.14502189518922998,3.106865078249423e-05,10,1,11
org.apache.camel.FailedToCreateProducerException,3,2,6,0.3333333333333333,1,0.3333333333333333,202,67.33333333333333,4,0.6666666666666666,0.0,0.0,0.10173952373233108,3.7623890095242194e-06,1,2,3
org.apache.camel.impl.converter.StaticMethodTypeConverter,3,2,6,0.3333333333333333,1,0.3333333333333333,1,0.3333333333333333,4,0.6666666666666666,0.0,0.0,0.11695602964344824,0.0,1,2,3
org.apache.camel.builder.xml.DefaultNamespaceContext,2,2,2,1.0,1,0.5,2,1.0,0,0.0,0.0,0.0,0.002878526194588371,3.224904865306474e-06,3,2,5
org.apache.camel.util.AsyncProcessorHelper,2,1,2,0.5,1,0.5,203,101.5,1,0.5,0.0,0.0,0.0,0.0,0,1,1
org.apache.camel.bam.rules.ActivityRules,10,31,90,0.34444444444444444,1,0.1,225,22.5,59,0.6555555555555556,0.2569444444444444,0.025694444444444443,0.008956328645447816,0.0013677462278470095,8,9,17
org.apache.camel.component.cxf.transport.CamelTransportFactory,2,1,2,0.5,1,0.5,203,101.5,1,0.5,0.0,0.0,0.0,0.0,0,1,1
org.apache.camel.builder.script.ScriptLanguageResolver,5,8,20,0.4,1,0.2,206,41.2,12,0.6,0.0,0.0,0.0,0.0,0,4,4
org.apache.camel.component.cxf.util.CxfEndpointUtils,7,6,42,0.14285714285714285,1,0.14285714285714285,267,38.142857142857146,36,0.8571428571428571,0.0,0.0,0.004960864292801235,4.9050054854883615e-05,3,6,9
org.apache.camel.component.event.EventConsumer,2,2,2,1.0,1,0.5,221,110.5,0,0.0,0.0,0.0,0.018464437117286854,0.0,1,1,2
org.apache.camel.model.MulticastType,5,6,20,0.3,1,0.2,202,40.4,14,0.7,0.0,0.0,0.14230341812155872,0.0008078328518313048,4,4,8
org.apache.camel.component.validator.jing.JingComponent,4,3,12,0.25,1,0.25,225,56.25,9,0.75,0.0,0.0,0.0010362694300518134,9.38037804075256e-05,1,3,4
org.apache.camel.language.Simple,1,0,0,0,1,1.0,-1,-1.0,0,0,0.0,0.0,0.0032383419689119173,0.0,2,0,2
org.apache.camel.AsyncCallback,1,0,0,0,1,1.0,-1,-1.0,0,0,0.0,0.0,0.1083885946579184,0.0,2,0,2
org.apache.camel.component.bean.XPathAnnotationExpressionFactory,7,9,42,0.21428571428571427,1,0.14285714285714285,206,29.428571428571427,33,0.7857142857142857,0.0,0.0,0.0,0.0,0,6,6
org.apache.camel.builder.Builder,2,2,2,1.0,1,0.5,2,1.0,0,0.0,0.0,0.0,0.17412195463503438,7.660940668916935e-05,4,1,5
org.apache.camel.bam.rules.TemporalRule,13,28,156,0.1794871794871795,1,0.07692307692307693,225,17.307692307692307,128,0.8205128205128205,0.06818181818181818,0.005244755244755244,0.005699481865284974,0.0015058714634133778,3,13,16
org.apache.camel.model.dataformat.ArtixDSDataFormat,5,6,20,0.3,1,0.2,202,40.4,14,0.7,0.0,0.0,0.11918716151267203,1.8197677454229387e-06,1,4,5
org.apache.camel.model.IdentifiedType,1,0,0,0,1,1.0,-1,-1.0,0,0,0.0,0.0,0.006632124352331606,0.0,6,0,6
org.apache.camel.NoSuchLanguageException,2,1,2,0.5,1,0.5,0,0.0,1,0.5,0.0,0.0,0.13711030634899932,1.0749682884354912e-06,1,1,2
org.apache.camel.model.AggregatorType,9,18,72,0.25,1,0.1111111111111111,202,22.444444444444443,54,0.75,0.0,0.0,0.14192005762015364,0.002295057295809774,2,9,11
org.apache.camel.bam.model.ActivityState,7,14,42,0.3333333333333333,1,0.14285714285714285,225,32.142857142857146,28,0.6666666666666666,0.3,0.04285714285714286,0.008359240069084627,0.00011321719580700942,7,6,13
org.apache.camel.component.log.LogComponent,5,6,20,0.3,1,0.2,215,43.0,14,0.7,0.0,0.0,0.0,0.0,0,4,4
org.apache.camel.component.cxf.interceptors.SoapMessageOutInterceptor,5,7,20,0.35,1,0.2,208,41.6,13,0.65,0.25,0.05,0.003426033625885587,1.4512071893879131e-05,1,4,5
org.apache.camel.model.SplitterType,7,13,42,0.30952380952380953,1,0.14285714285714285,202,28.857142857142858,29,0.6904761904761905,0.0,0.0,0.14218819268178418,0.0007899986483527645,3,6,9
org.apache.camel.model.UnmarshalType,7,9,42,0.21428571428571427,1,0.14285714285714285,202,28.857142857142858,33,0.7857142857142857,0.0,0.0,0.14192005762015364,0.0007749540237769344,1,6,7
org.apache.camel.Component,3,5,6,0.8333333333333334,1,0.3333333333333333,202,67.33333333333333,1,0.16666666666666666,0.0,0.0,0.2582388499441227,0.00028822691938380025,16,2,18
org.apache.camel.component.quartz.QuartzConsumer,2,2,2,1.0,1,0.5,224,112.0,0,0.0,0.0,0.0,0.0023686158401184307,0.0,1,1,2
org.apache.camel.component.file.FileComponent,5,9,20,0.45,1,0.2,226,45.2,11,0.55,0.25,0.05,0.010386245878473858,0.0010635719853327554,6,4,10
org.apache.camel.spring.handler.CamelNamespaceHandler,10,17,90,0.18888888888888888,1,0.1,251,25.1,73,0.8111111111111111,0.0625,0.00625,0.002072538860103627,8.575392769059057e-05,2,9,11
org.apache.camel.component.cxf.CxfProducer,14,28,182,0.15384615384615385,1,0.07142857142857142,267,19.071428571428573,154,0.8461538461538461,0.08974358974358974,0.00641025641025641,0.0048575129533678756,8.286768437156504e-05,1,13,14
org.apache.camel.component.mail.MailExchange,7,17,42,0.40476190476190477,1,0.14285714285714285,224,32.0,25,0.5952380952380952,0.26666666666666666,0.03809523809523809,0.0069084628670120895,0.0007493373588336287,6,6,12
org.apache.camel.component.cxf.invoker.PayloadInvokingContext,13,26,156,0.16666666666666666,1,0.07692307692307693,267,20.53846153846154,130,0.8333333333333334,0.0,0.0,0.003330866025166543,0.0003655283495865699,1,12,13
org.apache.camel.bam.ActivityLifecycle,1,0,0,0,1,1.0,-1,-1.0,0,0,0.0,0.0,0.003926915734933188,0.0,2,0,2
org.apache.camel.bam.processor.JpaBamProcessor,5,10,20,0.5,1,0.2,225,45.0,10,0.5,0.0,0.0,0.0040447935818151435,0.00012394028085403427,1,4,5
org.apache.camel.processor.Pipeline,6,12,30,0.4,1,0.16666666666666666,203,33.833333333333336,18,0.6,0.0,0.0,0.0,0.0,0,5,5
org.apache.camel.component.jmx.JMXComponent,5,9,20,0.45,1,0.2,219,43.8,11,0.55,0.25,0.05,0.001381692573402418,0.0001519288514322161,1,4,5
org.apache.camel.impl.converter.DefaultTypeConverter,16,32,240,0.13333333333333333,1,0.0625,202,12.625,208,0.8666666666666667,0.0,0.0,0.16874031194298858,0.014238889095434682,3,15,18
org.apache.camel.builder.script.ScriptLanguage,5,8,20,0.4,1,0.2,205,41.0,12,0.6,0.0,0.0,0.0010362694300518134,5.733164204989286e-06,1,4,5
org.apache.camel.component.mail.MailComponent,4,7,12,0.5833333333333334,1,0.25,224,56.0,5,0.4166666666666667,0.0,0.0,0.004317789291882556,0.00013360064211439095,2,4,6
org.apache.camel.component.mock.AssertionClause,5,11,20,0.55,1,0.2,212,42.4,9,0.45,0.3333333333333333,0.06666666666666667,0.05266350745855844,0.0004994410475136295,11,5,16
org.apache.camel.RuntimeExchangeException,3,3,6,0.5,1,0.3333333333333333,203,67.66666666666667,3,0.5,0.0,0.0,0.0027076717365869963,5.681975238873311e-06,1,2,3
org.apache.camel.component.cxf.CxfMessageObserver,8,21,56,0.375,1,0.125,267,33.375,35,0.625,0.11904761904761904,0.01488095238095238,0.004483858110801115,0.00035411673609596773,1,7,8
org.apache.camel.component.file.remote.SftpConsumer,8,15,56,0.26785714285714285,1,0.125,243,30.375,41,0.7321428571428571,0.08333333333333333,0.010416666666666666,0.001381692573402418,3.269247307204438e-05,1,7,8
org.apache.camel.InvalidTypeException,4,7,12,0.5833333333333334,1,0.25,202,50.5,5,0.4166666666666667,0.0,0.0,0.08455975182761001,2.5981627434330244e-05,1,3,4
org.apache.camel.util.UnsafeUriCharactersEncoder,1,0,0,0,1,1.0,-1,-1.0,0,0,0.0,0.0,0.0534353374830476,0.0,2,0,2
org.apache.camel.model.RoutesType,13,26,156,0.16666666666666666,1,0.07692307692307693,202,15.538461538461538,130,0.8333333333333334,0.0,0.0,0.2021516707160439,0.0026966053724560325,3,13,16
org.apache.camel.processor.CompositeProcessor,4,5,12,0.4166666666666667,1,0.25,203,50.75,7,0.5833333333333334,0.0,0.0,0.0,0.0,0,3,3
org.apache.camel.builder.ErrorHandlerBuilderSupport,4,8,12,0.6666666666666666,1,0.25,202,50.5,4,0.3333333333333333,0.0,0.0,0.13870649128120335,0.0014086427109130438,3,3,6
org.apache.camel.processor.ProceedProcessor,3,4,6,0.6666666666666666,1,0.3333333333333333,202,67.33333333333333,2,0.3333333333333333,0.0,0.0,0.1439364081655766,1.043231129443586e-05,1,2,3
org.apache.camel.component.jms.MessageJMSPropertyAccessException,2,1,2,0.5,1,0.5,0,0.0,1,0.5,0.0,0.0,0.003573342862247633,3.5832276281183037e-07,1,1,2
org.apache.camel.component.file.remote.RemoteFileBinding,2,1,2,0.5,1,0.5,209,104.5,1,0.5,0.0,0.0,0.007297063903281519,0.0,2,1,3
org.apache.camel.component.jmx.JMXExchange,5,9,20,0.45,1,0.2,208,41.6,11,0.55,0.25,0.05,0.002763385146804836,0.0003635184428726019,2,4,6
org.apache.camel.component.file.remote.FtpOperationFailedException,2,1,2,0.5,1,0.5,0,0.0,1,0.5,0.0,0.0,0.0,0.0,0,1,1
org.apache.camel.component.ibatis.IBatisComponent,4,5,12,0.4166666666666667,1,0.25,223,55.75,7,0.5833333333333334,0.3333333333333333,0.08333333333333333,0.0023686158401184307,2.0961881624492077e-05,1,3,4
org.apache.camel.component.jms.JmsExchange,8,25,56,0.44642857142857145,1,0.125,213,26.625,31,0.5535714285714286,0.15476190476190477,0.019345238095238096,0.00699481865284974,0.0010209511319416076,6,7,13
org.apache.camel.model.PolicyRef,5,6,20,0.3,1,0.2,202,40.4,14,0.7,0.0,0.0,0.14192005762015364,5.577037858335559e-06,1,4,5
org.apache.camel.util.CollectionHelper,1,0,0,0,1,1.0,-1,-1.0,0,0,0.0,0.0,0.0037996545768566492,0.0,1,0,1
org.apache.camel.converter.jaxb.IntegerHeader,2,1,2,0.5,1,0.5,0,0.0,1,0.5,0.0,0.0,0.0015544041450777201,0.0,1,1,2
org.apache.camel.PollingConsumer,1,0,0,0,1,1.0,-1,-1.0,0,0,0.0,0.0,0.22988947361300885,0.0,14,0,14
org.apache.camel.model.InterceptorRef,4,5,12,0.4166666666666667,1,0.25,202,50.5,7,0.5833333333333334,0.0,0.0,0.16729350710892674,3.0823578138307357e-06,3,3,6
org.apache.camel.component.file.remote.RemoteFileConsumer,4,4,12,0.3333333333333333,1,0.25,240,60.0,8,0.6666666666666666,0.0,0.0,0.0038380349261178275,3.560832455442565e-05,2,3,5
org.apache.camel.Processor,2,2,2,1.0,1,0.5,202,101.0,0,0.0,0.0,0.0,0.26919123857230987,0.002634313386673106,100,1,101
org.apache.camel.AlreadyStoppedException,2,1,2,0.5,1,0.5,0,0.0,1,0.5,0.0,0.0,0.09061509611710022,0.00047082642894332756,1,1,2
org.apache.camel.converter.IOConverter,3,2,6,0.3333333333333333,1,0.3333333333333333,1,0.3333333333333333,4,0.6666666666666666,0.0,0.0,0.09194592941420551,5.926146607246516e-05,6,2,8
org.apache.camel.Header,1,0,0,0,1,1.0,-1,-1.0,0,0,0.0,0.0,0.09110349774346317,0.0,2,0,2
org.apache.camel.component.bean.CamelInvocationHandler,7,15,42,0.35714285714285715,1,0.14285714285714285,208,29.714285714285715,27,0.6428571428571429,0.0,0.0,0.0034905917643850556,5.1240155082091744e-05,2,6,8
org.apache.camel.component.file.remote.RemoteFileConfiguration,1,1,0,0,1,1.0,-1,-1.0,-1,0,0.0,0.0,0.009645277002789956,0.0,10,1,11
org.apache.camel.component.mail.MailConsumer,6,12,30,0.4,1,0.16666666666666666,224,37.333333333333336,18,0.6,0.1,0.016666666666666666,0.0041450777202072546,4.179067193708262e-05,1,5,6
org.apache.camel.component.bean.BeanInvocation,2,2,2,1.0,1,0.5,202,101.0,0,0.0,0.0,0.0,0.10462904744508646,0.00021660611011975144,5,1,6
org.apache.camel.util.Time,1,1,0,0,1,1.0,-1,-1.0,-1,0,0.0,0.0,0.004388905821395916,0.0,2,1,3
org.apache.camel.spring.spi.SpringInjector,2,1,2,0.5,1,0.5,0,0.0,1,0.5,0.0,0.0,0.022803007213247996,0.0,1,1,2
org.apache.camel.NoSuchPropertyException,3,4,6,0.6666666666666666,1,0.3333333333333333,202,67.33333333333333,2,0.3333333333333333,0.0,0.0,0.09683956872904602,2.866904815541897e-05,4,2,6
org.apache.camel.component.bean.AnnotationExpressionFactory,3,2,6,0.3333333333333333,1,0.3333333333333333,202,67.33333333333333,4,0.6666666666666666,0.0,0.0,0.09095429107147969,0.0,2,2,4
org.apache.camel.spi.DataFormat,2,2,2,1.0,1,0.5,202,101.0,0,0.0,0.0,0.0,0.14516595587930844,0.00014258413464011898,12,1,13
org.apache.camel.model.dataformat.SerializationDataFormat,5,7,20,0.35,1,0.2,202,40.4,13,0.65,0.0,0.0,0.11916020219090938,0.0016655635444468673,1,4,5
org.apache.camel.component.timer.TimerEndpoint,6,6,30,0.2,1,0.16666666666666666,216,36.0,24,0.8,0.2,0.03333333333333333,0.002072538860103627,0.0002463468994331334,2,5,7
org.apache.camel.converter.jaxb.FallbackTypeConverter,3,3,6,0.5,1,0.3333333333333333,1,0.3333333333333333,3,0.5,0.0,0.0,0.0,0.0,0,2,2
org.apache.camel.component.mina.MinaConsumer,3,2,6,0.3333333333333333,1,0.3333333333333333,216,72.0,4,0.6666666666666666,0.0,0.0,0.0,0.0,0,2,2
org.apache.camel.converter.jaxb.JaxbConverter,7,12,42,0.2857142857142857,1,0.14285714285714285,213,30.428571428571427,30,0.7142857142857143,0.0,0.0,0.0010362694300518134,2.2448921090161174e-05,1,6,7
org.apache.camel.component.mina.MinaProducer,4,7,12,0.5833333333333334,1,0.25,214,53.5,5,0.4166666666666667,0.5,0.125,0.002763385146804836,4.630391000868072e-05,2,3,5
org.apache.camel.component.cxf.CxfSoapEndpoint,9,23,72,0.3194444444444444,1,0.1111111111111111,203,22.555555555555557,49,0.6805555555555556,0.0,0.0,0.0031088082901554403,0.00019546506711385346,3,8,11
org.apache.camel.converter.jaxp.XmlConverter,8,10,56,0.17857142857142858,1,0.125,9,1.125,46,0.8214285714285714,0.0,0.0,0.004317789291882556,4.031131081633092e-05,4,7,11
org.apache.camel.impl.NoRouteBuilder,1,1,0,0,1,1.0,-1,-1.0,-1,0,0.0,0.0,0.0031088082901554403,0.0,4,1,5
org.apache.camel.component.rmi.RmiProducer,4,6,12,0.5,1,0.25,215,53.75,6,0.5,0.3333333333333333,0.08333333333333333,0.001381692573402418,9.44436424839753e-07,1,3,4
org.apache.camel.ValidationException,3,4,6,0.6666666666666666,1,0.3333333333333333,203,67.66666666666667,2,0.3333333333333333,0.0,0.0,0.004210872604654988,2.7949175499322773e-05,2,2,4
org.apache.camel.Body,1,0,0,0,1,1.0,-1,-1.0,0,0,0.0,0.0,0.09097399868481046,0.0,2,0,2
org.apache.camel.bam.processor.ActivityMonitorEngine,4,5,12,0.4166666666666667,1,0.25,226,56.5,7,0.5833333333333334,0.0,0.0,0.0,0.0,0,3,3
org.apache.camel.component.cxf.interceptors.AbstractInvokerInterceptor,6,14,30,0.4666666666666667,1,0.16666666666666666,267,44.5,16,0.5333333333333333,0.0,0.0,0.003480009280024747,0.0006178347006717569,2,5,7
org.apache.camel.component.jms.ConsumerType,1,0,0,0,1,1.0,-1,-1.0,0,0,0.0,0.0,0.009136442141623489,0.0,2,0,2
org.apache.camel.component.jdbc.JdbcEndpoint,7,8,42,0.19047619047619047,1,0.14285714285714285,217,31.0,34,0.8095238095238095,0.3333333333333333,0.047619047619047616,0.002072538860103627,3.986340736281613e-05,2,6,8
org.apache.camel.model.language.HeaderExpression,2,1,2,0.5,1,0.5,203,101.5,1,0.5,0.0,0.0,0.0,0.0,0,1,1
org.apache.camel.processor.loadbalancer.RoundRobinLoadBalancer,4,7,12,0.5833333333333334,1,0.25,206,51.5,5,0.4166666666666667,0.0,0.0,0.003730569948186528,1.4341868581543512e-05,2,3,5
org.apache.camel.bam.model.ActivityDefinition,3,4,6,0.6666666666666666,1,0.3333333333333333,2,0.6666666666666666,2,0.3333333333333333,0.0,0.0,0.007105847520355292,5.89440944825461e-06,3,2,5
org.apache.camel.impl.ExpressionSupport,2,1,2,0.5,1,0.5,0,0.0,1,0.5,0.0,0.0,0.0010362694300518134,2.687420721088728e-07,1,1,2
org.apache.camel.model.language.OgnlExpression,2,1,2,0.5,1,0.5,203,101.5,1,0.5,0.0,0.0,0.001381692573402418,0.00025042836633144713,1,1,2
org.apache.camel.component.file.remote.FtpEndpoint,6,13,30,0.43333333333333335,1,0.16666666666666666,240,40.0,17,0.5666666666666667,0.55,0.09166666666666667,0.0051813471502590676,0.00013690838593518912,4,5,9
org.apache.camel.component.cxf.invoker.PayloadMessage,2,1,2,0.5,1,0.5,2,1.0,1,0.5,0.0,0.0,0.0030847090010844677,4.031131081633092e-05,1,1,2
org.apache.camel.builder.PredicateFactory,2,1,2,0.5,1,0.5,0,0.0,1,0.5,0.0,0.0,0.0,0.0,0,1,1
org.apache.camel.processor.RedeliveryPolicy,1,1,0,0,1,1.0,-1,-1.0,-1,0,0.0,0.0,0.16488230294996523,0.0,6,1,7
org.apache.camel.model.NodeFactory,3,3,6,0.5,1,0.3333333333333333,202,67.33333333333333,3,0.5,0.0,0.0,0.14192005762015364,0.0,1,2,3
org.apache.camel.spring.SpringInstrumentationAgent,2,1,2,0.5,1,0.5,213,106.5,1,0.5,0.0,0.0,0.0033914272256241164,2.2236486880779873e-05,2,1,3
org.apache.camel.processor.RecipientList,6,13,30,0.43333333333333335,1,0.16666666666666666,202,33.666666666666664,17,0.5666666666666667,0.0,0.0,0.1390726647006363,0.001574476729724282,3,5,8
