name,Size,Ties,Pairs,Density,WeakComp,nWeakComp,2StepReach,ReachEffic,Broker,nBroker,EgoBetween,nEgoBetween,Closeness_Centrality,Betweenness_Centrality,in_degree,out_degree,degree
org.apache.poi.hssf.record.ValueRangeRecord,6,5,30,0.16666666666666666,1,0.16666666666666666,6,1.0,25,0.8333333333333334,0.0,0.0,0.0030234315948601664,3.964289678575393e-07,1,5,6
org.apache.poi.ddf.EscherRecord,5,10,20,0.5,1,0.2,6,1.2,10,0.5,0.6666666666666666,0.13333333333333333,0.11703088314972007,0.0011538954643469184,30,5,35
org.apache.poi.hssf.usermodel.HSSFRow,6,14,30,0.4666666666666667,1,0.16666666666666666,247,41.166666666666664,16,0.5333333333333333,0.0,0.0,0.02110587824873539,0.006965129644727346,4,5,9
org.apache.poi.hssf.record.ObjectLinkRecord,5,4,20,0.2,1,0.2,5,1.0,16,0.8,0.0,0.0,0.0030234315948601664,0.0,1,4,5
org.apache.poi.hssf.record.formula.NamePtg,5,12,20,0.6,1,0.2,182,36.4,8,0.4,0.125,0.025,0.05785672293608802,3.3969815200489286e-05,2,4,6
org.apache.poi.hssf.record.PasswordRev4Record,4,3,12,0.25,1,0.25,4,1.0,9,0.75,0.0,0.0,0.07207207207207207,1.0758820475889111e-05,4,3,7
org.apache.poi.ddf.EscherBoolProperty,2,1,2,0.5,1,0.5,7,3.5,1,0.5,0.0,0.0,0.07833772964968301,0.00020442520442520443,5,1,6
org.apache.poi.hssf.model.TextboxShape,19,48,342,0.14035087719298245,1,0.05263157894736842,271,14.263157894736842,294,0.8596491228070176,0.01797385620915033,0.0009459924320605436,0.007086167800453515,0.00013321995464852607,2,18,20
org.apache.poi.hssf.usermodel.HSSFPatriarch,9,23,72,0.3194444444444444,1,0.1111111111111111,263,29.22222222222222,49,0.6805555555555556,0.5178571428571428,0.05753968253968253,0.015625,0.0008862433862433861,2,8,10
org.apache.poi.poifs.property.DirectoryProperty,6,8,30,0.26666666666666666,1,0.16666666666666666,20,3.3333333333333335,22,0.7333333333333333,0.0,0.0,0.026533996683250412,0.0006740755465245264,6,5,11
org.apache.poi.hssf.usermodel.HSSFHeader,2,1,2,0.5,1,0.5,6,3.0,1,0.5,0.0,0.0,0.01613978924903295,3.0741493326527337e-05,1,1,2
org.apache.poi.hssf.record.formula.Ref3DPtg,8,12,56,0.21428571428571427,1,0.125,182,22.75,44,0.7857142857142857,0.10714285714285714,0.013392857142857142,0.061260059579387315,0.0002733076378716453,3,7,10
org.apache.poi.hssf.record.LabelSSTRecord,5,5,20,0.25,1,0.2,5,1.0,15,0.75,0.0,0.0,0.02670940170940171,1.890785562522282e-05,6,4,10
org.apache.poi.hssf.record.TextRecord,6,5,30,0.16666666666666666,1,0.16666666666666666,6,1.0,25,0.8333333333333334,0.0,0.0,0.0030234315948601664,3.964289678575393e-07,1,5,6
org.apache.poi.hssf.record.DBCellRecord,4,3,12,0.25,1,0.25,4,1.0,9,0.75,0.0,0.0,0.025025025025025023,5.303238528346753e-07,4,3,7
org.apache.poi.hssf.record.DatRecord,6,5,30,0.16666666666666666,1,0.16666666666666666,6,1.0,25,0.8333333333333334,0.0,0.0,0.0030234315948601664,3.964289678575393e-07,1,5,6
org.apache.poi.poifs.property.PropertyConstants,1,0,0,0,1,1.0,-1,-1.0,0,0,0.0,0.0,0.02818618486821252,0.0,5,0,5
org.apache.poi.hpsf.SpecialPropertySet,4,6,12,0.5,1,0.25,17,4.25,6,0.5,0.0,0.0,0.00510204081632653,2.0614306328592042e-05,2,3,5
org.apache.poi.hssf.record.DefaultColWidthRecord,4,3,12,0.25,1,0.25,4,1.0,9,0.75,0.0,0.0,0.025025025025025023,5.303238528346753e-07,4,3,7
org.apache.poi.hssf.usermodel.HSSFSheet,26,75,650,0.11538461538461539,1,0.038461538461538464,263,10.115384615384615,575,0.8846153846153846,0.04,0.0015384615384615385,0.021739130434782605,0.012454042241281727,7,26,33
org.apache.poi.hssf.eventusermodel.HSSFListener,2,1,2,0.5,1,0.5,0,0.0,1,0.5,0.0,0.0,0.009070294784580497,0.0,3,1,4
org.apache.poi.hssf.record.EscherAggregate,29,93,812,0.1145320197044335,1,0.034482758620689655,272,9.379310344827585,719,0.8854679802955665,0.0,0.0,0.0,0.0,1,29,30
org.apache.poi.hssf.usermodel.HSSFWorkbook,30,85,870,0.09770114942528736,1,0.03333333333333333,341,11.366666666666667,785,0.9022988505747126,0.0,0.0,0.01020408163265306,0.004995087320389513,4,29,33
org.apache.poi.hssf.record.WindowOneRecord,5,4,20,0.2,1,0.2,5,1.0,16,0.8,0.0,0.0,0.07207207207207207,4.7986143417497765e-05,4,4,8
org.apache.poi.hssf.record.ColumnInfoRecord,5,4,20,0.2,1,0.2,5,1.0,16,0.8,0.0,0.0,0.026239067055393587,3.136721183257979e-05,5,4,9
org.apache.poi.poifs.storage.HeaderBlockWriter,9,12,72,0.16666666666666666,1,0.1111111111111111,11,1.2222222222222223,60,0.8333333333333334,0.0,0.0,0.01889644746787604,0.00027929275639155046,2,8,10
org.apache.poi.util.FixedField,1,0,0,0,1,1.0,-1,-1.0,0,0,0.0,0.0,0.02999443290290168,0.0,4,0,4
org.apache.poi.hssf.record.ProtectRecord,4,3,12,0.25,1,0.25,4,1.0,9,0.75,0.0,0.0,0.0792079207920792,2.5699639047892117e-05,6,3,9
org.apache.poi.hssf.record.SubRecord,6,9,30,0.3,1,0.16666666666666666,10,1.6666666666666667,21,0.7,0.6000000000000001,0.10000000000000002,0.02619501133786848,0.0005978148835291692,4,5,9
org.apache.poi.hssf.record.AxisOptionsRecord,6,5,30,0.16666666666666666,1,0.16666666666666666,6,1.0,25,0.8333333333333334,0.0,0.0,0.0030234315948601664,3.964289678575393e-07,1,5,6
org.apache.poi.poifs.storage.BlockListImpl,4,7,12,0.5833333333333334,1,0.25,14,3.5,5,0.4166666666666667,0.0,0.0,0.01740064446831364,0.00014816532673675532,4,3,7
org.apache.poi.hssf.record.PasswordRecord,4,3,12,0.25,1,0.25,4,1.0,9,0.75,0.0,0.0,0.07207207207207207,1.0758820475889111e-05,4,3,7
org.apache.poi.hssf.record.formula.ReferencePtg,6,9,30,0.3,1,0.16666666666666666,182,30.333333333333332,21,0.7,0.15000000000000002,0.025000000000000005,0.05785672293608802,8.878096524973455e-05,2,5,7
org.apache.poi.hssf.record.TabIdRecord,4,3,12,0.25,1,0.25,4,1.0,9,0.75,0.0,0.0,0.07207207207207207,1.0758820475889111e-05,4,3,7
org.apache.poi.hssf.record.Record,1,0,0,0,1,1.0,-1,-1.0,0,0,0.0,0.0,0.37133337299934555,0.0,151,0,151
org.apache.poi.hssf.record.RecalcIdRecord,4,3,12,0.25,1,0.25,4,1.0,9,0.75,0.0,0.0,0.07017543859649122,1.0758820475889111e-05,2,3,5
org.apache.poi.hssf.usermodel.HSSFDateUtil,3,4,6,0.6666666666666666,1,0.3333333333333333,246,82.0,2,0.3333333333333333,0.0,0.0,0.014512471655328797,0.0,1,2,3
org.apache.poi.hssf.record.PrintHeadersRecord,4,3,12,0.25,1,0.25,4,1.0,9,0.75,0.0,0.0,0.025025025025025023,5.303238528346753e-07,4,3,7
org.apache.poi.hssf.usermodel.HSSFAnchor,1,0,0,0,1,1.0,-1,-1.0,0,0,0.0,0.0,0.02499055177626606,0.0,11,0,11
org.apache.poi.hssf.usermodel.HSSFFont,2,1,2,0.5,1,0.5,7,3.5,1,0.5,0.0,0.0,0.025960539979231565,0.00014364799157438784,5,1,6
org.apache.poi.poifs.dev.POIFSViewable,1,0,0,0,1,1.0,-1,-1.0,0,0,0.0,0.0,0.03607503607503607,0.0,7,0,7
org.apache.poi.hpsf.Property,5,7,20,0.35,1,0.2,6,1.2,13,0.65,0.0,0.0,0.03135665040426946,0.0007497226884981985,7,4,11
org.apache.poi.ddf.EscherShapePathProperty,2,1,2,0.5,1,0.5,7,3.5,1,0.5,0.0,0.0,0.047389490775734164,1.7178588607160035e-06,3,1,4
org.apache.poi.poifs.filesystem.DocumentDescriptor,2,2,2,1.0,1,0.5,0,0.0,0,0.0,0.0,0.0,0.0030234315948601664,0.0,1,1,2
org.apache.poi.hssf.record.FontIndexRecord,5,4,20,0.2,1,0.2,5,1.0,16,0.8,0.0,0.0,0.0030234315948601664,0.0,1,4,5
org.apache.poi.hssf.record.formula.LessEqualPtg,3,3,6,0.5,1,0.3333333333333333,182,60.666666666666664,3,0.5,0.0,0.0,0.05807180369049726,1.0307153164296021e-05,2,2,4
org.apache.poi.hssf.usermodel.HSSFShapeGroup,8,19,56,0.3392857142857143,1,0.125,263,32.875,37,0.6607142857142857,0.0,0.0,0.013513513513513513,4.552325980897409e-05,4,8,12
org.apache.poi.util.CommonsLogger,2,1,2,0.5,1,0.5,1,0.5,1,0.5,0.0,0.0,0.0,0.0,0,1,1
org.apache.poi.ddf.EscherSplitMenuColorsRecord,7,11,42,0.2619047619047619,1,0.14285714285714285,9,1.2857142857142858,31,0.7380952380952381,0.0,0.0,0.07376444553725105,0.00014701728446317192,2,6,8
org.apache.poi.util.HexRead,1,0,0,0,1,1.0,-1,-1.0,0,0,0.0,0.0,0.0022675736961451248,0.0,1,0,1
org.apache.poi.hssf.model.DrawingManager,4,6,12,0.5,1,0.25,12,3.0,6,0.5,0.0,0.0,0.06896551724137931,0.00041376062209395534,3,3,6
org.apache.poi.hssf.record.DrawingSelectionRecord,2,1,2,0.5,1,0.5,37,18.5,1,0.5,0.0,0.0,0.012698412698412698,0.00021090473007603496,2,1,3
org.apache.poi.hssf.usermodel.HSSFFooter,2,1,2,0.5,1,0.5,6,3.0,1,0.5,0.0,0.0,0.01613978924903295,3.0741493326527337e-05,1,1,2
org.apache.poi.ddf.EscherProperty,2,1,2,0.5,1,0.5,1,0.5,1,0.5,0.0,0.0,0.06599326599326599,1.8037518037518038e-05,3,1,4
org.apache.poi.hssf.record.GutsRecord,4,3,12,0.25,1,0.25,4,1.0,9,0.75,0.0,0.0,0.025025025025025023,5.303238528346753e-07,4,3,7
org.apache.poi.hssf.util.Region,2,2,2,1.0,1,0.5,0,0.0,0,0.0,0.0,0.0,0.016380681625884186,3.6762179619322465e-05,3,2,5
org.apache.poi.hssf.record.SCLRecord,5,4,20,0.2,1,0.2,5,1.0,16,0.8,0.0,0.0,0.02354357380812407,6.325169480495715e-05,3,4,7
org.apache.poi.hssf.record.NumberRecord,5,5,20,0.25,1,0.2,5,1.0,15,0.75,0.0,0.0,0.027988338192419825,1.890785562522282e-05,7,4,11
org.apache.poi.ddf.DefaultEscherRecordFactory,19,57,342,0.16666666666666666,1,0.05263157894736842,34,1.7894736842105263,285,0.8333333333333334,0.0,0.0,0.059672595505533325,0.004138902795365381,2,18,20
org.apache.poi.ddf.EscherTextboxRecord,7,11,42,0.2619047619047619,1,0.14285714285714285,9,1.2857142857142858,31,0.7380952380952381,0.0,0.0,0.04697531186387598,3.2148501536256633e-06,1,6,7
org.apache.poi.hssf.dev.EFHSSFListener,4,6,12,0.5,1,0.25,348,87.0,6,0.5,0.16666666666666666,0.041666666666666664,0.0022675736961451248,2.5767882910740053e-06,1,3,4
org.apache.poi.hssf.record.formula.MultiplyPtg,4,8,12,0.6666666666666666,1,0.25,182,45.5,4,0.3333333333333333,0.16666666666666666,0.041666666666666664,0.05785672293608802,1.0307153164296021e-05,2,3,5
org.apache.poi.hssf.model.AbstractShape,20,79,380,0.20789473684210527,1,0.05,271,13.55,301,0.7921052631578948,0.09770955165692008,0.004885477582846004,0.011337868480725623,0.0003655603655603656,6,20,26
org.apache.poi.hssf.record.MulRKRecord,6,5,30,0.16666666666666666,1,0.16666666666666666,6,1.0,25,0.8333333333333334,0.0,0.0,0.015276285952977682,0.0001237502576788291,3,5,8
org.apache.poi.hssf.record.ExtSSTRecord,5,6,20,0.3,1,0.2,5,1.0,14,0.7,0.0,0.0,0.0795123244102836,0.0004809367906538592,6,4,10
org.apache.poi.hssf.record.formula.MissingArgPtg,3,6,6,1.0,1,0.3333333333333333,182,60.666666666666664,0,0.0,0.0,0.0,0.05764322949351943,0.0,1,2,3
org.apache.poi.hssf.record.PageBreakRecord,5,4,20,0.2,1,0.2,5,1.0,16,0.8,0.0,0.0,0.02938775510204081,0.00011285877363281518,4,4,8
org.apache.poi.poifs.storage.DocumentBlock,5,7,20,0.35,1,0.2,5,1.0,13,0.65,0.0,0.0,0.02243564092303588,6.364667078952792e-05,3,5,8
org.apache.poi.ddf.EscherPropertyFactory,10,20,90,0.2222222222222222,1,0.1,12,1.2,70,0.7777777777777778,0.0,0.0,0.05904961565338923,0.0015177283034425889,1,9,10
org.apache.poi.hssf.record.GridsetRecord,4,3,12,0.25,1,0.25,4,1.0,9,0.75,0.0,0.0,0.025025025025025023,5.303238528346753e-07,4,3,7
org.apache.poi.poifs.storage.HeaderBlockConstants,1,0,0,0,1,1.0,-1,-1.0,0,0,0.0,0.0,0.016867971678467302,0.0,2,0,2
org.apache.poi.hssf.record.formula.FuncPtg,3,2,6,0.3333333333333333,1,0.3333333333333333,182,60.666666666666664,4,0.6666666666666666,0.0,0.0,0.0582884895251633,0.0002304642378853882,2,2,4
org.apache.poi.hssf.dev.FormulaViewer,11,25,110,0.22727272727272727,1,0.09090909090909091,308,28.0,85,0.7727272727272727,0.0,0.0,0.0,0.0,0,10,10
org.apache.poi.hssf.usermodel.HSSFName,4,7,12,0.5833333333333334,1,0.25,183,45.75,5,0.4166666666666667,0.0,0.0,0.007407407407407407,1.8037518037518038e-05,1,3,4
org.apache.poi.poifs.property.DocumentProperty,4,6,12,0.5,1,0.25,28,7.0,6,0.5,0.08333333333333333,0.020833333333333332,0.02204081632653061,0.00015509811428178775,4,3,7
org.apache.poi.hssf.usermodel.HSSFPrintSetup,2,1,2,0.5,1,0.5,6,3.0,1,0.5,0.0,0.0,0.016884702598988315,3.6762179619322465e-05,2,1,3
org.apache.poi.hssf.model.ConvertAnchor,7,11,42,0.2619047619047619,1,0.14285714285714285,264,37.714285714285715,31,0.7380952380952381,0.0,0.0,0.008163265306122448,0.0006106988249845391,2,6,8
org.apache.poi.poifs.storage.BATBlock,5,4,20,0.2,1,0.2,7,1.4,16,0.8,0.0,0.0,0.0277459298326072,0.00018222582935399886,4,4,8
org.apache.poi.ddf.EscherBSERecord,6,10,30,0.3333333333333333,1,0.16666666666666666,8,1.3333333333333333,20,0.6666666666666666,0.0,0.0,0.04697531186387598,3.2148501536256633e-06,1,5,6
org.apache.poi.util.LittleEndianConsts,1,0,0,0,1,1.0,-1,-1.0,0,0,0.0,0.0,0.29600630649304965,0.0,16,0,16
org.apache.poi.hssf.record.MMSRecord,4,3,12,0.25,1,0.25,4,1.0,9,0.75,0.0,0.0,0.07207207207207207,1.0758820475889111e-05,4,3,7
org.apache.poi.hssf.record.HeaderRecord,5,4,20,0.2,1,0.2,5,1.0,16,0.8,0.0,0.0,0.026239067055393587,3.755213441360627e-05,5,4,9
org.apache.poi.hssf.record.StringRecord,5,4,20,0.2,1,0.2,5,1.0,16,0.8,0.0,0.0,0.027471755663917487,2.9628510418553708e-05,6,4,10
org.apache.poi.poifs.eventfilesystem.POIFSReaderRegistry,4,5,12,0.4166666666666667,1,0.25,66,16.5,7,0.5833333333333334,0.0,0.0,0.0022675736961451248,5.153576582148011e-06,1,3,4
org.apache.poi.util.LongField,4,4,12,0.3333333333333333,1,0.25,3,0.75,8,0.6666666666666666,0.0,0.0,0.016867971678467302,3.3555230872794264e-05,2,3,5
org.apache.poi.hssf.record.FontBasisRecord,5,4,20,0.2,1,0.2,5,1.0,16,0.8,0.0,0.0,0.0030234315948601664,0.0,1,4,5
org.apache.poi.hssf.record.SheetPropertiesRecord,6,5,30,0.16666666666666666,1,0.16666666666666666,6,1.0,25,0.8333333333333334,0.0,0.0,0.0030234315948601664,3.964289678575393e-07,1,5,6
org.apache.poi.hssf.record.BOFRecord,4,3,12,0.25,1,0.25,4,1.0,9,0.75,0.0,0.0,0.07407407407407407,2.1826367876151434e-05,7,3,10
org.apache.poi.hssf.model.Node,3,4,6,0.6666666666666666,1,0.3333333333333333,183,61.0,2,0.3333333333333333,0.0,0.0,0.01563138916768893,0.0,1,2,3
org.apache.poi.hssf.record.RecordProcessor,6,10,30,0.3333333333333333,1,0.16666666666666666,16,2.6666666666666665,20,0.6666666666666666,0.0,0.0,0.04582002869174881,0.00034863945578231297,1,5,6
org.apache.poi.hssf.record.HorizontalPageBreakRecord,2,1,2,0.5,1,0.5,6,3.0,1,0.5,0.0,0.0,0.012698412698412698,3.6075036075036075e-05,2,1,3
org.apache.poi.poifs.storage.BigBlock,2,1,2,0.5,1,0.5,0,0.0,1,0.5,0.0,0.0,0.03048838583052269,4.6382189239332094e-05,6,1,7
org.apache.poi.hssf.record.CommonObjectDataSubRecord,6,6,30,0.2,1,0.16666666666666666,10,1.6666666666666667,24,0.8,0.2,0.03333333333333333,0.02168461203465934,9.863577465618282e-05,6,5,11
org.apache.poi.poifs.storage.BlockWritable,1,0,0,0,1,1.0,-1,-1.0,0,0,0.0,0.0,0.043039437997421194,0.0,8,0,8
org.apache.poi.hssf.record.EOFRecord,4,3,12,0.25,1,0.25,4,1.0,9,0.75,0.0,0.0,0.07272727272727272,1.7409016520024564e-05,6,3,9
org.apache.poi.hssf.record.LegendRecord,6,5,30,0.16666666666666666,1,0.16666666666666666,6,1.0,25,0.8333333333333334,0.0,0.0,0.0030234315948601664,3.964289678575393e-07,1,5,6
org.apache.poi.hssf.record.MulBlankRecord,4,3,12,0.25,1,0.25,4,1.0,9,0.75,0.0,0.0,0.015276285952977682,6.441970727685014e-08,3,3,6
org.apache.poi.util.StringUtil,1,0,0,0,1,1.0,-1,-1.0,0,0,0.0,0.0,0.0974124809741248,0.0,15,0,15
org.apache.poi.hssf.record.CalcModeRecord,4,3,12,0.25,1,0.25,4,1.0,9,0.75,0.0,0.0,0.025025025025025023,5.303238528346753e-07,4,3,7
org.apache.poi.hssf.record.BeginRecord,4,3,12,0.25,1,0.25,4,1.0,9,0.75,0.0,0.0,0.0030234315948601664,0.0,1,3,4
org.apache.poi.ddf.EscherClientDataRecord,6,10,30,0.3333333333333333,1,0.16666666666666666,8,1.3333333333333333,20,0.6666666666666666,0.0,0.0,0.049776007964161276,1.3669248363125914e-05,4,5,9
org.apache.poi.hssf.record.LabelRecord,6,6,30,0.2,1,0.16666666666666666,6,1.0,24,0.8,0.0,0.0,0.025025025025025023,1.190695570720308e-05,4,5,9
org.apache.poi.hssf.record.FooterRecord,5,4,20,0.2,1,0.2,5,1.0,16,0.8,0.0,0.0,0.026239067055393587,3.755213441360627e-05,5,4,9
org.apache.poi.hssf.record.formula.AreaPtg,7,11,42,0.2619047619047619,1,0.14285714285714285,182,26.0,31,0.7380952380952381,0.13333333333333333,0.019047619047619046,0.05785672293608802,0.0002302180114486854,2,6,8
org.apache.poi.hssf.record.CustomField,1,0,0,0,1,1.0,-1,-1.0,0,0,0.0,0.0,0.0036281179138321997,0.0,1,0,1
org.apache.poi.ddf.EscherDggRecord,8,12,56,0.21428571428571427,1,0.125,10,1.25,44,0.7857142857142857,0.0,0.0,0.07541276215975011,0.0006361060175995238,3,7,10
org.apache.poi.hssf.record.formula.UnionPtg,3,3,6,0.5,1,0.3333333333333333,182,60.666666666666664,3,0.5,0.0,0.0,0.060313958273141954,3.865182436611006e-05,2,2,4
org.apache.poi.poifs.filesystem.POIFSDocumentPath,1,1,0,0,1,1.0,-1,-1.0,-1,0,0.0,0.0,0.03306878306878307,0.0,11,1,12
org.apache.poi.poifs.storage.SmallBlockTableWriter,8,16,56,0.2857142857142857,1,0.125,44,5.5,40,0.7142857142857143,0.0,0.0,0.01666036785084404,6.055452484023912e-05,1,7,8
org.apache.poi.hssf.record.aggregates.RowRecordsAggregate,3,3,6,0.5,1,0.3333333333333333,6,2.0,3,0.5,0.0,0.0,0.017041868293709236,0.0,1,2,3
org.apache.poi.hssf.record.formula.AttrPtg,5,5,20,0.25,1,0.2,182,36.4,15,0.75,0.0,0.0,0.05807180369049726,3.094638360562911e-05,2,4,6
org.apache.poi.util.POILogger,2,1,2,0.5,1,0.5,0,0.0,1,0.5,0.0,0.0,0.08205649861190582,0.00010336825271890202,10,1,11
org.apache.poi.hpsf.Thumbnail,3,2,6,0.3333333333333333,1,0.3333333333333333,3,1.0,4,0.6666666666666666,0.0,0.0,0.0,0.0,0,2,2
org.apache.poi.ddf.EscherRGBProperty,2,1,2,0.5,1,0.5,7,3.5,1,0.5,0.0,0.0,0.07770341604928072,0.00020098948670377241,3,1,4
org.apache.poi.hssf.model.PolygonShape,17,47,272,0.17279411764705882,1,0.058823529411764705,271,15.941176470588236,225,0.8272058823529411,0.021527777777777778,0.0012663398692810458,0.0062988158226253465,3.9682539682539676e-05,1,16,17
org.apache.poi.hssf.util.HSSFColor,47,92,2162,0.0425531914893617,1,0.02127659574468085,45,0.9574468085106383,2070,0.9574468085106383,1.0,0.02127659574468085,0.14274416765519968,0.030869923727066585,51,46,97
org.apache.poi.hssf.record.UnicodeString,4,3,12,0.25,1,0.25,4,1.0,9,0.75,0.0,0.0,0.06156648451730419,4.75846904418333e-05,6,3,9
org.apache.poi.util.IOUtils,1,0,0,0,1,1.0,-1,-1.0,0,0,0.0,0.0,0.027986123224218465,0.0,3,0,3
org.apache.poi.hssf.record.formula.NumberPtg,4,7,12,0.5833333333333334,1,0.25,182,45.5,5,0.4166666666666667,0.16666666666666666,0.041666666666666664,0.05785672293608802,7.4288958024270325e-06,2,3,5
org.apache.poi.poifs.storage.RawDataBlock,4,3,12,0.25,1,0.25,2,0.5,9,0.75,0.0,0.0,0.030934479054779807,9.121830550401978e-05,5,3,8
org.apache.poi.util.ShortField,4,4,12,0.3333333333333333,1,0.25,3,0.75,8,0.6666666666666666,0.0,0.0,0.028811524609843937,0.00010969318966381423,2,3,5
org.apache.poi.ddf.EscherSpRecord,6,10,30,0.3333333333333333,1,0.16666666666666666,8,1.3333333333333333,20,0.6666666666666666,0.0,0.0,0.06136528685548293,3.3271245005938884e-05,8,5,13
org.apache.poi.poifs.common.POIFSConstants,1,0,0,0,1,1.0,-1,-1.0,0,0,0.0,0.0,0.0466472303206997,0.0,14,0,14
org.apache.poi.hssf.record.IterationRecord,4,3,12,0.25,1,0.25,4,1.0,9,0.75,0.0,0.0,0.025025025025025023,5.303238528346753e-07,4,3,7
org.apache.poi.util.DrawingDump,4,6,12,0.5,1,0.25,342,85.5,6,0.5,0.0,0.0,0.0,0.0,0,3,3
org.apache.poi.poifs.storage.PropertyBlock,5,5,20,0.25,1,0.2,20,4.0,15,0.75,0.0,0.0,0.014196983141082519,6.441970727685013e-06,1,4,5
org.apache.poi.hssf.record.formula.DividePtg,3,3,6,0.5,1,0.3333333333333333,182,60.666666666666664,3,0.5,0.0,0.0,0.05807180369049726,1.0307153164296021e-05,2,2,4
org.apache.poi.hssf.record.SSTDeserializer,7,13,42,0.30952380952380953,1,0.14285714285714285,16,2.2857142857142856,29,0.6904761904761905,0.03333333333333333,0.0047619047619047615,0.05850635585395939,0.00022804576376004936,1,6,7
org.apache.poi.hpsf.HPSFException,1,0,0,0,1,1.0,-1,-1.0,0,0,0.0,0.0,0.012244897959183673,0.0,4,0,4
org.apache.poi.hpsf.HPSFRuntimeException,1,0,0,0,1,1.0,-1,-1.0,0,0,0.0,0.0,0.027279082058888716,0.0,5,0,5
org.apache.poi.hssf.record.BoundSheetRecord,5,4,20,0.2,1,0.2,5,1.0,16,0.8,0.0,0.0,0.07339449541284404,5.4645931269307915e-05,5,4,9
org.apache.poi.hssf.record.BottomMarginRecord,5,4,20,0.2,1,0.2,5,1.0,16,0.8,0.0,0.0,0.025025025025025023,1.0837477017130697e-05,4,4,8
org.apache.poi.hssf.eventusermodel.AbortableHSSFListener,4,4,12,0.3333333333333333,1,0.25,2,0.5,8,0.6666666666666666,0.0,0.0,0.005668934240362812,0.0,1,3,4
org.apache.poi.hssf.record.MergeCellsRecord,5,4,20,0.2,1,0.2,5,1.0,16,0.8,0.0,0.0,0.025025025025025023,4.175893651001877e-05,4,4,8
org.apache.poi.hssf.record.ExternSheetSubRecord,3,2,6,0.3333333333333333,1,0.3333333333333333,3,1.0,4,0.6666666666666666,0.0,0.0,0.0712313911071675,5.296359656285446e-06,2,2,4
org.apache.poi.hssf.record.WindowProtectRecord,4,3,12,0.25,1,0.25,4,1.0,9,0.75,0.0,0.0,0.07207207207207207,1.0758820475889111e-05,4,3,7
org.apache.poi.hssf.record.SelectionRecord,4,3,12,0.25,1,0.25,4,1.0,9,0.75,0.0,0.0,0.025025025025025023,5.303238528346753e-07,4,3,7
org.apache.poi.hssf.model.SimpleFilledShape,12,28,132,0.21212121212121213,1,0.08333333333333333,271,22.583333333333332,104,0.7878787878787878,0.02727272727272727,0.0022727272727272726,0.0062988158226253465,1.1337868480725624e-05,1,11,12
org.apache.poi.util.POILogFactory,3,3,6,0.5,1,0.3333333333333333,2,0.6666666666666666,3,0.5,0.0,0.0,0.0761904761904762,0.0004329004329004329,6,2,8
org.apache.poi.ddf.EscherDump,9,14,72,0.19444444444444445,1,0.1111111111111111,37,4.111111111111111,58,0.8055555555555556,0.0,0.0,0.0,0.0,0,8,8
org.apache.poi.hssf.record.ExtendedFormatRecord,5,4,20,0.2,1,0.2,5,1.0,16,0.8,0.0,0.0,0.07655710259181554,0.00011104492109630686,7,4,11
org.apache.poi.hssf.record.formula.ConcatPtg,3,3,6,0.5,1,0.3333333333333333,182,60.666666666666664,3,0.5,0.0,0.0,0.05807180369049726,1.0307153164296021e-05,2,2,4
org.apache.poi.hssf.record.formula.GreaterEqualPtg,3,3,6,0.5,1,0.3333333333333333,182,60.666666666666664,3,0.5,0.0,0.0,0.05807180369049726,1.0307153164296021e-05,2,2,4
org.apache.poi.hssf.record.DataFormatRecord,6,5,30,0.16666666666666666,1,0.16666666666666666,6,1.0,25,0.8333333333333334,0.0,0.0,0.0030234315948601664,3.964289678575393e-07,1,5,6
org.apache.poi.hpsf.NoSingleSectionException,2,1,2,0.5,1,0.5,0,0.0,1,0.5,0.0,0.0,0.0062988158226253465,0.0,1,1,2
org.apache.poi.poifs.storage.RawDataBlockList,3,2,6,0.3333333333333333,1,0.3333333333333333,15,5.0,4,0.6666666666666666,0.0,0.0,0.02024619371558147,7.945097230811515e-05,4,2,6
org.apache.poi.hssf.usermodel.HSSFSimpleShape,3,4,6,0.6666666666666666,1,0.3333333333333333,263,87.66666666666667,2,0.3333333333333333,0.0,0.0,0.020833333333333332,9.44822373393802e-06,8,2,10
org.apache.poi.hssf.record.ExternSheetRecord,5,6,20,0.3,1,0.2,5,1.0,14,0.7,0.0,0.0,0.07207207207207207,4.683385655092519e-05,4,4,8
org.apache.poi.hssf.usermodel.HSSFShape,4,6,12,0.5,1,0.25,263,65.75,6,0.5,0.0,0.0,0.025641025641025637,0.01048312326373551,13,4,17
org.apache.poi.util.HexDump,1,0,0,0,1,1.0,-1,-1.0,0,0,0.0,0.0,0.19786333777497253,0.0,63,0,63
org.apache.poi.hssf.record.formula.UnaryPlusPtg,3,3,6,0.5,1,0.3333333333333333,182,60.666666666666664,3,0.5,0.0,0.0,0.0582884895251633,1.0307153164296021e-05,2,2,4
org.apache.poi.hssf.record.DrawingRecord,4,3,12,0.25,1,0.25,4,1.0,9,0.75,0.0,0.0,0.022326879469736615,2.923055837403395e-06,3,3,6
org.apache.poi.hssf.record.RecordFactory,88,252,7656,0.032915360501567396,1,0.011363636363636364,246,2.7954545454545454,7404,0.9670846394984326,0.0,0.0,0.013718820861678006,0.005275991075834381,4,87,91
org.apache.poi.hssf.usermodel.HSSFTextbox,5,8,20,0.4,1,0.2,263,52.6,12,0.6,0.0,0.0,0.018518518518518517,0.00010447035957240039,5,4,9
org.apache.poi.hssf.record.aggregates.ValueRecordsAggregate,8,18,56,0.32142857142857145,1,0.125,189,23.625,38,0.6785714285714286,0.0,0.0,0.017041868293709236,9.705902563045417e-05,1,7,8
org.apache.poi.hssf.record.PaletteRecord,5,4,20,0.2,1,0.2,5,1.0,16,0.8,0.0,0.0,0.07413221698935984,0.00047789630060038205,5,4,9
org.apache.poi.hssf.usermodel.HSSFClientAnchor,4,5,12,0.4166666666666667,1,0.25,263,65.75,7,0.5833333333333334,0.0,0.0,0.022222222222222223,0.014253651677121065,4,3,7
org.apache.poi.hssf.record.formula.ControlPtg,2,2,2,1.0,1,0.5,182,91.0,0,0.0,0.0,0.0,0.045945044684540484,0.00018295196866625438,1,1,2
org.apache.poi.hssf.record.PlotGrowthRecord,5,4,20,0.2,1,0.2,5,1.0,16,0.8,0.0,0.0,0.0030234315948601664,0.0,1,4,5
org.apache.poi.hpsf.IllegalPropertySetDataException,2,1,2,0.5,1,0.5,0,0.0,1,0.5,0.0,0.0,0.0,0.0,0,1,1
org.apache.poi.poifs.property.RootProperty,5,7,20,0.35,1,0.2,24,4.8,13,0.65,0.0,0.0,0.01740064446831364,0.00010435992578849721,4,4,8
org.apache.poi.hssf.record.aggregates.ColumnInfoRecordsAggregate,3,3,6,0.5,1,0.3333333333333333,6,2.0,3,0.5,0.0,0.0,0.017041868293709236,0.0,1,2,3
org.apache.poi.poifs.storage.SmallDocumentBlockList,3,3,6,0.5,1,0.3333333333333333,16,5.333333333333333,3,0.5,0.0,0.0,0.014196983141082519,0.0,1,2,3
org.apache.poi.hpsf.TypeReader,5,5,20,0.25,1,0.2,4,0.8,15,0.75,0.0,0.0,0.023900557790025985,0.0003349824778396207,1,4,5
org.apache.poi.hssf.util.AreaReference,2,1,2,0.5,1,0.5,0,0.0,1,0.5,0.0,0.0,0.04848484848484848,0.0,2,1,3
org.apache.poi.hssf.record.BarRecord,6,5,30,0.16666666666666666,1,0.16666666666666666,6,1.0,25,0.8333333333333334,0.0,0.0,0.0030234315948601664,3.964289678575393e-07,1,5,6
org.apache.poi.hssf.record.BackupRecord,4,3,12,0.25,1,0.25,4,1.0,9,0.75,0.0,0.0,0.07441860465116279,1.7165490130317086e-05,5,3,8
org.apache.poi.hssf.usermodel.HSSFShapeContainer,1,0,0,0,1,1.0,-1,-1.0,0,0,0.0,0.0,0.014253320375769355,0.0,3,0,3
org.apache.poi.hssf.record.LineFormatRecord,6,5,30,0.16666666666666666,1,0.16666666666666666,6,1.0,25,0.8333333333333334,0.0,0.0,0.0030234315948601664,3.964289678575393e-07,1,5,6
org.apache.poi.hssf.record.DefaultDataLabelTextPropertiesRecord,5,4,20,0.2,1,0.2,5,1.0,16,0.8,0.0,0.0,0.0030234315948601664,0.0,1,4,5
org.apache.poi.hssf.record.RKRecord,7,11,42,0.2619047619047619,1,0.14285714285714285,7,1.0,31,0.7380952380952381,0.0,0.0,0.015276285952977682,4.65693131509458e-05,3,6,9
org.apache.poi.hssf.eventmodel.ListenerWrapper,3,3,6,0.5,1,0.3333333333333333,1,0.3333333333333333,3,0.5,0.0,0.0,0.007346938775510203,0.0,1,2,3
org.apache.poi.hssf.record.EndSubRecord,4,4,12,0.3333333333333333,1,0.25,10,2.5,8,0.6666666666666666,0.3333333333333333,0.08333333333333333,0.02168461203465934,4.1596725270194656e-05,6,3,9
org.apache.poi.hssf.record.SeriesListRecord,4,3,12,0.25,1,0.25,4,1.0,9,0.75,0.0,0.0,0.0030234315948601664,0.0,1,3,4
org.apache.poi.hssf.record.formula.AbstractFunctionPtg,4,4,12,0.3333333333333333,1,0.25,182,45.5,8,0.6666666666666666,0.0,0.0,0.04959147680236116,0.0020532708032708017,3,3,6
org.apache.poi.ddf.EscherRecordFactory,2,3,2,1.5,1,0.5,6,3.0,-1,-0.5,0.0,0.0,0.08671796587487453,0.0,19,1,20
org.apache.poi.hssf.record.AxisRecord,5,4,20,0.2,1,0.2,5,1.0,16,0.8,0.0,0.0,0.0030234315948601664,0.0,1,4,5
org.apache.poi.poifs.filesystem.POIFSFileSystem,25,82,600,0.13666666666666666,1,0.04,62,2.48,518,0.8633333333333333,0.08152173913043478,0.0032608695652173916,0.022398074876208988,0.004542734822527816,10,24,34
org.apache.poi.hssf.record.ExtSSTInfoSubRecord,3,2,6,0.3333333333333333,1,0.3333333333333333,3,1.0,4,0.6666666666666666,0.0,0.0,0.05831608005521048,0.0,1,2,3
org.apache.poi.poifs.filesystem.DirectoryNode,15,53,210,0.2523809523809524,1,0.06666666666666667,62,4.133333333333334,157,0.7476190476190476,0.07417582417582418,0.004945054945054945,0.020324179054337786,0.0010415378272521127,3,14,17
org.apache.poi.hssf.usermodel.HSSFChildAnchor,2,1,2,0.5,1,0.5,0,0.0,1,0.5,0.0,0.0,0.020324179054337786,1.7178588607160035e-06,4,1,5
org.apache.poi.hssf.record.LeftMarginRecord,5,4,20,0.2,1,0.2,5,1.0,16,0.8,0.0,0.0,0.025025025025025023,1.0837477017130697e-05,4,4,8
org.apache.poi.ddf.NullEscherSerializationListener,3,6,6,1.0,1,0.3333333333333333,6,2.0,0,0.0,0.0,0.0,0.08188538573324065,1.76991518982861e-05,2,2,4
org.apache.poi.hssf.record.formula.SubtractPtg,3,3,6,0.5,1,0.3333333333333333,182,60.666666666666664,3,0.5,0.0,0.0,0.05807180369049726,1.0307153164296021e-05,2,2,4
org.apache.poi.hssf.record.PlotAreaRecord,4,3,12,0.25,1,0.25,4,1.0,9,0.75,0.0,0.0,0.0030234315948601664,0.0,1,3,4
org.apache.poi.poifs.filesystem.POIFSDocument,15,32,210,0.1523809523809524,1,0.06666666666666667,28,1.8666666666666667,178,0.8476190476190476,0.0631868131868132,0.004212454212454213,0.029518950437317785,0.0014438235611704993,7,14,21
org.apache.poi.hssf.record.CellValueRecordInterface,1,1,0,0,1,1.0,-1,-1.0,-1,0,0.0,0.0,0.041809739768923444,0.0,14,1,15
org.apache.poi.hssf.record.InterfaceEndRecord,4,3,12,0.25,1,0.25,4,1.0,9,0.75,0.0,0.0,0.07207207207207207,1.0758820475889111e-05,4,3,7
org.apache.poi.hssf.record.AxisParentRecord,5,4,20,0.2,1,0.2,5,1.0,16,0.8,0.0,0.0,0.0030234315948601664,0.0,1,4,5
org.apache.poi.hssf.eventmodel.ModelFactoryListener,2,1,2,0.5,1,0.5,0,0.0,1,0.5,0.0,0.0,0.0022675736961451248,0.0,1,1,2
org.apache.poi.poifs.storage.ListManagedBlock,1,0,0,0,1,1.0,-1,-1.0,0,0,0.0,0.0,0.03664765569527474,0.0,7,0,7
org.apache.poi.hssf.record.UnknownRecord,4,3,12,0.25,1,0.25,4,1.0,9,0.75,0.0,0.0,0.033146012027999605,2.6226466259938867e-05,7,3,10
org.apache.poi.ddf.EscherSerializationListener,2,3,2,1.5,1,0.5,6,3.0,-1,-0.5,0.0,0.0,0.08343526685121998,0.0,16,1,17
org.apache.poi.hssf.record.AxisUsedRecord,5,4,20,0.2,1,0.2,5,1.0,16,0.8,0.0,0.0,0.0030234315948601664,0.0,1,4,5
org.apache.poi.hpsf.SummaryInformation,5,6,20,0.3,1,0.2,19,3.8,14,0.7,0.0,0.0,0.0022675736961451248,5.153576582148011e-06,1,4,5
org.apache.poi.poifs.eventfilesystem.POIFSReaderListener,2,1,2,0.5,1,0.5,64,32.0,1,0.5,0.0,0.0,0.006802721088435374,0.0003298289012574727,3,1,4
org.apache.poi.hssf.record.ChartRecord,5,4,20,0.2,1,0.2,5,1.0,16,0.8,0.0,0.0,0.0030234315948601664,0.0,1,4,5
org.apache.poi.hssf.record.VCenterRecord,4,3,12,0.25,1,0.25,4,1.0,9,0.75,0.0,0.0,0.030193236714975844,1.5005238279279843e-05,5,3,8
org.apache.poi.hssf.util.RKUtil,1,0,0,0,1,1.0,-1,-1.0,0,0,0.0,0.0,0.013119533527696793,0.0,2,0,2
org.apache.poi.ddf.EscherContainerRecord,7,16,42,0.38095238095238093,1,0.14285714285714285,9,1.2857142857142858,26,0.6190476190476191,0.0,0.0,0.08091342263777758,0.0005303645683206597,8,6,14
org.apache.poi.hssf.record.FontRecord,6,5,30,0.16666666666666666,1,0.16666666666666666,6,1.0,25,0.8333333333333334,0.0,0.0,0.0809220769721099,0.00021552420165197396,6,5,11
org.apache.poi.hssf.record.SeriesIndexRecord,5,4,20,0.2,1,0.2,5,1.0,16,0.8,0.0,0.0,0.0030234315948601664,0.0,1,4,5
org.apache.poi.util.BitField,1,0,0,0,1,1.0,-1,-1.0,0,0,0.0,0.0,0.11718946837994457,0.0,34,0,34
org.apache.poi.hssf.record.AreaFormatRecord,6,5,30,0.16666666666666666,1,0.16666666666666666,6,1.0,25,0.8333333333333334,0.0,0.0,0.0030234315948601664,3.964289678575393e-07,1,5,6
org.apache.poi.hssf.record.UseSelFSRecord,4,3,12,0.25,1,0.25,4,1.0,9,0.75,0.0,0.0,0.07207207207207207,1.0758820475889111e-05,4,3,7
org.apache.poi.hssf.model.Workbook,57,111,3192,0.03477443609022556,1,0.017543859649122806,182,3.192982456140351,3081,0.9652255639097744,0.01753246753246753,0.0003075871496924128,0.10277181047857739,0.05162215344408449,46,57,103
org.apache.poi.hpsf.Util,1,0,0,0,1,1.0,-1,-1.0,0,0,0.0,0.0,0.020776985492992377,0.0,2,0,2
org.apache.poi.hssf.record.formula.LessThanPtg,3,3,6,0.5,1,0.3333333333333333,182,60.666666666666664,3,0.5,0.0,0.0,0.05807180369049726,1.0307153164296021e-05,2,2,4
org.apache.poi.util.NullLogger,2,1,2,0.5,1,0.5,1,0.5,1,0.5,0.0,0.0,0.055536338829317036,0.0,1,1,2
org.apache.poi.hpsf.NoPropertySetStreamException,2,1,2,0.5,1,0.5,0,0.0,1,0.5,0.0,0.0,0.007086167800453515,6.871435442864014e-06,2,1,3
org.apache.poi.ddf.EscherBlipRecord,7,11,42,0.2619047619047619,1,0.14285714285714285,9,1.2857142857142858,31,0.7380952380952381,0.0,0.0,0.04697531186387598,3.2148501536256633e-06,1,6,7
org.apache.poi.hssf.record.HideObjRecord,4,3,12,0.25,1,0.25,4,1.0,9,0.75,0.0,0.0,0.07207207207207207,1.0758820475889111e-05,4,3,7
org.apache.poi.hssf.record.DefaultRowHeightRecord,4,3,12,0.25,1,0.25,4,1.0,9,0.75,0.0,0.0,0.025025025025025023,5.303238528346753e-07,4,3,7
org.apache.poi.poifs.filesystem.EntryNode,6,12,30,0.4,1,0.16666666666666666,62,10.333333333333334,18,0.6,0.05,0.008333333333333333,0.020324179054337786,0.00032952214074663045,3,5,8
org.apache.poi.hssf.record.formula.IntPtg,4,7,12,0.5833333333333334,1,0.25,182,45.5,5,0.4166666666666667,0.16666666666666666,0.041666666666666664,0.05785672293608802,7.4288958024270325e-06,2,3,5
org.apache.poi.hssf.util.SheetReferences,1,0,0,0,1,1.0,-1,-1.0,0,0,0.0,0.0,0.06837606837606837,0.0,3,0,3
org.apache.poi.hssf.record.FormulaRecord,7,9,42,0.21428571428571427,1,0.14285714285714285,184,26.285714285714285,33,0.7857142857142857,0.0,0.0,0.02772429726607624,0.0024293627892712517,7,6,13
org.apache.poi.util.ByteField,5,6,20,0.3,1,0.2,3,0.6,14,0.7,0.0,0.0,0.026477931239836,9.143698856515798e-05,1,4,5
org.apache.poi.hssf.usermodel.EscherGraphics2d,4,6,12,0.5,1,0.25,345,86.25,6,0.5,0.0,0.0,0.0,0.0,0,3,3
org.apache.poi.hpsf.wellknown.PropertyIDMap,1,1,0,0,1,1.0,-1,-1.0,-1,0,0.0,0.0,0.01111111111111111,0.0,5,1,6
org.apache.poi.hssf.record.NumberFormatIndexRecord,5,4,20,0.2,1,0.2,5,1.0,16,0.8,0.0,0.0,0.0,0.0,0,4,4
org.apache.poi.hssf.record.SSTRecordHeader,4,6,12,0.5,1,0.25,16,4.0,6,0.5,0.0,0.0,0.046055003197860336,4.457843743558029e-05,2,3,5
org.apache.poi.poifs.storage.BlockList,3,4,6,0.6666666666666666,1,0.3333333333333333,13,4.333333333333333,2,0.3333333333333333,0.0,0.0,0.024766616603351298,2.576788291074005e-05,5,2,7
org.apache.poi.hssf.record.SeriesRecord,5,4,20,0.2,1,0.2,5,1.0,16,0.8,0.0,0.0,0.0030234315948601664,0.0,1,4,5
org.apache.poi.poifs.property.PropertyFactory,7,11,42,0.2619047619047619,1,0.14285714285714285,38,5.428571428571429,31,0.7380952380952381,0.0,0.0,0.014196983141082519,5.0247371675943104e-05,1,6,7
org.apache.poi.hssf.record.formula.NameXPtg,4,7,12,0.5833333333333334,1,0.25,182,45.5,5,0.4166666666666667,0.16666666666666666,0.041666666666666664,0.05764322949351943,5.768298903734896e-06,1,3,4
org.apache.poi.hssf.usermodel.HSSFPolygon,3,4,6,0.6666666666666666,1,0.3333333333333333,263,87.66666666666667,2,0.3333333333333333,0.0,0.0,0.018518518518518517,9.44822373393802e-06,5,2,7
org.apache.poi.hssf.model.FormulaParser,32,115,992,0.1159274193548387,1,0.03125,184,5.75,877,0.8840725806451613,0.0,0.0,0.019115890083632018,0.002375282015162967,3,31,34
org.apache.poi.hssf.record.AreaRecord,6,5,30,0.16666666666666666,1,0.16666666666666666,6,1.0,25,0.8333333333333334,0.0,0.0,0.0030234315948601664,3.964289678575393e-07,1,5,6
org.apache.poi.hpsf.ClassID,2,1,2,0.5,1,0.5,0,0.0,1,0.5,0.0,0.0,0.037383177570093455,8.374561945990517e-05,6,1,7
org.apache.poi.poifs.filesystem.POIFSWriterListener,2,1,2,0.5,1,0.5,2,1.0,1,0.5,0.0,0.0,0.03180815705277545,0.00016319659176802027,6,1,7
org.apache.poi.hssf.record.CategorySeriesAxisRecord,6,5,30,0.16666666666666666,1,0.16666666666666666,6,1.0,25,0.8333333333333334,0.0,0.0,0.0030234315948601664,3.964289678575393e-07,1,5,6
org.apache.poi.hssf.dev.EFBiffViewer,4,5,12,0.4166666666666667,1,0.25,311,77.75,7,0.5833333333333334,0.0,0.0,0.0,0.0,0,3,3
org.apache.poi.hssf.record.WriteAccessRecord,6,8,30,0.26666666666666666,1,0.16666666666666666,6,1.0,22,0.7333333333333333,0.0,0.0,0.07207207207207207,0.00023833412516158345,4,5,9
org.apache.poi.hssf.record.PrecisionRecord,4,3,12,0.25,1,0.25,4,1.0,9,0.75,0.0,0.0,0.07207207207207207,1.0758820475889111e-05,4,3,7
org.apache.poi.hssf.record.CodepageRecord,4,3,12,0.25,1,0.25,4,1.0,9,0.75,0.0,0.0,0.07207207207207207,1.0758820475889111e-05,4,3,7
org.apache.poi.hssf.record.TextObjectBaseRecord,6,5,30,0.16666666666666666,1,0.16666666666666666,6,1.0,25,0.8333333333333334,0.0,0.0,0.016393442622950817,2.30169490373572e-05,4,5,9
org.apache.poi.hssf.usermodel.EscherGraphics,16,37,240,0.15416666666666667,1,0.0625,344,21.5,203,0.8458333333333333,0.0,0.0,0.0022675736961451248,0.0017573696145124717,1,15,16
org.apache.poi.hssf.record.formula.FuncVarPtg,3,2,6,0.3333333333333333,1,0.3333333333333333,182,60.666666666666664,4,0.6666666666666666,0.0,0.0,0.0582884895251633,0.00022387911225264348,2,2,4
org.apache.poi.util.ShortList,1,1,0,0,1,1.0,-1,-1.0,-1,0,0.0,0.0,0.0,0.0,1,1,2
org.apache.poi.hssf.record.formula.ParenthesisPtg,3,3,6,0.5,1,0.3333333333333333,182,60.666666666666664,3,0.5,0.0,0.0,0.05807180369049726,1.0307153164296021e-05,2,2,4
org.apache.poi.poifs.storage.SmallBlockTableReader,9,17,72,0.2361111111111111,1,0.1111111111111111,35,3.888888888888889,55,0.7638888888888888,0.0,0.0,0.017640389489128987,0.00022375111660825946,2,8,10
org.apache.poi.hssf.record.HCenterRecord,4,3,12,0.25,1,0.25,4,1.0,9,0.75,0.0,0.0,0.030193236714975844,1.5005238279279843e-05,5,3,8
org.apache.poi.hssf.record.TextObjectRecord,8,12,56,0.21428571428571427,1,0.125,12,1.5,44,0.7857142857142857,0.0,0.0,0.01889644746787604,0.00023261314889329733,4,7,11
org.apache.poi.util.IntList,1,1,0,0,1,1.0,-1,-1.0,-1,0,0.0,0.0,0.037825059101654845,0.0,5,1,6
org.apache.poi.hssf.record.BookBoolRecord,4,3,12,0.25,1,0.25,4,1.0,9,0.75,0.0,0.0,0.07207207207207207,1.0758820475889111e-05,4,3,7
org.apache.poi.poifs.filesystem.DirectoryEntry,5,6,20,0.3,1,0.2,7,1.4,14,0.7,0.25,0.05,0.0217687074829932,0.00010393046107331821,6,5,11
org.apache.poi.hssf.usermodel.HSSFCellStyle,3,2,6,0.3333333333333333,1,0.3333333333333333,9,3.0,4,0.6666666666666666,0.0,0.0,0.01707510313362293,5.9930473951489875e-05,4,2,6
org.apache.poi.hssf.eventmodel.ERFListener,2,1,2,0.5,1,0.5,0,0.0,1,0.5,0.0,0.0,0.009070294784580499,0.0,3,1,4
org.apache.poi.hssf.record.SupBookRecord,4,3,12,0.25,1,0.25,4,1.0,9,0.75,0.0,0.0,0.06896551724137931,1.0694400768612262e-05,2,3,5
org.apache.poi.hssf.record.TopMarginRecord,5,4,20,0.2,1,0.2,5,1.0,16,0.8,0.0,0.0,0.025025025025025023,1.0837477017130697e-05,4,4,8
org.apache.poi.hssf.record.formula.BoolPtg,3,6,6,1.0,1,0.3333333333333333,182,60.666666666666664,0,0.0,0.0,0.0,0.05785672293608802,0.0,2,2,4
org.apache.poi.hssf.usermodel.FontDetails,1,1,0,0,1,1.0,-1,-1.0,-1,0,0.0,0.0,0.00510204081632653,0.0,3,1,4
org.apache.poi.hssf.record.DSFRecord,4,3,12,0.25,1,0.25,4,1.0,9,0.75,0.0,0.0,0.07207207207207207,1.0758820475889111e-05,4,3,7
org.apache.poi.ddf.EscherOptRecord,8,13,56,0.23214285714285715,1,0.125,18,2.25,43,0.7678571428571429,0.0,0.0,0.08091342263777758,0.0025861262669395002,8,7,15
org.apache.poi.hssf.record.AxisLineFormatRecord,5,4,20,0.2,1,0.2,5,1.0,16,0.8,0.0,0.0,0.0030234315948601664,0.0,1,4,5
org.apache.poi.hssf.record.BoolErrRecord,5,5,20,0.25,1,0.2,5,1.0,15,0.75,0.0,0.0,0.02496490659755966,1.1963169490678927e-05,4,4,8
org.apache.poi.hssf.record.FrameRecord,6,5,30,0.16666666666666666,1,0.16666666666666666,6,1.0,25,0.8333333333333334,0.0,0.0,0.0030234315948601664,3.964289678575393e-07,1,5,6
org.apache.poi.poifs.eventfilesystem.POIFSReader,16,38,240,0.15833333333333333,1,0.0625,68,4.25,202,0.8416666666666667,0.0,0.0,0.0,0.0,0,15,15
org.apache.poi.hssf.record.formula.PowerPtg,3,3,6,0.5,1,0.3333333333333333,182,60.666666666666664,3,0.5,0.0,0.0,0.05807180369049726,1.0307153164296021e-05,2,2,4
org.apache.poi.poifs.dev.POIFSViewEngine,2,1,2,0.5,1,0.5,0,0.0,1,0.5,0.0,0.0,0.0022675736961451248,0.0,1,1,2
org.apache.poi.hssf.record.RightMarginRecord,5,4,20,0.2,1,0.2,5,1.0,16,0.8,0.0,0.0,0.025025025025025023,1.0837477017130697e-05,4,4,8
org.apache.poi.hssf.record.SSTRecord,10,28,90,0.3111111111111111,1,0.1,16,1.6,62,0.6888888888888889,0.13425925925925924,0.013425925925925924,0.08201575911947731,0.003551864502952401,10,9,19
org.apache.poi.hssf.dev.EFHSSF,16,40,240,0.16666666666666666,1,0.0625,348,21.75,200,0.8333333333333334,0.06190476190476191,0.003869047619047619,0.0022675736961451248,0.0017831374974232117,1,15,16
org.apache.poi.hssf.record.SSTSerializer,8,17,56,0.30357142857142855,1,0.125,16,2.0,39,0.6964285714285714,0.22619047619047616,0.02827380952380952,0.0586975530953122,0.0014855184498041643,2,7,9
org.apache.poi.util.SystemOutLogger,2,1,2,0.5,1,0.5,1,0.5,1,0.5,0.0,0.0,0.0,0.0,0,1,1
org.apache.poi.poifs.filesystem.DocumentOutputStream,1,0,0,0,1,1.0,-1,-1.0,0,0,0.0,0.0,0.021139638651159386,0.0,3,0,3
org.apache.poi.hssf.model.LineShape,15,30,210,0.14285714285714285,1,0.06666666666666667,271,18.066666666666666,180,0.8571428571428571,0.02197802197802198,0.0014652014652014654,0.0062988158226253465,1.6491445062873635e-05,1,14,15
org.apache.poi.hssf.record.IndexRecord,5,5,20,0.25,1,0.2,5,1.0,15,0.75,0.0,0.0,0.025025025025025023,2.9733924485006735e-05,4,4,8
org.apache.poi.hssf.record.WindowTwoRecord,5,4,20,0.2,1,0.2,5,1.0,16,0.8,0.0,0.0,0.031210986267166042,4.314860592272491e-05,6,4,10
org.apache.poi.poifs.storage.BlockAllocationTableReader,9,16,72,0.2222222222222222,1,0.1111111111111111,13,1.4444444444444444,56,0.7777777777777778,0.10714285714285714,0.011904761904761904,0.024766616603351298,0.0003895916990440868,5,8,13
org.apache.poi.hpsf.UnexpectedPropertySetTypeException,2,1,2,0.5,1,0.5,0,0.0,1,0.5,0.0,0.0,0.006802721088435374,1.2025012025012026e-05,3,1,4
org.apache.poi.util.BinaryTree,2,3,2,1.5,1,0.5,0,0.0,-1,-0.5,0.0,0.0,0.05187228044370902,0.0003092145949288806,5,1,6
org.apache.poi.hssf.record.formula.OperationPtg,2,2,2,1.0,1,0.5,182,91.0,0,0.0,0.0,0.0,0.06008198151055294,0.003460626674912389,20,1,21
org.apache.poi.hssf.eventusermodel.HSSFEventFactory,9,17,72,0.2361111111111111,1,0.1111111111111111,310,34.44444444444444,55,0.7638888888888888,0.0,0.0,0.00510204081632653,0.0007803005762189436,2,8,10
org.apache.poi.hssf.record.EndRecord,4,3,12,0.25,1,0.25,4,1.0,9,0.75,0.0,0.0,0.0030234315948601664,0.0,1,3,4
org.apache.poi.hssf.model.WorkbookRecordList,2,1,2,0.5,1,0.5,0,0.0,1,0.5,0.0,0.0,0.06779661016949153,0.0,1,1,2
org.apache.poi.hssf.record.PrintSetupRecord,5,4,20,0.2,1,0.2,5,1.0,16,0.8,0.0,0.0,0.026239067055393587,3.65207884147278e-05,5,4,9
org.apache.poi.hssf.record.SeriesToChartGroupRecord,5,4,20,0.2,1,0.2,5,1.0,16,0.8,0.0,0.0,0.0030234315948601664,0.0,1,4,5
org.apache.poi.hssf.record.ProtectionRev4Record,4,3,12,0.25,1,0.25,4,1.0,9,0.75,0.0,0.0,0.07207207207207207,1.0758820475889111e-05,4,3,7
org.apache.poi.hssf.record.TickRecord,6,5,30,0.16666666666666666,1,0.16666666666666666,6,1.0,25,0.8333333333333334,0.0,0.0,0.0030234315948601664,3.964289678575393e-07,1,5,6
org.apache.poi.hssf.record.StyleRecord,6,5,30,0.16666666666666666,1,0.16666666666666666,6,1.0,25,0.8333333333333334,0.0,0.0,0.07207207207207207,7.714874969049366e-05,4,5,9
org.apache.poi.hssf.record.formula.Area3DPtg,8,13,56,0.23214285714285715,1,0.125,182,22.75,43,0.7678571428571429,0.10714285714285714,0.013392857142857142,0.06298917416428937,0.0006236615499197505,4,7,11
org.apache.poi.hssf.record.WSBoolRecord,5,4,20,0.2,1,0.2,5,1.0,16,0.8,0.0,0.0,0.030193236714975844,3.218737930186612e-05,5,4,9
org.apache.poi.hssf.record.formula.EqualPtg,3,3,6,0.5,1,0.3333333333333333,182,60.666666666666664,3,0.5,0.0,0.0,0.05807180369049726,1.0307153164296021e-05,2,2,4
org.apache.poi.util.IntegerField,4,4,12,0.3333333333333333,1,0.25,3,0.75,8,0.6666666666666666,0.0,0.0,0.0349395313681028,0.00017932345661164455,4,3,7
org.apache.poi.poifs.dev.POIFSViewer,4,5,12,0.4166666666666667,1,0.25,64,16.0,7,0.5833333333333334,0.0,0.0,0.0,0.0,0,3,3
org.apache.poi.hssf.usermodel.StaticFontMetrics,2,2,2,1.0,1,0.5,0,0.0,0,0.0,0.0,0.0,0.0030234315948601664,0.0,1,1,2
org.apache.poi.hssf.record.PrintGridlinesRecord,4,3,12,0.25,1,0.25,4,1.0,9,0.75,0.0,0.0,0.030193236714975844,1.5005238279279843e-05,5,3,8
org.apache.poi.poifs.property.Parent,3,3,6,0.5,1,0.3333333333333333,8,2.6666666666666665,3,0.5,0.0,0.0,0.019864890400604684,6.871435442864014e-06,1,2,3
org.apache.poi.poifs.eventfilesystem.POIFSReaderEvent,3,3,6,0.5,1,0.3333333333333333,63,21.0,3,0.5,0.0,0.0,0.0072562358276643995,0.0006545042259327973,3,2,5
org.apache.poi.hssf.record.SeriesTextRecord,6,5,30,0.16666666666666666,1,0.16666666666666666,6,1.0,25,0.8333333333333334,0.0,0.0,0.0030234315948601664,8.589294303580017e-07,1,5,6
org.apache.poi.hssf.record.formula.MemFuncPtg,4,4,12,0.3333333333333333,1,0.25,182,45.5,8,0.6666666666666666,0.0,0.0,0.060313958273141954,0.0004315482994422457,2,3,5
org.apache.poi.hssf.usermodel.HSSFPalette,4,4,12,0.3333333333333333,1,0.25,54,13.5,8,0.6666666666666666,0.0,0.0,0.008547008547008546,0.000400112353575557,2,3,5
org.apache.poi.poifs.property.PropertyTable,12,23,132,0.17424242424242425,1,0.08333333333333333,46,3.8333333333333335,109,0.8257575757575758,0.0,0.0,0.017640389489128987,0.00046811653954511104,2,11,13
org.apache.poi.ddf.EscherProperties,2,1,2,0.5,1,0.5,0,0.0,1,0.5,0.0,0.0,0.0878438331854481,0.00046639868068439495,11,1,12
org.apache.poi.hssf.record.DateWindow1904Record,4,3,12,0.25,1,0.25,4,1.0,9,0.75,0.0,0.0,0.07207207207207207,1.0758820475889111e-05,4,3,7
org.apache.poi.hssf.record.RkRec,1,0,0,0,1,1.0,-1,-1.0,0,0,0.0,0.0,0.0119150690579262,0.0,1,0,1
org.apache.poi.hssf.record.RefreshAllRecord,4,3,12,0.25,1,0.25,4,1.0,9,0.75,0.0,0.0,0.07207207207207207,1.0758820475889111e-05,4,3,7
org.apache.poi.ddf.EscherComplexProperty,5,5,20,0.25,1,0.2,6,1.2,15,0.75,0.0,0.0,0.04783474365355899,9.44822373393802e-06,2,4,6
org.apache.poi.hssf.record.LinkedDataFormulaField,4,4,12,0.3333333333333333,1,0.25,184,46.0,8,0.6666666666666666,0.0,0.0,0.003401360544217687,0.0009276437847866419,1,3,4
org.apache.poi.poifs.property.Property,10,11,90,0.12222222222222222,1,0.1,12,1.2,79,0.8777777777777778,0.0,0.0,0.0379905808477237,0.0012291828134244648,13,9,22
org.apache.poi.hssf.util.CellReference,1,0,0,0,1,1.0,-1,-1.0,0,0,0.0,0.0,0.051197562358276646,0.0,6,0,6
org.apache.poi.hssf.record.ContinueRecord,4,3,12,0.25,1,0.25,4,1.0,9,0.75,0.0,0.0,0.04557713052858684,1.0371572871572872e-05,6,3,9
org.apache.poi.hssf.usermodel.HSSFRichTextString,2,1,2,0.5,1,0.5,8,4.0,1,0.5,0.0,0.0,0.02218278615794144,0.0001619327384633507,4,1,5
org.apache.poi.hssf.record.formula.StringPtg,5,8,20,0.4,1,0.2,182,36.4,12,0.6,0.16666666666666666,0.03333333333333333,0.05785672293608802,6.466020751735036e-05,2,4,6
org.apache.poi.hssf.record.DeltaRecord,4,3,12,0.25,1,0.25,4,1.0,9,0.75,0.0,0.0,0.025025025025025023,5.303238528346753e-07,4,3,7
org.apache.poi.ddf.UnknownEscherRecord,6,10,30,0.3333333333333333,1,0.16666666666666666,8,1.3333333333333333,20,0.6666666666666666,0.0,0.0,0.04697531186387598,3.2148501536256633e-06,1,5,6
org.apache.poi.hssf.record.LinkedDataRecord,7,7,42,0.16666666666666666,1,0.14285714285714285,185,26.428571428571427,35,0.8333333333333334,0.0,0.0,0.0030234315948601664,2.101073529644958e-05,1,6,7
org.apache.poi.ddf.EscherPropertyMetaData,1,0,0,0,1,1.0,-1,-1.0,0,0,0.0,0.0,0.06572677380130797,0.0,2,0,2
org.apache.poi.hpsf.MarkUnsupportedException,2,1,2,0.5,1,0.5,0,0.0,1,0.5,0.0,0.0,0.007086167800453515,6.871435442864014e-06,2,1,3
org.apache.poi.hssf.record.RefModeRecord,4,3,12,0.25,1,0.25,4,1.0,9,0.75,0.0,0.0,0.025025025025025023,5.303238528346753e-07,4,3,7
org.apache.poi.hssf.record.SSTRecordSizeCalculator,5,11,20,0.55,1,0.2,16,3.2,9,0.45,0.041666666666666664,0.008333333333333333,0.0586975530953122,1.2883941455370026e-06,2,4,6
org.apache.poi.hssf.record.FormatRecord,5,4,20,0.2,1,0.2,5,1.0,16,0.8,0.0,0.0,0.07272727272727272,6.700482181897318e-05,5,4,9
org.apache.poi.hssf.record.UnitsRecord,5,4,20,0.2,1,0.2,5,1.0,16,0.8,0.0,0.0,0.0030234315948601664,0.0,1,4,5
org.apache.poi.hssf.record.SaveRecalcRecord,4,3,12,0.25,1,0.25,4,1.0,9,0.75,0.0,0.0,0.025025025025025023,5.303238528346753e-07,4,3,7
org.apache.poi.hpsf.DocumentSummaryInformation,5,6,20,0.3,1,0.2,19,3.8,14,0.7,0.0,0.0,0.0022675736961451248,5.153576582148011e-06,1,4,5
org.apache.poi.poifs.filesystem.Entry,2,3,2,1.5,1,0.5,7,3.5,-1,-0.5,0.0,0.0,0.0217687074829932,0.0,5,1,6
org.apache.poi.hssf.record.formula.GreaterThanPtg,3,3,6,0.5,1,0.3333333333333333,182,60.666666666666664,3,0.5,0.0,0.0,0.05807180369049726,1.0307153164296021e-05,2,2,4
org.apache.poi.ddf.EscherArrayProperty,5,7,20,0.35,1,0.2,7,1.4,13,0.65,0.0,0.0,0.04715661858519002,1.0184448959959163e-05,2,4,6
org.apache.poi.hpsf.Section,9,15,72,0.20833333333333334,1,0.1111111111111111,11,1.2222222222222223,57,0.7916666666666666,0.0,0.0,0.007086167800453515,5.1535765821480104e-05,2,8,10
org.apache.poi.hssf.record.VerticalPageBreakRecord,2,1,2,0.5,1,0.5,6,3.0,1,0.5,0.0,0.0,0.012698412698412698,3.6075036075036075e-05,2,1,3
org.apache.poi.hssf.model.Model,1,0,0,0,1,1.0,-1,-1.0,0,0,0.0,0.0,0.06971582959424905,0.0,4,0,4
org.apache.poi.hpsf.wellknown.SectionIDMap,2,3,2,1.5,1,0.5,0,0.0,-1,-0.5,0.0,0.0,0.008163265306122448,2.5767882910740053e-06,3,2,5
org.apache.poi.ddf.EscherSimpleProperty,5,5,20,0.25,1,0.2,6,1.2,15,0.75,0.0,0.0,0.06277562149604218,0.0001270417979601653,7,4,11
org.apache.poi.hssf.record.SeriesLabelsRecord,6,5,30,0.16666666666666666,1,0.16666666666666666,6,1.0,25,0.8333333333333334,0.0,0.0,0.0,0.0,0,5,5
org.apache.poi.poifs.filesystem.POIFSWriterEvent,3,3,6,0.5,1,0.3333333333333333,1,0.3333333333333333,3,0.5,0.0,0.0,0.023744113029827315,5.926613069470215e-05,3,2,5
org.apache.poi.hssf.eventusermodel.HSSFUserException,1,0,0,0,1,1.0,-1,-1.0,0,0,0.0,0.0,0.008163265306122448,0.0,3,0,3
org.apache.poi.hssf.record.GroupMarkerSubRecord,5,5,20,0.25,1,0.2,10,2.0,15,0.75,0.25,0.05,0.02046485260770975,1.7080425243690547e-05,2,4,6
org.apache.poi.hssf.eventusermodel.HSSFRequest,6,9,30,0.3,1,0.16666666666666666,250,41.666666666666664,21,0.7,0.0,0.0,0.0072562358276643995,0.0007776010837235327,3,5,8
org.apache.poi.hpsf.Variant,1,0,0,0,1,1.0,-1,-1.0,0,0,0.0,0.0,0.020529640427599614,0.0,2,0,2
org.apache.poi.hssf.dev.BiffViewer,130,525,16770,0.03130590339892665,1,0.007692307692307693,345,2.6538461538461537,16245,0.9686940966010733,0.007570251937984496,5.8232707215265355e-05,0.0022675736961451248,0.0017582285439428306,1,129,130
org.apache.poi.hssf.record.RowRecord,5,4,20,0.2,1,0.2,5,1.0,16,0.8,0.0,0.0,0.03265306122448979,0.00011488984436950298,8,4,12
org.apache.poi.poifs.storage.SmallDocumentBlock,4,4,12,0.3333333333333333,1,0.25,2,0.5,8,0.6666666666666666,0.0,0.0,0.027642803153007232,5.299594585308872e-05,7,4,11
org.apache.poi.hssf.record.CalcCountRecord,4,3,12,0.25,1,0.25,4,1.0,9,0.75,0.0,0.0,0.025025025025025023,5.303238528346753e-07,4,3,7
org.apache.poi.hssf.record.AbstractEscherHolderRecord,8,15,56,0.26785714285714285,1,0.125,36,4.5,41,0.7321428571428571,0.0,0.0,0.08095879861378515,0.004866596812775924,6,7,13
org.apache.poi.hssf.record.SeriesChartGroupIndexRecord,5,4,20,0.2,1,0.2,5,1.0,16,0.8,0.0,0.0,0.0,0.0,0,4,4
org.apache.poi.hssf.usermodel.HSSFCell,16,52,240,0.21666666666666667,1,0.0625,246,15.375,188,0.7833333333333333,0.05952380952380953,0.0037202380952380955,0.01949436491014316,0.004657474685084085,5,15,20
org.apache.poi.hssf.record.DimensionsRecord,4,3,12,0.25,1,0.25,4,1.0,9,0.75,0.0,0.0,0.025025025025025023,5.303238528346753e-07,4,3,7
org.apache.poi.hssf.eventmodel.ModelFactory,10,28,90,0.3111111111111111,1,0.1,252,25.2,62,0.6888888888888889,0.0,0.0,0.0,0.0,0,9,9
org.apache.poi.hpsf.PropertySet,12,23,132,0.17424242424242425,1,0.08333333333333333,16,1.3333333333333333,109,0.8257575757575758,0.0,0.0,0.009070294784580499,0.0002447948876520305,4,11,15
org.apache.poi.poifs.storage.BlockAllocationTableWriter,8,14,56,0.25,1,0.125,14,1.75,42,0.75,0.0,0.0,0.01789208834218619,0.00010427403284546136,2,7,9
org.apache.poi.hssf.record.PaneRecord,5,4,20,0.2,1,0.2,5,1.0,16,0.8,0.0,0.0,0.019070294784580496,2.7381629113230843e-06,2,4,6
org.apache.poi.hssf.util.RangeAddress,1,0,0,0,1,1.0,-1,-1.0,0,0,0.0,0.0,0.05673758865248226,0.0,3,0,3
org.apache.poi.poifs.filesystem.BATManaged,1,0,0,0,1,1.0,-1,-1.0,0,0,0.0,0.0,0.028463126544149994,0.0,5,0,5
org.apache.poi.hssf.model.Sheet,62,148,3782,0.03913273400317292,1,0.016129032258064516,241,3.8870967741935485,3634,0.960867265996827,0.0,0.0,0.02189828312277292,0.007525207741078179,6,62,68
org.apache.poi.poifs.filesystem.DocumentEntry,1,0,0,0,1,1.0,-1,-1.0,0,0,0.0,0.0,0.02834467120181406,0.0,6,0,6
org.apache.poi.hssf.record.SharedFormulaRecord,4,3,12,0.25,1,0.25,4,1.0,9,0.75,0.0,0.0,0.023879295307866737,1.2089431732288875e-05,5,3,8
org.apache.poi.hssf.usermodel.HSSFDataFormat,3,4,6,0.6666666666666666,1,0.3333333333333333,183,61.0,2,0.3333333333333333,0.0,0.0,0.007936507936507936,9.81785828937855e-05,2,2,4
org.apache.poi.util.LittleEndian,3,2,6,0.3333333333333333,1,0.3333333333333333,1,0.3333333333333333,4,0.6666666666666666,0.0,0.0,0.41796561144142697,0.0025703333598935023,184,2,186
org.apache.poi.hssf.record.formula.UnknownPtg,3,5,6,0.8333333333333334,1,0.3333333333333333,183,61.0,1,0.16666666666666666,0.0,0.0,0.0,0.0,0,2,2
org.apache.poi.hssf.record.Margin,1,0,0,0,1,1.0,-1,-1.0,0,0,0.0,0.0,0.02804048448647752,0.0,5,0,5
org.apache.poi.hssf.record.FnGroupCountRecord,4,3,12,0.25,1,0.25,4,1.0,9,0.75,0.0,0.0,0.07207207207207207,1.0758820475889111e-05,4,3,7
org.apache.poi.hssf.record.formula.UnaryMinusPtg,4,6,12,0.5,1,0.25,182,45.5,6,0.5,0.0,0.0,0.05807180369049726,1.288394145537002e-05,2,3,5
org.apache.poi.ddf.EscherChildAnchorRecord,6,10,30,0.3333333333333333,1,0.16666666666666666,8,1.3333333333333333,20,0.6666666666666666,0.0,0.0,0.049641478212906785,1.6957721039353692e-05,2,5,7
org.apache.poi.hssf.record.DrawingGroupRecord,2,1,2,0.5,1,0.5,37,18.5,1,0.5,0.0,0.0,0.07142857142857142,0.00021090473007603496,3,1,4
org.apache.poi.hssf.record.aggregates.FormulaRecordAggregate,6,10,30,0.3333333333333333,1,0.16666666666666666,187,31.166666666666668,20,0.6666666666666666,0.0,0.0,0.019115890083632018,7.933542584903126e-05,3,5,8
org.apache.poi.poifs.filesystem.DocumentInputStream,4,5,12,0.4166666666666667,1,0.25,62,15.5,7,0.5833333333333334,0.0,0.0,0.024389014865205342,0.0013963615749330034,5,3,8
org.apache.poi.hssf.record.formula.MemErrPtg,4,7,12,0.5833333333333334,1,0.25,182,45.5,5,0.4166666666666667,0.16666666666666666,0.041666666666666664,0.05764322949351943,5.768298903734896e-06,1,3,4
org.apache.poi.hssf.eventmodel.EventRecordFactory,82,314,6642,0.04727491719361638,1,0.012195121951219513,232,2.8292682926829267,6328,0.9527250828063836,0.0,0.0,0.009070294784580499,0.0009482690829917948,2,81,83
org.apache.poi.ddf.EscherClientAnchorRecord,6,10,30,0.3333333333333333,1,0.16666666666666666,8,1.3333333333333333,20,0.6666666666666666,0.0,0.0,0.050184008029441285,3.011774695448165e-05,4,5,9
org.apache.poi.hssf.record.BlankRecord,5,5,20,0.25,1,0.2,5,1.0,15,0.75,0.0,0.0,0.02620545073375262,1.2429073636236752e-05,5,4,9
org.apache.poi.hssf.record.ObjRecord,5,5,20,0.25,1,0.2,11,2.2,15,0.75,0.0,0.0,0.030130059686709933,0.0006618446331263275,9,4,13
org.apache.poi.hssf.record.DrawingRecordForBiffViewer,2,1,2,0.5,1,0.5,37,18.5,1,0.5,0.0,0.0,0.0030234315948601664,5.3777906282544504e-05,1,1,2
org.apache.poi.hssf.record.PColor,1,0,0,0,1,1.0,-1,-1.0,0,0,0.0,0.0,0.0546285832465451,0.0,1,0,1
org.apache.poi.ddf.EscherDgRecord,6,10,30,0.3333333333333333,1,0.16666666666666666,8,1.3333333333333333,20,0.6666666666666666,0.0,0.0,0.0569023569023569,2.0530458455628527e-05,3,5,8
org.apache.poi.hssf.record.CountryRecord,4,3,12,0.25,1,0.25,4,1.0,9,0.75,0.0,0.0,0.07207207207207207,1.0758820475889111e-05,4,3,7
org.apache.poi.hssf.record.formula.NotEqualPtg,3,3,6,0.5,1,0.3333333333333333,182,60.666666666666664,3,0.5,0.0,0.0,0.05807180369049726,1.0307153164296021e-05,2,2,4
org.apache.poi.hssf.record.formula.Ptg,36,83,1260,0.06587301587301587,1,0.027777777777777776,182,5.055555555555555,1177,0.9341269841269841,0.38823529411764707,0.010784313725490196,0.08265246133726858,0.019108480574660226,26,36,62
org.apache.poi.poifs.storage.HeaderBlockReader,8,10,56,0.17857142857142858,1,0.125,8,1.0,46,0.8214285714285714,0.0,0.0,0.017640389489128987,0.0002763190790073974,2,7,9
org.apache.poi.hssf.record.formula.AddPtg,3,3,6,0.5,1,0.3333333333333333,182,60.666666666666664,3,0.5,0.0,0.0,0.05807180369049726,1.0307153164296021e-05,2,2,4
org.apache.poi.hssf.record.InterfaceHdrRecord,4,3,12,0.25,1,0.25,4,1.0,9,0.75,0.0,0.0,0.07207207207207207,1.0758820475889111e-05,4,3,7
org.apache.poi.hssf.record.NameRecord,11,25,110,0.22727272727272727,1,0.09090909090909091,182,16.545454545454547,85,0.7727272727272727,0.16111111111111112,0.014646464646464647,0.07403466915992306,0.005043434322251037,7,10,17
org.apache.poi.poifs.property.Child,1,1,0,0,1,1.0,-1,-1.0,-1,0,0.0,0.0,0.027777777777777773,0.0,3,1,4
org.apache.poi.hssf.record.ChartFormatRecord,5,4,20,0.2,1,0.2,5,1.0,16,0.8,0.0,0.0,0.0030234315948601664,3.964289678575393e-07,1,4,5
org.apache.poi.hssf.dev.HSSF,11,25,110,0.22727272727272727,1,0.09090909090909091,342,31.09090909090909,85,0.7727272727272727,0.0,0.0,0.0,0.0,0,10,10
org.apache.poi.poifs.filesystem.DocumentNode,8,22,56,0.39285714285714285,1,0.125,62,7.75,34,0.6071428571428571,0.0,0.0,0.022398074876208988,0.001043034818545023,3,7,10
org.apache.poi.hssf.record.RecordFormatException,1,0,0,0,1,1.0,-1,-1.0,0,0,0.0,0.0,0.3144872763920383,0.0,140,0,140
org.apache.poi.hpsf.PropertySetFactory,7,12,42,0.2857142857142857,1,0.14285714285714285,21,3.0,30,0.7142857142857143,0.0,0.0,0.0,0.0,0,6,6
org.apache.poi.hssf.record.formula.ExpPtg,3,6,6,1.0,1,0.3333333333333333,182,60.666666666666664,0,0.0,0.0,0.0,0.05785672293608802,0.0,2,2,4
org.apache.poi.ddf.EscherSpgrRecord,7,11,42,0.2619047619047619,1,0.14285714285714285,9,1.2857142857142858,31,0.7380952380952381,0.0,0.0,0.0472168301768008,5.570770876893326e-06,2,6,8
