name,Size,Ties,Pairs,Density,WeakComp,nWeakComp,2StepReach,ReachEffic,Broker,nBroker,EgoBetween,nEgoBetween,Closeness_Centrality,Betweenness_Centrality,in_degree,out_degree,degree
org.apache.camel.AlreadyStoppedException,2,1,2,0.5,1,0.5,0,0.0,1,0.5,0.0,0.0,0.10136355225461482,1.5673944340256252e-06,2,1,3
org.apache.camel.AsyncCallback,1,0,0,0,1,1.0,-1,-1.0,0,0,0.0,0.0,0.0012515644555694619,0.0,2,0,2
org.apache.camel.AsyncProcessor,2,2,2,1.0,1,0.5,277,138.5,0,0.0,0.0,0.0,0.14522755327721296,0.0001995978849579507,21,1,22
org.apache.camel.bam.ActivityBuilder,11,27,110,0.24545454545454545,1,0.09090909090909091,297,27.0,83,0.7545454545454545,0.19444444444444445,0.017676767676767676,0.002852402712693192,2.6860405490001186e-05,3,11,14
org.apache.camel.bam.ActivityLifecycle,1,0,0,0,1,1.0,-1,-1.0,0,0,0.0,0.0,0.002514303593777937,0.0,2,0,2
org.apache.camel.bam.model.ActivityDefinition,3,4,6,0.6666666666666666,1,0.3333333333333333,1,0.3333333333333333,2,0.3333333333333333,0.0,0.0,0.0052148518982060915,4.460543326831258e-06,4,2,6
org.apache.camel.bam.model.ActivityState,6,13,30,0.43333333333333335,1,0.16666666666666666,297,49.5,17,0.5666666666666667,0.30000000000000004,0.05000000000000001,0.006132665832290362,8.023298162506299e-05,9,5,14
org.apache.camel.bam.model.EntitySupport,1,0,0,0,1,1.0,-1,-1.0,0,0,0.0,0.0,0.004827462900053638,0.0,3,0,3
org.apache.camel.bam.model.ProcessDefinition,2,2,2,1.0,1,0.5,0,0.0,0,0.0,0.0,0.0,0.005340008343763037,2.1747597772105555e-06,6,2,8
org.apache.camel.bam.model.ProcessInstance,4,8,12,0.6666666666666666,1,0.25,297,74.25,4,0.3333333333333333,0.3333333333333333,0.08333333333333333,0.005332752897643794,8.013051227879092e-06,8,3,11
org.apache.camel.bam.model.TemporalEntity,2,1,2,0.5,1,0.5,0,0.0,1,0.5,0.0,0.0,0.004022885750044699,7.118583054533047e-07,1,1,2
org.apache.camel.bam.ProcessBuilder,10,23,90,0.25555555555555554,1,0.1,297,29.7,67,0.7444444444444445,0.06944444444444445,0.006944444444444445,0.0036074504895825662,5.1598298227616494e-05,3,10,13
org.apache.camel.bam.processor.ActivityMonitorEngine,4,5,12,0.4166666666666667,1,0.25,298,74.5,7,0.5833333333333334,0.0,0.0,0.0,0.0,0,3,3
org.apache.camel.bam.processor.BamProcessorSupport,5,6,20,0.3,1,0.2,279,55.8,14,0.7,0.25,0.05,0.0021945239768889195,6.729183499829807e-05,2,4,6
org.apache.camel.bam.processor.JpaBamProcessor,7,21,42,0.5,1,0.14285714285714285,297,42.42857142857143,21,0.5,0.0,0.0,0.002666376448821897,2.8988380700719936e-05,1,6,7
org.apache.camel.bam.processor.JpaBamProcessorSupport,7,10,42,0.23809523809523808,1,0.14285714285714285,297,42.42857142857143,32,0.7619047619047619,0.0,0.0,0.0021518125727334604,2.081859002943828e-05,1,6,7
org.apache.camel.bam.processor.NoCorrelationKeyException,3,3,6,0.5,1,0.3333333333333333,279,93.0,3,0.5,0.5,0.16666666666666666,0.0018204573899192173,5.551188620507423e-06,1,2,3
org.apache.camel.bam.processor.ProcessContext,6,19,30,0.6333333333333333,1,0.16666666666666666,297,49.5,11,0.36666666666666664,0.05,0.008333333333333333,0.003956558601477653,4.950354087464265e-06,2,5,7
org.apache.camel.bam.rules.ActivityRules,10,32,90,0.35555555555555557,1,0.1,297,29.7,58,0.6444444444444445,0.25,0.025,0.005332752897643794,0.0007755684499636121,8,9,17
org.apache.camel.bam.rules.ProcessRules,8,21,56,0.375,1,0.125,297,37.125,35,0.625,0.011904761904761904,0.001488095238095238,0.003956558601477653,7.235261371125472e-05,4,7,11
org.apache.camel.bam.rules.TemporalRule,14,33,182,0.1813186813186813,1,0.07142857142857142,297,21.214285714285715,149,0.8186813186813187,0.0641025641025641,0.004578754578754578,0.0036074504895825662,0.0009550067505015496,3,14,17
org.apache.camel.bam.TimeExpression,7,22,42,0.5238095238095238,1,0.14285714285714285,297,42.42857142857143,20,0.47619047619047616,0.3277777777777778,0.046825396825396826,0.002852402712693192,5.5724231049445795e-05,3,7,10
org.apache.camel.Body,1,0,0,0,1,1.0,-1,-1.0,0,0,0.0,0.0,0.10438333678945313,0.0,8,0,8
org.apache.camel.builder.BinaryPredicateSupport,2,1,2,0.5,1,0.5,0,0.0,1,0.5,0.0,0.0,0.0,0.0,0,1,1
org.apache.camel.builder.Builder,3,4,6,0.6666666666666666,1,0.3333333333333333,2,0.6666666666666666,2,0.3333333333333333,0.0,0.0,0.09215767281917932,7.324687739301367e-06,4,2,6
org.apache.camel.builder.BuilderSupport,12,24,132,0.18181818181818182,1,0.08333333333333333,285,23.75,108,0.8181818181818182,0.0,0.0,0.11406857123294704,0.0035674308081535757,2,12,14
org.apache.camel.builder.ConstantProcessorBuilder,3,3,6,0.5,1,0.3333333333333333,279,93.0,3,0.5,0.0,0.0,0.06505060351827409,0.0,1,2,3
org.apache.camel.builder.DataFormatClause,11,18,110,0.16363636363636364,1,0.09090909090909091,277,25.181818181818183,92,0.8363636363636363,0.0,0.0,0.16722383980154437,0.0023754385112469707,1,10,11
org.apache.camel.builder.DeadLetterChannelBuilder,14,26,182,0.14285714285714285,1,0.07142857142857142,280,20.0,156,0.8571428571428571,0.0,0.0,0.0827811654102512,0.001973597383291731,2,14,16
org.apache.camel.builder.ErrorHandlerBuilder,4,9,12,0.75,1,0.25,277,69.25,3,0.25,0.0,0.0,0.20321102205463215,0.00022182070134565984,17,4,21
org.apache.camel.builder.ErrorHandlerBuilderRef,6,16,30,0.5333333333333333,1,0.16666666666666666,277,46.166666666666664,14,0.4666666666666667,0.0,0.0,0.1671938713714724,0.0007355291295235484,1,5,6
org.apache.camel.builder.ErrorHandlerBuilderSupport,4,8,12,0.6666666666666666,1,0.25,277,69.25,4,0.3333333333333333,0.0,0.0,0.14534067646873597,0.0011773931118164633,6,3,9
org.apache.camel.builder.ExpressionBuilder,3,2,6,0.3333333333333333,1,0.3333333333333333,1,0.3333333333333333,4,0.6666666666666666,0.0,0.0,0.0,0.0,0,2,2
org.apache.camel.builder.ExpressionClause,9,21,72,0.2916666666666667,1,0.1111111111111111,277,30.77777777777778,51,0.7083333333333334,0.0,0.0,0.1804180627060174,0.00586068595361662,5,9,14
org.apache.camel.builder.LoggingErrorHandlerBuilder,8,15,56,0.26785714285714285,1,0.125,279,34.875,41,0.7321428571428571,0.0,0.0,0.0827811654102512,0.0004432648347645479,1,7,8
org.apache.camel.builder.NoErrorHandlerBuilder,5,9,20,0.45,1,0.2,277,55.4,11,0.55,0.0,0.0,0.17865603260299046,0.0008055842879263109,2,4,6
org.apache.camel.builder.NoRouteBuilder,1,1,0,0,1,1.0,-1,-1.0,-1,0,0.0,0.0,0.0018773466833541927,0.0,4,1,5
org.apache.camel.builder.PredicateBuilder,2,1,2,0.5,1,0.5,0,0.0,1,0.5,0.0,0.0,0.0,0.0,0,1,1
org.apache.camel.builder.PredicateFactory,2,1,2,0.5,1,0.5,0,0.0,1,0.5,0.0,0.0,0.0,0.0,0,1,1
org.apache.camel.builder.PredicateSupport,2,1,2,0.5,1,0.5,0,0.0,1,0.5,0.0,0.0,0.0,0.0,0,1,1
org.apache.camel.builder.ProcessorBuilder,3,2,6,0.3333333333333333,1,0.3333333333333333,278,92.66666666666667,4,0.6666666666666666,0.0,0.0,0.0,0.0,0,2,2
org.apache.camel.builder.ProcessorFactory,2,1,2,0.5,1,0.5,278,139.0,1,0.5,0.0,0.0,0.06738017206635584,0.0,3,1,4
org.apache.camel.builder.RouteBuilder,16,56,240,0.23333333333333334,1,0.0625,289,18.0625,184,0.7666666666666667,0.0,0.0,0.1840835921042111,0.0322995362110124,276,16,292
org.apache.camel.builder.script.ScriptBuilder,6,7,30,0.23333333333333334,1,0.16666666666666666,279,46.5,23,0.7666666666666667,0.0,0.0,0.0008343763037129745,0.00011043599949738883,2,6,8
org.apache.camel.builder.script.ScriptEvaluationException,2,1,2,0.5,1,0.5,0,0.0,1,0.5,0.0,0.0,0.0009386733416770963,9.796215212660157e-07,1,1,2
org.apache.camel.builder.script.ScriptLanguage,5,9,20,0.45,1,0.2,280,56.0,11,0.55,0.0,0.0,0.0006257822277847309,2.6776321581271095e-06,1,4,5
org.apache.camel.builder.script.ScriptLanguageResolver,5,8,20,0.4,1,0.2,281,56.2,12,0.6,0.0,0.0,0.0,0.0,0,4,4
org.apache.camel.builder.sql.SqlBuilder,3,3,6,0.5,1,0.3333333333333333,2,0.6666666666666666,3,0.5,0.0,0.0,0.0006257822277847309,5.877729127596095e-07,2,3,5
org.apache.camel.builder.ValueBuilder,3,3,6,0.5,1,0.3333333333333333,1,0.3333333333333333,3,0.5,0.0,0.0,0.09618782968442974,4.568685859472976e-06,8,3,11
org.apache.camel.builder.xml.DefaultNamespaceContext,2,2,2,1.0,1,0.5,0,0.0,0,0.0,0.0,0.0,0.0014303593777936707,1.9592430425320315e-07,3,2,5
org.apache.camel.builder.xml.DomResultHandler,3,4,6,0.6666666666666666,1,0.3333333333333333,279,93.0,2,0.3333333333333333,0.0,0.0,0.0009386733416770963,5.466288088664369e-05,1,2,3
org.apache.camel.builder.xml.DomResultHandlerFactory,4,5,12,0.4166666666666667,1,0.25,281,70.25,7,0.5833333333333334,0.0,0.0,0.0008343763037129745,7.836972170128126e-07,1,3,4
org.apache.camel.builder.xml.InvalidXPathExpression,2,1,2,0.5,1,0.5,1,0.5,1,0.5,0.0,0.0,0.0009386733416770963,0.0,1,1,2
org.apache.camel.builder.xml.MessageVariableResolver,3,4,6,0.6666666666666666,1,0.3333333333333333,278,92.66666666666667,2,0.3333333333333333,0.0,0.0,0.0009386733416770963,7.44512356162172e-06,1,2,3
org.apache.camel.builder.xml.Namespaces,5,5,20,0.25,1,0.2,277,55.4,15,0.75,0.0,0.0,0.14652769000358348,0.0013960312184755294,5,5,10
org.apache.camel.builder.xml.ResultHandler,2,2,2,1.0,1,0.5,278,139.0,0,0.0,0.0,0.0,0.00506883604505632,0.0002736409449403071,8,1,9
org.apache.camel.builder.xml.ResultHandlerFactory,2,1,2,0.5,1,0.5,279,139.5,1,0.5,0.0,0.0,0.0026074259491030457,0.0,4,1,5
org.apache.camel.builder.xml.StreamResultHandler,3,4,6,0.6666666666666666,1,0.3333333333333333,279,93.0,2,0.3333333333333333,0.0,0.0,0.0009386733416770963,5.466288088664369e-05,1,2,3
org.apache.camel.builder.xml.StreamResultHandlerFactory,4,5,12,0.4166666666666667,1,0.25,281,70.25,7,0.5833333333333334,0.0,0.0,0.0008343763037129745,7.836972170128126e-07,1,3,4
org.apache.camel.builder.xml.StringResultHandler,3,4,6,0.6666666666666666,1,0.3333333333333333,279,93.0,2,0.3333333333333333,0.0,0.0,0.0009386733416770963,5.466288088664369e-05,1,2,3
org.apache.camel.builder.xml.StringResultHandlerFactory,4,5,12,0.4166666666666667,1,0.25,281,70.25,7,0.5833333333333334,0.0,0.0,0.0008343763037129745,7.836972170128126e-07,1,3,4
org.apache.camel.builder.xml.XPathBuilder,9,16,72,0.2222222222222222,1,0.1111111111111111,281,31.22222222222222,56,0.7777777777777778,0.0,0.0,0.0008343763037129745,0.00014568791318336576,2,9,11
org.apache.camel.builder.xml.XPathLanguage,5,8,20,0.4,1,0.2,282,56.4,12,0.6,0.0,0.0,0.0006257822277847309,3.7145848627091224e-05,1,4,5
org.apache.camel.builder.xml.XsltBuilder,10,19,90,0.2111111111111111,1,0.1,292,29.2,71,0.7888888888888889,0.0,0.0,0.0006257822277847309,5.159340012001016e-06,2,10,12
org.apache.camel.CamelContext,12,17,132,0.12878787878787878,1,0.08333333333333333,277,23.083333333333332,115,0.8712121212121212,0.43636363636363634,0.03636363636363636,0.3642880914692761,0.06411116627176508,172,11,183
org.apache.camel.CamelContextAware,2,1,2,0.5,1,0.5,277,138.5,1,0.5,0.0,0.0,0.1671938713714724,9.796215212660158e-08,9,1,10
org.apache.camel.CamelException,1,0,0,0,1,1.0,-1,-1.0,0,0,0.0,0.0,0.17284880436829222,0.0,8,0,8
org.apache.camel.CamelExchangeException,3,3,6,0.5,1,0.3333333333333333,277,92.33333333333333,3,0.5,0.0,0.0,0.11618204262177038,8.412598493695484e-05,9,2,11
org.apache.camel.CamelTemplate,3,3,6,0.5,1,0.3333333333333333,279,93.0,3,0.5,0.0,0.0,0.0,0.0,0,2,2
org.apache.camel.Component,3,5,6,0.8333333333333334,1,0.3333333333333333,277,92.33333333333333,1,0.16666666666666666,0.0,0.0,0.25722134057149604,0.0005806835895920142,21,2,23
org.apache.camel.component.atom.AtomComponent,4,5,12,0.4166666666666667,1,0.25,293,73.25,7,0.5833333333333334,0.3333333333333333,0.08333333333333333,0.002816020025031289,4.287476858074262e-05,1,3,4
org.apache.camel.component.atom.AtomConsumerSupport,3,4,6,0.6666666666666666,1,0.3333333333333333,293,97.66666666666667,2,0.3333333333333333,0.0,0.0,0.0029816682617978354,1.9592430425320315e-07,2,2,4
org.apache.camel.component.atom.AtomConverter,2,1,2,0.5,1,0.5,0,0.0,1,0.5,0.0,0.0,0.0,0.0,0,1,1
org.apache.camel.component.atom.AtomEndpoint,11,22,110,0.2,1,0.09090909090909091,293,26.636363636363637,88,0.8,0.35000000000000003,0.03181818181818182,0.00506883604505632,0.0007087561706359624,8,10,18
org.apache.camel.component.atom.AtomEntryPollingConsumer,6,12,30,0.4,1,0.16666666666666666,293,48.833333333333336,18,0.6,0.325,0.05416666666666667,0.002816020025031289,6.465502040355704e-06,1,5,6
org.apache.camel.component.atom.AtomPollingConsumer,4,6,12,0.5,1,0.25,293,73.25,6,0.5,0.3333333333333333,0.08333333333333333,0.0029816682617978354,1.5673944340256252e-06,2,3,5
org.apache.camel.component.atom.AtomProducer,3,4,6,0.6666666666666666,1,0.3333333333333333,294,98.0,2,0.3333333333333333,0.0,0.0,0.0,0.0,0,2,2
org.apache.camel.component.atom.AtomUtils,1,0,0,0,1,1.0,-1,-1.0,0,0,0.0,0.0,0.002720792294716221,0.0,3,0,3
org.apache.camel.component.atom.EntryFilter,2,1,2,0.5,1,0.5,293,146.5,1,0.5,0.0,0.0,0.00253441802252816,5.720989684193532e-05,3,1,4
org.apache.camel.component.atom.UpdatedDateFilter,3,3,6,0.5,1,0.3333333333333333,293,97.66666666666667,3,0.5,0.0,0.0,0.0023040163841165093,5.720989684193532e-05,2,2,4
org.apache.camel.component.bean.AmbiguousMethodCallException,3,4,6,0.6666666666666666,1,0.3333333333333333,277,92.33333333333333,2,0.3333333333333333,0.0,0.0,0.10312167594261258,0.00010314625180342661,1,2,3
org.apache.camel.component.bean.AnnotationExpressionFactory,3,2,6,0.3333333333333333,1,0.3333333333333333,277,92.33333333333333,4,0.6666666666666666,0.0,0.0,0.10329293647617538,0.0,2,2,4
org.apache.camel.component.bean.BeanComponent,7,11,42,0.2619047619047619,1,0.14285714285714285,287,41.0,31,0.7380952380952381,0.0,0.0,0.0006257822277847309,1.5505698231365804e-05,1,6,7
org.apache.camel.component.bean.BeanEndpoint,7,13,42,0.30952380952380953,1,0.14285714285714285,286,40.857142857142854,29,0.6904761904761905,0.0,0.0,0.0014080100125156445,0.00011541900763556198,2,6,8
org.apache.camel.component.bean.BeanExchange,6,14,30,0.4666666666666667,1,0.16666666666666666,283,47.166666666666664,16,0.5333333333333333,0.0,0.0,0.003110505779282927,9.95603346655813e-05,3,5,8
org.apache.camel.component.bean.BeanHolder,3,2,6,0.3333333333333333,1,0.3333333333333333,277,92.33333333333333,4,0.6666666666666666,0.0,0.0,0.1190280431555009,3.341815549545469e-05,6,2,8
org.apache.camel.component.bean.BeanInfo,18,30,306,0.09803921568627451,1,0.05555555555555555,277,15.38888888888889,276,0.9019607843137255,0.0,0.0,0.11910402173532696,0.00597200109688529,6,17,23
org.apache.camel.component.bean.BeanInvocation,4,4,12,0.3333333333333333,1,0.25,277,69.25,8,0.6666666666666666,0.0,0.0,0.11934780635190177,0.0010648392638873852,6,3,9
org.apache.camel.component.bean.BeanProcessor,11,25,110,0.22727272727272727,1,0.09090909090909091,277,25.181818181818183,85,0.7727272727272727,0.0,0.0,0.1400392978464149,0.005560140564801123,11,10,21
org.apache.camel.component.bean.CamelInvocationHandler,7,16,42,0.38095238095238093,1,0.14285714285714285,284,40.57142857142857,26,0.6190476190476191,0.0,0.0,0.002107898030432778,2.9553781837279603e-05,2,6,8
org.apache.camel.component.bean.ConstantBeanHolder,7,11,42,0.2619047619047619,1,0.14285714285714285,277,39.57142857142857,31,0.7380952380952381,0.0,0.0,0.11870998883481564,2.351091651038438e-06,2,6,8
org.apache.camel.component.bean.DefaultAnnotationExpressionFactory,6,9,30,0.3,1,0.16666666666666666,278,46.333333333333336,21,0.7,0.0,0.0,0.0012515644555694619,1.5673944340256252e-06,2,5,7
org.apache.camel.component.bean.DefaultParameterMappingStrategy,3,3,6,0.5,1,0.3333333333333333,1,0.3333333333333333,3,0.5,0.0,0.0,0.10321080055614026,3.918486085064063e-07,2,2,4
org.apache.camel.component.bean.MethodBean,1,0,0,0,1,1.0,-1,-1.0,0,0,0.0,0.0,0.10338207636190884,0.0,1,0,1
org.apache.camel.component.bean.MethodInfo,5,6,20,0.3,1,0.2,277,55.4,14,0.7,0.0,0.0,0.10312167594261258,0.0,1,4,5
org.apache.camel.component.bean.MethodInvocation,1,0,0,0,1,1.0,-1,-1.0,0,0,0.0,0.0,0.10343929469064579,0.0,4,0,4
org.apache.camel.component.bean.NoBeanAvailableException,2,1,2,0.5,1,0.5,0,0.0,1,0.5,0.0,0.0,0.11723379604005696,3.167442918760118e-06,1,1,2
org.apache.camel.component.bean.ParameterInfo,2,1,2,0.5,1,0.5,0,0.0,1,0.5,0.0,0.0,0.10327924273157538,0.0,2,1,3
org.apache.camel.component.bean.ParameterMappingStrategy,2,1,2,0.5,1,0.5,0,0.0,1,0.5,0.0,0.0,0.11943353652956842,2.9780494246486873e-06,7,1,8
org.apache.camel.component.bean.ProxyHelper,3,3,6,0.5,1,0.3333333333333333,285,95.0,3,0.5,0.0,0.0,0.0020480145636591193,2.1832498303948604e-05,3,2,5
org.apache.camel.component.bean.RegistryBean,10,22,90,0.24444444444444444,1,0.1,277,27.7,68,0.7555555555555555,0.0,0.0,0.138234079456633,0.0043638609981909845,4,9,13
org.apache.camel.component.bean.XPathAnnotationExpressionFactory,7,9,42,0.21428571428571427,1,0.14285714285714285,281,40.142857142857146,33,0.7857142857142857,0.0,0.0,0.0,0.0,0,6,6
org.apache.camel.component.cxf.AsyncProcessorDecorator,6,10,30,0.3333333333333333,1,0.16666666666666666,279,46.5,20,0.6666666666666666,0.0,0.0,0.0,0.0,0,5,5
org.apache.camel.component.cxf.CamelInvoker,9,22,72,0.3055555555555556,1,0.1111111111111111,330,36.666666666666664,50,0.6944444444444444,0.14285714285714285,0.015873015873015872,0.0021578697509818307,4.186249300876774e-05,1,8,9
org.apache.camel.component.cxf.CxfBinding,5,11,20,0.55,1,0.2,286,57.2,9,0.45,0.16666666666666666,0.03333333333333333,0.0037052895066201175,3.0172342854993287e-06,3,4,7
org.apache.camel.component.cxf.CxfComponent,4,6,12,0.5,1,0.25,330,82.5,6,0.5,0.3333333333333333,0.08333333333333333,0.003293590672551215,0.00017179511379368276,3,3,6
org.apache.camel.component.cxf.CxfConstants,1,0,0,0,1,1.0,-1,-1.0,0,0,0.0,0.0,0.009312235532510878,0.0,10,0,10
org.apache.camel.component.cxf.CxfConsumer,9,15,72,0.20833333333333334,1,0.1111111111111111,330,36.666666666666664,57,0.7916666666666666,0.27678571428571425,0.03075396825396825,0.0031289111389236545,8.538845401482319e-05,2,8,10
org.apache.camel.component.cxf.CxfEndpoint,13,24,156,0.15384615384615385,1,0.07692307692307693,330,25.384615384615383,132,0.8461538461538461,0.2196969696969697,0.0168997668997669,0.0052148518982060915,0.00032635304222463035,8,12,20
org.apache.camel.component.cxf.CxfExchange,7,21,42,0.5,1,0.14285714285714285,286,40.857142857142854,21,0.5,0.11666666666666667,0.016666666666666666,0.005632040050062579,0.00045909820255962084,7,6,13
org.apache.camel.component.cxf.CxfMessage,5,12,20,0.6,1,0.2,286,57.2,8,0.4,0.25,0.05,0.003911138923654568,6.674487964892454e-06,4,5,9
org.apache.camel.component.cxf.CxfProducer,15,32,210,0.1523809523809524,1,0.06666666666666667,330,22.0,178,0.8476190476190476,0.1043956043956044,0.00695970695970696,0.0029799153704034805,8.420098320195824e-05,1,14,15
org.apache.camel.component.cxf.CxfSoapBinding,2,1,2,0.5,1,0.5,0,0.0,1,0.5,0.0,0.0,0.0015018773466833543,0.0,2,1,3
org.apache.camel.component.cxf.CxfSoapComponent,6,7,30,0.23333333333333334,1,0.16666666666666666,281,46.833333333333336,23,0.7666666666666667,0.0,0.0,0.0,0.0,0,5,5
org.apache.camel.component.cxf.CxfSoapConsumer,7,9,42,0.21428571428571427,1,0.14285714285714285,335,47.857142857142854,33,0.7857142857142857,0.0,0.0,0.0,0.0,0,6,6
org.apache.camel.component.cxf.CxfSoapEndpoint,9,23,72,0.3194444444444444,1,0.1111111111111111,278,30.88888888888889,49,0.6805555555555556,0.0,0.0,0.0018773466833541927,0.00012010105046720165,3,8,11
org.apache.camel.component.cxf.CxfSoapProducer,14,31,182,0.17032967032967034,1,0.07142857142857142,337,24.071428571428573,151,0.8296703296703297,0.0,0.0,0.0,0.0,0,13,13
org.apache.camel.component.cxf.DataFormat,2,1,2,0.5,1,0.5,278,139.0,1,0.5,0.0,0.0,0.005319148936170213,2.6897368831517886e-06,7,1,8
org.apache.camel.component.cxf.feature.AbstractDataFormatFeature,3,2,6,0.3333333333333333,1,0.3333333333333333,279,93.0,4,0.6666666666666666,0.0,0.0,0.0025180284879909413,0.0,2,2,4
org.apache.camel.component.cxf.feature.MessageDataFormatFeature,7,8,42,0.19047619047619047,1,0.14285714285714285,286,40.857142857142854,34,0.8095238095238095,0.0,0.0,0.002611022398688015,2.085940759282436e-05,2,6,8
org.apache.camel.component.cxf.feature.MessageInvokerInterceptor,4,4,12,0.3333333333333333,1,0.25,279,69.75,8,0.6666666666666666,0.0,0.0,0.0,0.0,0,3,3
org.apache.camel.component.cxf.feature.PayLoadDataFormatFeature,9,11,72,0.1527777777777778,1,0.1111111111111111,294,32.666666666666664,61,0.8472222222222222,0.0,0.0,0.002611022398688015,6.559167988624335e-05,2,8,10
org.apache.camel.component.cxf.interceptors.AbstractMessageInInterceptor,4,4,12,0.3333333333333333,1,0.25,278,69.5,8,0.6666666666666666,0.0,0.0,0.0031192837200346587,4.554295779454709e-06,3,3,6
org.apache.camel.component.cxf.interceptors.AbstractMessageOutInterceptor,4,4,12,0.3333333333333333,1,0.25,278,69.5,8,0.6666666666666666,0.0,0.0,0.002225003476567932,9.796215212660157e-07,2,3,5
org.apache.camel.component.cxf.interceptors.DOMInInterceptor,6,10,30,0.3333333333333333,1,0.16666666666666666,285,47.5,20,0.6666666666666666,0.0,0.0,0.0021978692878292985,2.2773367486138078e-05,1,5,6
org.apache.camel.component.cxf.interceptors.DOMOutInterceptor,4,6,12,0.5,1,0.25,283,70.75,6,0.5,0.6666666666666666,0.16666666666666666,0.003200022755717374,2.019558606900209e-05,4,3,7
org.apache.camel.component.cxf.interceptors.FakeBindingOperationInfo,1,0,0,0,1,1.0,-1,-1.0,0,0,0.0,0.0,0.002190237797246558,0.0,1,0,1
org.apache.camel.component.cxf.interceptors.FaultOutInterceptor,3,3,6,0.5,1,0.3333333333333333,279,93.0,3,0.5,0.0,0.0,0.0025180284879909413,5.387918366963087e-06,2,2,4
org.apache.camel.component.cxf.interceptors.PayloadContentRedirectInterceptor,2,2,2,1.0,1,0.5,278,139.0,0,0.0,0.0,0.0,0.0021978692878292985,9.796215212660158e-08,1,1,2
org.apache.camel.component.cxf.interceptors.RawMessageContentRedirectInterceptor,2,2,2,1.0,1,0.5,278,139.0,0,0.0,0.0,0.0,0.0021978692878292985,1.9592430425320315e-07,1,1,2
org.apache.camel.component.cxf.interceptors.SoapMessageInInterceptor,4,5,12,0.4166666666666667,1,0.25,279,69.75,7,0.5833333333333334,0.0,0.0,0.0026700041718815187,5.533917300720725e-06,2,3,5
org.apache.camel.component.cxf.interceptors.SoapMessageOutInterceptor,5,7,20,0.35,1,0.2,283,56.6,13,0.65,0.25,0.05,0.0024276034698545597,5.094031910583282e-06,1,4,5
org.apache.camel.component.cxf.interceptors.XMLMessageInInterceptor,4,5,12,0.4166666666666667,1,0.25,279,69.75,7,0.5833333333333334,0.0,0.0,0.001958466601770732,3.7705985624418967e-06,1,3,4
org.apache.camel.component.cxf.interceptors.XMLMessageOutInterceptor,5,7,20,0.35,1,0.2,283,56.6,13,0.65,0.25,0.05,0.0024276034698545597,7.558468444670491e-06,1,4,5
org.apache.camel.component.cxf.invoker.AbstractInvokingContext,4,5,12,0.4166666666666667,1,0.25,279,69.75,7,0.5833333333333334,0.0,0.0,0.002114712355962194,7.836972170128126e-07,2,3,5
org.apache.camel.component.cxf.invoker.CxfClient,5,11,20,0.55,1,0.2,279,55.8,9,0.45,0.0,0.0,0.0027306860848788257,1.7633187382788283e-06,2,4,6
org.apache.camel.component.cxf.invoker.CxfClientFactoryBean,3,3,6,0.5,1,0.3333333333333333,280,93.33333333333333,3,0.5,0.0,0.0,0.002366239048811014,3.265405070886719e-07,1,2,3
org.apache.camel.component.cxf.invoker.InvokingContext,3,6,6,1.0,1,0.3333333333333333,278,92.66666666666667,0,0.0,0.0,0.0,0.0044110015568240785,6.243454495535408e-05,4,2,6
org.apache.camel.component.cxf.invoker.InvokingContextFactory,6,6,30,0.2,1,0.16666666666666666,284,47.333333333333336,24,0.8,0.0,0.0,0.002366239048811014,1.8698869991216664e-05,1,5,6
org.apache.camel.component.cxf.invoker.PayloadInvokingContext,6,12,30,0.4,1,0.16666666666666666,281,46.833333333333336,18,0.6,0.0,0.0,0.0020480145636591193,3.669778274194426e-05,1,5,6
org.apache.camel.component.cxf.invoker.PayloadMessage,2,1,2,0.5,1,0.5,2,1.0,1,0.5,0.0,0.0,0.0018553894122038512,3.455959120317461e-06,1,1,2
org.apache.camel.component.cxf.invoker.RawMessageInvokingContext,5,11,20,0.55,1,0.2,280,56.0,9,0.45,0.0,0.0,0.0020480145636591193,2.971518614506915e-05,1,4,5
org.apache.camel.component.cxf.MessageInvoker,2,2,2,1.0,1,0.5,278,139.0,0,0.0,0.0,0.0,0.0021978692878292985,3.918486085064063e-07,2,1,3
org.apache.camel.component.cxf.spring.CxfEndpointBean,1,0,0,0,1,1.0,-1,-1.0,0,0,0.0,0.0,0.005575150756627603,0.0,6,0,6
org.apache.camel.component.cxf.spring.CxfEndpointBeanDefinitionParser,3,2,6,0.3333333333333333,1,0.3333333333333333,3,1.0,4,0.6666666666666666,0.0,0.0,0.0006257822277847309,1.5673944340256252e-06,1,2,3
org.apache.camel.component.cxf.spring.NamespaceHandler,2,1,2,0.5,1,0.5,4,2.0,1,0.5,0.0,0.0,0.0,0.0,0,1,1
org.apache.camel.component.cxf.transport.CamelConduit,8,15,56,0.26785714285714285,1,0.125,281,35.125,41,0.7321428571428571,0.07142857142857142,0.008928571428571428,0.001668752607425949,0.00014130856804622728,2,7,9
org.apache.camel.component.cxf.transport.CamelDestination,9,17,72,0.2361111111111111,1,0.1111111111111111,282,31.333333333333332,55,0.7638888888888888,0.19642857142857142,0.021825396825396824,0.003899104650043323,0.00056589008774564,6,8,14
org.apache.camel.component.cxf.transport.CamelTransportFactory,3,3,6,0.5,1,0.3333333333333333,283,94.33333333333333,3,0.5,0.0,0.0,0.0014080100125156445,8.15645685141416e-06,2,2,4
org.apache.camel.component.cxf.transport.spring.AbstractCamelContextBeanDefinitionParser,2,1,2,0.5,1,0.5,2,1.0,1,0.5,0.0,0.0,0.0014080100125156445,3.5266374765576567e-06,2,1,3
org.apache.camel.component.cxf.transport.spring.CamelConduitDefinitionParser,2,1,2,0.5,1,0.5,3,1.5,1,0.5,0.0,0.0,0.0006257822277847309,7.836972170128126e-07,1,1,2
org.apache.camel.component.cxf.transport.spring.CamelDestinationDefinitionParser,3,2,6,0.3333333333333333,1,0.3333333333333333,284,94.66666666666667,4,0.6666666666666666,0.0,0.0,0.0006257822277847309,0.00011089315620731303,1,2,3
org.apache.camel.component.cxf.transport.spring.NamespaceHandler,3,2,6,0.3333333333333333,1,0.3333333333333333,286,95.33333333333333,4,0.6666666666666666,0.0,0.0,0.0,0.0,0,2,2
org.apache.camel.component.cxf.util.CxfEndpointUtils,10,14,90,0.15555555555555556,1,0.1,330,33.0,76,0.8444444444444444,0.0,0.0,0.003911138923654568,7.493465475147337e-05,6,9,15
org.apache.camel.component.cxf.util.DataInInterceptor,2,2,2,1.0,1,0.5,278,139.0,0,0.0,0.0,0.0,0.0023105805333590067,5.446695658239049e-05,1,1,2
org.apache.camel.component.cxf.util.DataOutInterceptor,2,2,2,1.0,1,0.5,278,139.0,0,0.0,0.0,0.0,0.0023105805333590067,5.446695658239049e-05,1,1,2
org.apache.camel.component.cxf.util.Dummy,1,0,0,0,1,1.0,-1,-1.0,0,0,0.0,0.0,0.0006257822277847309,0.0,1,0,1
org.apache.camel.component.cxf.util.NullConduit,2,2,2,1.0,1,0.5,278,139.0,0,0.0,0.0,0.0,0.0018773466833541927,3.265405070886719e-07,3,1,4
org.apache.camel.component.cxf.util.NullConduitSelector,5,10,20,0.5,1,0.2,279,55.8,10,0.5,0.0,0.0,0.0006257822277847309,1.3061620283546875e-07,1,4,5
org.apache.camel.component.cxf.util.NullDestination,2,2,2,1.0,1,0.5,278,139.0,0,0.0,0.0,0.0,0.0008343763037129745,0.00010932576177328738,1,1,2
org.apache.camel.component.cxf.util.NullDestinationFactory,2,1,2,0.5,1,0.5,279,139.5,1,0.5,0.0,0.0,0.0006257822277847309,3.918486085064063e-07,1,1,2
org.apache.camel.component.cxf.util.UriUtils,2,1,2,0.5,1,0.5,0,0.0,1,0.5,0.0,0.0,0.002804431465257498,0.0,1,1,2
org.apache.camel.component.cxf.util.WSDLSoapServiceFactoryBean,4,3,12,0.25,1,0.25,280,70.0,9,0.75,0.0,0.0,0.002804431465257498,8.620669387140939e-06,1,3,4
org.apache.camel.component.dataset.DataSet,3,5,6,0.8333333333333334,1,0.3333333333333333,286,95.33333333333333,1,0.16666666666666666,0.0,0.0,0.005575150756627603,0.00026942121626656064,7,2,9
org.apache.camel.component.dataset.DataSetComponent,4,4,12,0.3333333333333333,1,0.25,287,71.75,8,0.6666666666666666,0.0,0.0,0.0,0.0,0,3,3
org.apache.camel.component.dataset.DataSetConsumer,5,6,20,0.3,1,0.2,289,57.8,14,0.7,0.0,0.0,0.0,0.0,0,4,4
org.apache.camel.component.dataset.DataSetEndpoint,11,21,110,0.19090909090909092,1,0.09090909090909091,286,26.0,89,0.8090909090909091,0.08888888888888889,0.00808080808080808,0.004380475594493116,0.00021622394443030448,4,10,14
org.apache.camel.component.dataset.DataSetSupport,5,11,20,0.55,1,0.2,287,57.4,9,0.45,0.0,0.0,0.0020025031289111392,7.918429183896428e-05,3,4,7
org.apache.camel.component.dataset.SimpleDataSet,3,3,6,0.5,1,0.3333333333333333,288,96.0,3,0.5,0.0,0.0,0.0018773466833541927,5.094031910583282e-06,3,2,5
org.apache.camel.component.direct.DirectComponent,2,1,2,0.5,1,0.5,278,139.0,1,0.5,0.0,0.0,0.0006257822277847309,2.664570537843563e-05,1,1,2
org.apache.camel.component.direct.DirectEndpoint,6,5,30,0.16666666666666666,1,0.16666666666666666,280,46.666666666666664,25,0.8333333333333334,0.0,0.0,0.0,0.0,0,5,5
org.apache.camel.component.direct.DirectProducer,3,4,6,0.6666666666666666,1,0.3333333333333333,278,92.66666666666667,2,0.3333333333333333,0.0,0.0,0.0006257822277847309,2.7429402595448442e-05,1,2,3
org.apache.camel.component.event.CamelEvent,3,5,6,0.8333333333333334,1,0.3333333333333333,281,93.66666666666667,1,0.16666666666666666,0.0,0.0,0.005598753761350624,5.4858805190896885e-06,2,2,4
org.apache.camel.component.event.EventComponent,2,2,2,1.0,1,0.5,281,140.5,0,0.0,0.0,0.0,0.007412434557281108,0.0,2,1,3
org.apache.camel.component.event.EventConsumer,2,2,2,1.0,1,0.5,281,140.5,0,0.0,0.0,0.0,0.005482113057989152,0.0,1,1,2
org.apache.camel.component.event.EventEndpoint,10,18,90,0.2,1,0.1,281,28.1,72,0.8,0.3194444444444444,0.03194444444444444,0.007739453728925863,0.00028136204682378444,4,9,13
org.apache.camel.component.file.FileComponent,4,6,12,0.5,1,0.25,292,73.0,6,0.5,0.3333333333333333,0.08333333333333333,0.004329736494943003,9.644047336356837e-05,1,3,4
org.apache.camel.component.file.FileConsumer,7,11,42,0.2619047619047619,1,0.14285714285714285,294,42.0,31,0.7380952380952381,0.0,0.0,0.0,0.0,0,6,6
org.apache.camel.component.file.FileEndpoint,15,26,210,0.12380952380952381,1,0.06666666666666667,292,19.466666666666665,184,0.8761904761904762,0.26373626373626374,0.017582417582417582,0.007281829559676869,0.00028655702145498015,11,14,25
org.apache.camel.component.file.FileExchange,5,11,20,0.55,1,0.2,284,56.8,9,0.45,0.25,0.05,0.007822277847309137,0.0008804402234735335,9,4,13
org.apache.camel.component.file.FileMessage,3,5,6,0.8333333333333334,1,0.3333333333333333,284,94.66666666666667,1,0.16666666666666666,0.5,0.16666666666666666,0.0049080959041939674,3.5266374765576567e-06,2,3,5
org.apache.camel.component.file.FileProcessStrategy,2,2,2,1.0,1,0.5,292,146.0,0,0.0,0.0,0.0,0.005524146562513487,2.05067438451686e-06,4,1,5
org.apache.camel.component.file.FileProducer,5,12,20,0.6,1,0.2,292,58.4,8,0.4,0.027777777777777776,0.005555555555555555,0.004329736494943003,6.866680377636072e-07,1,4,5
org.apache.camel.component.file.remote.FtpConsumer,5,5,20,0.25,1,0.2,298,59.6,15,0.75,0.25,0.05,0.002027534418022528,3.8531779836463286e-06,1,4,5
org.apache.camel.component.file.remote.FtpEndpoint,6,11,30,0.36666666666666664,1,0.16666666666666666,298,49.666666666666664,19,0.6333333333333333,0.7000000000000001,0.11666666666666668,0.0029816682617978354,1.7301982011312632e-05,4,5,9
org.apache.camel.component.file.remote.FtpOperationFailedException,2,1,2,0.5,1,0.5,0,0.0,1,0.5,0.0,0.0,0.0,0.0,0,1,1
org.apache.camel.component.file.remote.FtpProducer,6,7,30,0.23333333333333334,1,0.16666666666666666,298,49.666666666666664,23,0.7666666666666667,0.2,0.03333333333333333,0.002027534418022528,3.8889419439465165e-06,1,5,6
org.apache.camel.component.file.remote.RemoteFileBinding,2,1,2,0.5,1,0.5,285,142.5,1,0.5,0.0,0.0,0.0034658708000385096,0.0,2,1,3
org.apache.camel.component.file.remote.RemoteFileComponent,6,14,30,0.4666666666666667,1,0.16666666666666666,298,49.666666666666664,16,0.5333333333333333,0.375,0.0625,0.003379224030037547,0.00028768218674512006,4,6,10
org.apache.camel.component.file.remote.RemoteFileConfiguration,2,2,2,1.0,1,0.5,0,0.0,0,0.0,0.0,0.0,0.003476567932137394,2.1551673467852347e-06,5,2,7
org.apache.camel.component.file.remote.RemoteFileConsumer,4,4,12,0.3333333333333333,1,0.25,298,74.5,8,0.6666666666666666,0.0,0.0,0.0023040163841165093,5.943037229013829e-06,2,3,5
org.apache.camel.component.file.remote.RemoteFileConverter,2,1,2,0.5,1,0.5,0,0.0,1,0.5,0.0,0.0,0.0,0.0,0,1,1
org.apache.camel.component.file.remote.RemoteFileEndpoint,7,12,42,0.2857142857142857,1,0.14285714285714285,298,42.57142857142857,30,0.7142857142857143,0.13333333333333333,0.019047619047619046,0.003899104650043323,0.00010735874395677705,5,6,11
org.apache.camel.component.file.remote.RemoteFileExchange,4,7,12,0.5833333333333334,1,0.25,285,71.25,5,0.4166666666666667,0.3333333333333333,0.08333333333333333,0.005300743576529486,0.0006303133660592852,7,3,10
org.apache.camel.component.file.remote.RemoteFileMessage,4,7,12,0.5833333333333334,1,0.25,285,71.25,5,0.4166666666666667,0.5,0.125,0.0032183086000357585,3.3960212737221877e-06,2,4,6
org.apache.camel.component.file.remote.RemoteFileProducer,2,2,2,1.0,1,0.5,278,139.0,0,0.0,0.0,0.0,0.0023177119547582625,7.40158482734323e-07,2,1,3
org.apache.camel.component.file.remote.SftpConsumer,4,4,12,0.3333333333333333,1,0.25,298,74.5,8,0.6666666666666666,0.3333333333333333,0.08333333333333333,0.002027534418022528,3.6572536793931257e-06,1,3,4
org.apache.camel.component.file.remote.SftpEndpoint,7,15,42,0.35714285714285715,1,0.14285714285714285,298,42.57142857142857,27,0.6428571428571429,0.5333333333333333,0.07619047619047618,0.0029816682617978354,1.7824446822654506e-05,4,6,10
org.apache.camel.component.file.remote.SftpProducer,5,6,20,0.3,1,0.2,298,59.6,14,0.7,0.25,0.05,0.002027534418022528,3.693017639693313e-06,1,4,5
org.apache.camel.component.file.strategy.DefaultFileRenamer,2,1,2,0.5,1,0.5,0,0.0,1,0.5,0.0,0.0,0.0044110015568240785,0.0,2,1,3
org.apache.camel.component.file.strategy.DeleteFileProcessStrategy,4,7,12,0.5833333333333334,1,0.25,293,73.25,5,0.4166666666666667,0.0,0.0,0.0006257822277847309,5.572740293975275e-05,1,3,4
org.apache.camel.component.file.strategy.FileProcessStrategyFactory,6,5,30,0.16666666666666666,1,0.16666666666666666,296,49.333333333333336,25,0.8333333333333334,0.0,0.0,0.0,0.0,0,5,5
org.apache.camel.component.file.strategy.FileProcessStrategySupport,6,10,30,0.3333333333333333,1,0.16666666666666666,292,48.666666666666664,20,0.6666666666666666,0.2,0.03333333333333333,0.006161548088957351,0.0001432990361307928,6,5,11
org.apache.camel.component.file.strategy.FileRenamer,1,0,0,0,1,1.0,-1,-1.0,0,0,0.0,0.0,0.004827462900053638,0.0,3,0,3
org.apache.camel.component.file.strategy.NoOpFileProcessStrategy,2,1,2,0.5,1,0.5,293,146.5,1,0.5,0.0,0.0,0.0006257822277847309,1.3061620283546875e-07,1,1,2
org.apache.camel.component.file.strategy.RenameFileProcessStrategy,6,12,30,0.4,1,0.16666666666666666,293,48.833333333333336,18,0.6,0.0,0.0,0.0006257822277847309,5.6511100156765566e-05,1,5,6
org.apache.camel.component.http.CamelServlet,4,5,12,0.4166666666666667,1,0.25,299,74.75,7,0.5833333333333334,0.0,0.0,0.0014303593777936707,2.741634097516489e-05,2,3,5
org.apache.camel.component.http.helper.LoadingByteArrayOutputStream,1,0,0,0,1,1.0,-1,-1.0,0,0,0.0,0.0,0.0036409147798384346,0.0,2,0,2
org.apache.camel.component.http.HttpBinding,4,7,12,0.5833333333333334,1,0.25,298,74.5,5,0.4166666666666667,0.6666666666666666,0.16666666666666666,0.006121782663111499,6.946169666790229e-05,8,3,11
org.apache.camel.component.http.HttpClientConfigurer,1,0,0,0,1,1.0,-1,-1.0,0,0,0.0,0.0,0.004711772068026209,0.0,2,0,2
org.apache.camel.component.http.HttpComponent,6,9,30,0.3,1,0.16666666666666666,298,49.666666666666664,21,0.7,0.2,0.03333333333333333,0.004541967782308531,1.698663717875272e-05,3,5,8
org.apache.camel.component.http.HttpConsumer,3,4,6,0.6666666666666666,1,0.3333333333333333,298,99.33333333333333,2,0.3333333333333333,0.0,0.0,0.005415423125060171,4.062163908183079e-05,6,2,8
org.apache.camel.component.http.HttpConverter,3,2,6,0.3333333333333333,1,0.3333333333333333,299,99.66666666666667,4,0.6666666666666666,0.0,0.0,0.0,0.0,0,2,2
org.apache.camel.component.http.HttpEndpoint,12,27,132,0.20454545454545456,1,0.08333333333333333,298,24.833333333333332,105,0.7954545454545454,0.41818181818181815,0.034848484848484844,0.007040050062578223,0.00037327685040895747,10,11,21
org.apache.camel.component.http.HttpExchange,5,11,20,0.55,1,0.2,298,59.6,9,0.45,0.29166666666666663,0.05833333333333333,0.005632040050062579,0.00035039942248232505,6,4,10
org.apache.camel.component.http.HttpMessage,6,12,30,0.4,1,0.16666666666666666,298,49.666666666666664,18,0.6,0.35000000000000003,0.05833333333333334,0.004541967782308531,0.0001278275469049315,3,5,8
org.apache.camel.component.http.HttpMethods,2,2,2,1.0,1,0.5,278,139.0,0,0.0,0.0,0.0,0.0034826141372367634,0.0,1,1,2
org.apache.camel.component.http.HttpPollingConsumer,7,12,42,0.2857142857142857,1,0.14285714285714285,298,42.57142857142857,30,0.7142857142857143,0.18333333333333332,0.026190476190476188,0.00414120591916366,5.456491873451708e-05,1,6,7
org.apache.camel.component.http.HttpProducer,7,12,42,0.2857142857142857,1,0.14285714285714285,298,42.57142857142857,30,0.7142857142857143,0.26666666666666666,0.03809523809523809,0.004693366708385482,9.336446178679306e-05,2,6,8
org.apache.camel.component.ibatis.IBatisComponent,3,3,6,0.5,1,0.3333333333333333,286,95.33333333333333,3,0.5,0.5,0.16666666666666666,0.0014303593777936707,3.265405070886719e-07,1,2,3
org.apache.camel.component.ibatis.IBatisEndpoint,8,11,56,0.19642857142857142,1,0.125,286,35.75,45,0.8035714285714286,0.42857142857142855,0.05357142857142857,0.0025031289111389237,2.727919396218765e-05,4,7,11
org.apache.camel.component.ibatis.IBatisPollingConsumer,5,6,20,0.3,1,0.2,286,57.2,14,0.7,0.25,0.05,0.0014303593777936707,1.4596360666863636e-05,1,4,5
org.apache.camel.component.ibatis.IBatisProducer,3,4,6,0.6666666666666666,1,0.3333333333333333,286,95.33333333333333,2,0.3333333333333333,0.5,0.16666666666666666,0.0014303593777936707,3.918486085064063e-07,1,2,3
org.apache.camel.component.irc.IrcBinding,3,8,6,1.3333333333333333,1,0.3333333333333333,285,95.0,-2,-0.3333333333333333,0.0,0.0,0.0027875753783138013,0.0,3,2,5
org.apache.camel.component.irc.IrcComponent,5,9,20,0.45,1,0.2,292,58.4,11,0.55,0.125,0.025,0.0014303593777936707,8.885167197882765e-05,2,5,7
org.apache.camel.component.irc.IrcConfiguration,2,2,2,1.0,1,0.5,0,0.0,0,0.0,0.0,0.0,0.0037546933667083854,1.3061620283546876e-06,7,2,9
org.apache.camel.component.irc.IrcConsumer,4,9,12,0.75,1,0.25,292,73.0,3,0.25,0.16666666666666666,0.041666666666666664,0.001668752607425949,1.175545825519219e-06,2,3,5
org.apache.camel.component.irc.IrcEndpoint,10,26,90,0.28888888888888886,1,0.1,292,29.2,64,0.7111111111111111,0.29166666666666663,0.029166666666666664,0.0025031289111389237,9.056927504611406e-05,4,9,13
org.apache.camel.component.irc.IrcErrorLogger,1,0,0,0,1,1.0,-1,-1.0,0,0,0.0,0.0,0.0013037129745515229,0.0,1,0,1
org.apache.camel.component.irc.IrcExchange,5,12,20,0.6,1,0.2,285,57.0,8,0.4,0.3333333333333333,0.06666666666666667,0.003066332916145181,0.0004611143808700555,5,5,10
org.apache.camel.component.irc.IrcMessage,4,10,12,0.8333333333333334,1,0.25,285,71.25,2,0.16666666666666666,0.3333333333333333,0.08333333333333333,0.0027875753783138013,3.7552158315197267e-06,4,4,8
org.apache.camel.component.irc.IrcProducer,6,10,30,0.3333333333333333,1,0.16666666666666666,292,48.666666666666664,20,0.6666666666666666,0.125,0.020833333333333332,0.0014303593777936707,3.2392818303196258e-06,1,5,6
org.apache.camel.component.jcr.JcrComponent,3,3,6,0.5,1,0.3333333333333333,283,94.33333333333333,3,0.5,0.5,0.16666666666666666,0.0008343763037129745,2.2857835496207033e-07,1,2,3
org.apache.camel.component.jcr.JcrConverter,2,1,2,0.5,1,0.5,0,0.0,1,0.5,0.0,0.0,0.0,0.0,0,1,1
org.apache.camel.component.jcr.JcrEndpoint,9,10,72,0.1388888888888889,1,0.1111111111111111,283,31.444444444444443,62,0.8611111111111112,0.25,0.027777777777777776,0.0012515644555694619,1.544536598529418e-05,2,8,10
org.apache.camel.component.jcr.JcrProducer,4,5,12,0.4166666666666667,1,0.25,283,70.75,7,0.5833333333333334,0.3333333333333333,0.08333333333333333,0.0008343763037129745,1.1102377241014845e-06,1,3,4
org.apache.camel.component.jdbc.JdbcComponent,4,6,12,0.5,1,0.25,280,70.0,6,0.5,0.3333333333333333,0.08333333333333333,0.0008343763037129745,0.00010468888657262824,1,3,4
org.apache.camel.component.jdbc.JdbcEndpoint,7,8,42,0.19047619047619047,1,0.14285714285714285,280,40.0,34,0.8095238095238095,0.3333333333333333,0.047619047619047616,0.0012515644555694619,4.245026592152734e-06,2,6,8
org.apache.camel.component.jdbc.JdbcProducer,5,6,20,0.3,1,0.2,280,56.0,14,0.7,0.25,0.05,0.0008343763037129745,2.1551673467852347e-06,1,4,5
org.apache.camel.component.jetty.CamelContinuationServlet,4,6,12,0.5,1,0.25,300,75.0,6,0.5,0.0,0.0,0.0,0.0,0,3,3
org.apache.camel.component.jetty.JettyHttpComponent,9,18,72,0.25,1,0.1111111111111111,304,33.77777777777778,54,0.75,0.08035714285714285,0.008928571428571428,0.0008343763037129745,1.726932796060377e-05,1,8,9
org.apache.camel.component.jetty.JettyHttpEndpoint,10,18,90,0.2,1,0.1,304,30.4,72,0.8,0.0625,0.00625,0.0012515644555694619,1.0312149213860259e-05,2,9,11
org.apache.camel.component.jetty.JettyHttpProducer,7,11,42,0.2619047619047619,1,0.14285714285714285,300,42.857142857142854,31,0.7380952380952381,0.0,0.0,0.0,0.0,0,6,6
org.apache.camel.component.jhc.AsyncBufferingHttpServiceHandler,3,2,6,0.3333333333333333,1,0.3333333333333333,3,1.0,4,0.6666666666666666,0.0,0.0,0.0,0.0,0,2,2
org.apache.camel.component.jhc.AsyncHttpRequestHandler,2,1,2,0.5,1,0.5,0,0.0,1,0.5,0.0,0.0,0.002252816020025031,1.175545825519219e-06,3,1,4
org.apache.camel.component.jhc.AsyncResponseHandler,1,0,0,0,1,1.0,-1,-1.0,0,0,0.0,0.0,0.002190237797246558,0.0,2,0,2
org.apache.camel.component.jhc.BufferingHttpServiceHandler,2,1,2,0.5,1,0.5,0,0.0,1,0.5,0.0,0.0,0.0006257822277847309,3.918486085064063e-07,1,1,2
org.apache.camel.component.jhc.DefaultListeningIOReactor,1,0,0,0,1,1.0,-1,-1.0,0,0,0.0,0.0,0.0011174682639013053,0.0,1,0,1
org.apache.camel.component.jhc.JhcComponent,2,1,2,0.5,1,0.5,278,139.0,1,0.5,0.0,0.0,0.0020025031289111392,0.00014315535830767382,1,1,2
org.apache.camel.component.jhc.JhcConsumer,4,4,12,0.3333333333333333,1,0.25,286,71.5,8,0.6666666666666666,0.3333333333333333,0.08333333333333333,0.0012515644555694619,0.00022374555545715805,2,3,5
org.apache.camel.component.jhc.JhcConverter,2,1,2,0.5,1,0.5,0,0.0,1,0.5,0.0,0.0,0.0,0.0,0,1,1
org.apache.camel.component.jhc.JhcEndpoint,5,4,20,0.2,1,0.2,279,55.8,16,0.8,0.0,0.0,0.0025552774301209847,0.0003375122681268514,2,4,6
org.apache.camel.component.jhc.JhcExchange,4,7,12,0.5833333333333334,1,0.25,283,70.75,5,0.4166666666666667,0.0,0.0,0.0,0.0,0,3,3
org.apache.camel.component.jhc.JhcMessage,2,2,2,1.0,1,0.5,281,140.5,0,0.0,0.0,0.0,0.0,0.0,0,1,1
org.apache.camel.component.jhc.JhcProducer,7,11,42,0.2619047619047619,1,0.14285714285714285,283,40.42857142857143,31,0.7380952380952381,0.5,0.07142857142857142,0.0018773466833541927,0.00033267946862193895,3,6,9
org.apache.camel.component.jhc.JhcServerEngine,3,2,6,0.3333333333333333,1,0.3333333333333333,2,0.6666666666666666,4,0.6666666666666666,0.0,0.0,0.001112501738283966,2.351091651038438e-06,1,2,3
org.apache.camel.component.jhc.JhcServerEngineFactory,2,1,2,0.5,1,0.5,3,1.5,1,0.5,0.0,0.0,0.0011264080100125155,2.351091651038438e-06,1,1,2
org.apache.camel.component.jms.ConsumerType,1,0,0,0,1,1.0,-1,-1.0,0,0,0.0,0.0,0.00994486351182221,0.0,2,0,2
org.apache.camel.component.jms.DefaultQueueBrowseStrategy,3,4,6,0.6666666666666666,1,0.3333333333333333,337,112.33333333333333,2,0.3333333333333333,0.0,0.0,0.0,0.0,0,2,2
org.apache.camel.component.jms.DestinationEndpoint,1,0,0,0,1,1.0,-1,-1.0,0,0,0.0,0.0,0.008362726134941403,0.0,3,0,3
org.apache.camel.component.jms.EndpointMessageListener,8,22,56,0.39285714285714285,1,0.125,336,42.0,34,0.6071428571428571,0.0,0.0,0.00809184557620102,0.00016641297268184504,2,7,9
org.apache.camel.component.jms.JmsBinding,9,19,72,0.2638888888888889,1,0.1111111111111111,336,37.333333333333336,53,0.7361111111111112,0.19642857142857142,0.021825396825396824,0.007513856606472376,0.0005023461842137034,4,8,12
org.apache.camel.component.jms.JmsComponent,10,23,90,0.25555555555555554,1,0.1,336,33.6,67,0.7444444444444445,0.38888888888888884,0.03888888888888888,0.012828535669586983,0.001129576385904153,16,10,26
org.apache.camel.component.jms.JmsConfiguration,10,16,90,0.17777777777777778,1,0.1,336,33.6,74,0.8222222222222222,0.38888888888888884,0.03888888888888888,0.011190850264958859,0.0002714232684107363,7,10,17
org.apache.camel.component.jms.JmsConsumer,3,4,6,0.6666666666666666,1,0.3333333333333333,336,112.0,2,0.3333333333333333,0.5,0.16666666666666666,0.007305138367403699,3.786936909351198e-06,2,2,4
org.apache.camel.component.jms.JmsEndpoint,15,39,210,0.18571428571428572,1,0.06666666666666667,336,22.4,171,0.8142857142857143,0.41849816849816857,0.027899877899877905,0.0100184754752965,0.0007232643653659122,10,14,24
org.apache.camel.component.jms.JmsExchange,8,26,56,0.4642857142857143,1,0.125,336,42.0,30,0.5357142857142857,0.0,0.0,0.007622753079029946,0.0003755337117993789,4,7,11
org.apache.camel.component.jms.JmsIOConverter,4,5,12,0.4166666666666667,1,0.25,279,69.75,7,0.5833333333333334,0.0,0.0,0.0,0.0,0,3,3
org.apache.camel.component.jms.JmsMessage,7,11,42,0.2619047619047619,1,0.14285714285714285,336,48.0,31,0.7380952380952381,0.13333333333333333,0.019047619047619046,0.007254758102800915,5.828328213737965e-05,5,7,12
org.apache.camel.component.jms.JmsPollingConsumer,4,5,12,0.4166666666666667,1,0.25,336,84.0,7,0.5833333333333334,0.16666666666666666,0.041666666666666664,0.007254758102800915,5.090113424498218e-05,1,3,4
org.apache.camel.component.jms.JmsProducer,19,42,342,0.12280701754385964,1,0.05263157894736842,336,17.68421052631579,300,0.8771929824561403,0.042483660130718956,0.002235982112143103,0.008839831301732206,0.000441142230483635,2,18,20
org.apache.camel.component.jms.JmsProviderMetadata,1,0,0,0,1,1.0,-1,-1.0,0,0,0.0,0.0,0.009122973965390623,0.0,2,0,2
org.apache.camel.component.jms.JmsQueueEndpoint,5,9,20,0.45,1,0.2,336,67.2,11,0.55,0.5,0.1,0.009147303694835936,0.0003461124121106894,5,4,9
org.apache.camel.component.jms.JmsTemporaryQueueEndpoint,5,11,20,0.55,1,0.2,336,67.2,9,0.45,0.25,0.05,0.00862245840086994,2.821309981246125e-06,1,4,5
org.apache.camel.component.jms.JmsTemporaryTopicEndpoint,4,6,12,0.5,1,0.25,336,84.0,6,0.5,0.5,0.125,0.00862245840086994,3.291714906029292e-05,1,3,4
org.apache.camel.component.jms.MessageJMSPropertyAccessException,2,1,2,0.5,1,0.5,0,0.0,1,0.5,0.0,0.0,0.0059031008011351084,3.1021348173423833e-07,1,1,2
org.apache.camel.component.jms.MessageListenerProcessor,4,5,12,0.4166666666666667,1,0.25,337,84.25,7,0.5833333333333334,0.0,0.0,0.0,0.0,0,3,3
org.apache.camel.component.jms.MessagePropertyAccessException,2,1,2,0.5,1,0.5,0,0.0,1,0.5,0.0,0.0,0.0059031008011351084,3.1021348173423833e-07,1,1,2
org.apache.camel.component.jms.MessagePropertyNamesAccessException,2,1,2,0.5,1,0.5,0,0.0,1,0.5,0.0,0.0,0.0059031008011351084,3.1021348173423833e-07,1,1,2
org.apache.camel.component.jms.QueueBrowseStrategy,2,2,2,1.0,1,0.5,336,168.0,0,0.0,0.0,0.0,0.009068447628501144,0.0,4,1,5
org.apache.camel.component.jms.requestor.DeferredRequestReplyMap,8,21,56,0.375,1,0.125,336,42.0,35,0.625,0.09523809523809523,0.011904761904761904,0.00796924185534949,3.2362963171119575e-05,3,7,10
org.apache.camel.component.jms.requestor.FailedToProcessResponse,3,3,6,0.5,1,0.3333333333333333,278,92.66666666666667,3,0.5,0.0,0.0,0.008116763601560774,9.143134198482814e-07,2,2,4
org.apache.camel.component.jms.requestor.FutureHandler,3,4,6,0.6666666666666666,1,0.3333333333333333,279,93.0,2,0.3333333333333333,0.0,0.0,0.00817688777638715,5.877729127596095e-07,3,2,5
org.apache.camel.component.jms.requestor.MessageSelectorProvider,1,0,0,0,1,1.0,-1,-1.0,0,0,0.0,0.0,0.0050270306763121955,0.0,2,0,2
org.apache.camel.component.jms.requestor.PersistentReplyToFutureHandler,6,13,30,0.43333333333333335,1,0.16666666666666666,336,56.0,17,0.5666666666666667,0.0,0.0,0.005394563717467347,0.0,1,5,6
org.apache.camel.component.jms.requestor.PersistentReplyToRequestor,11,26,110,0.23636363636363636,1,0.09090909090909091,336,30.545454545454547,84,0.7636363636363637,0.05555555555555556,0.005050505050505051,0.006786709192942791,0.0001242458640286075,2,10,12
org.apache.camel.component.jms.requestor.ReplyHandler,2,2,2,1.0,1,0.5,278,139.0,0,0.0,0.0,0.0,0.008507877493926232,0.0,3,1,4
org.apache.camel.component.jms.requestor.Requestor,13,33,156,0.21153846153846154,1,0.07692307692307693,336,25.846153846153847,123,0.7884615384615384,0.10606060606060606,0.008158508158508158,0.010844741493877656,0.00035188704773533326,5,13,18
org.apache.camel.component.jms.RuntimeJmsException,1,0,0,0,1,1.0,-1,-1.0,0,0,0.0,0.0,0.0068497784392652986,0.0,4,0,4
org.apache.camel.component.jmx.JMXComponent,4,6,12,0.5,1,0.25,288,72.0,6,0.5,0.3333333333333333,0.08333333333333333,0.0008343763037129745,8.385560222037095e-05,1,3,4
org.apache.camel.component.jmx.JMXConsumer,3,3,6,0.5,1,0.3333333333333333,288,96.0,3,0.5,0.5,0.16666666666666666,0.0008343763037129745,1.0188063821166564e-05,1,2,3
org.apache.camel.component.jmx.JMXEndpoint,8,11,56,0.19642857142857142,1,0.125,288,36.0,45,0.8035714285714286,0.2857142857142857,0.03571428571428571,0.0012515644555694619,8.10930695304008e-05,2,7,9
org.apache.camel.component.jmx.JMXExchange,4,7,12,0.5833333333333334,1,0.25,284,71.0,5,0.4166666666666667,0.3333333333333333,0.08333333333333333,0.001668752607425949,0.0002018412182416499,2,3,5
org.apache.camel.component.jmx.JMXMessage,3,5,6,0.8333333333333334,1,0.3333333333333333,284,94.66666666666667,1,0.16666666666666666,0.5,0.16666666666666666,0.001112501738283966,7.836972170128126e-07,2,3,5
org.apache.camel.component.jpa.Consumed,1,0,0,0,1,1.0,-1,-1.0,0,0,0.0,0.0,0.0014080100125156445,0.0,2,0,2
org.apache.camel.component.jpa.DefaultTransactionStrategy,3,2,6,0.3333333333333333,1,0.3333333333333333,3,1.0,4,0.6666666666666666,0.0,0.0,0.0,0.0,0,2,2
org.apache.camel.component.jpa.DeleteHandler,1,0,0,0,1,1.0,-1,-1.0,0,0,0.0,0.0,0.0006257822277847309,0.0,1,0,1
org.apache.camel.component.jpa.JpaComponent,4,8,12,0.6666666666666666,1,0.25,278,69.5,4,0.3333333333333333,0.0,0.0,0.0011264080100125155,5.329141075687127e-05,1,3,4
org.apache.camel.component.jpa.JpaConsumer,8,9,56,0.16071428571428573,1,0.125,286,35.75,47,0.8392857142857143,0.0,0.0,0.0,0.0,0,7,7
org.apache.camel.component.jpa.JpaEndpoint,9,9,72,0.125,1,0.1111111111111111,281,31.22222222222222,63,0.875,0.0,0.0,0.0012515644555694619,6.8573506488621105e-06,2,8,10
org.apache.camel.component.jpa.JpaProducer,5,7,20,0.35,1,0.2,282,56.4,13,0.65,0.0,0.0,0.0,0.0,0,4,4
org.apache.camel.component.jpa.JpaTemplateTransactionStrategy,3,3,6,0.5,1,0.3333333333333333,3,1.0,3,0.5,0.0,0.0,0.0,0.0,1,3,4
org.apache.camel.component.jpa.QueryBuilder,3,3,6,0.5,1,0.3333333333333333,1,0.3333333333333333,3,0.5,0.0,0.0,0.0,0.0,1,3,4
org.apache.camel.component.jpa.QueryFactory,1,0,0,0,1,1.0,-1,-1.0,0,0,0.0,0.0,0.0012515644555694619,0.0,2,0,2
org.apache.camel.component.jpa.TransactionStrategy,1,0,0,0,1,1.0,-1,-1.0,0,0,0.0,0.0,0.004450006953135864,0.0,7,0,7
org.apache.camel.component.list.ListComponent,2,1,2,0.5,1,0.5,278,139.0,1,0.5,0.0,0.0,0.0,0.0,0,1,1
org.apache.camel.component.list.ListEndpoint,10,16,90,0.17777777777777778,1,0.1,280,28.0,74,0.8222222222222222,0.0,0.0,0.0009386733416770963,0.00010958699417895828,1,9,10
org.apache.camel.component.log.LogComponent,7,9,42,0.21428571428571427,1,0.14285714285714285,280,40.0,33,0.7857142857142857,0.0,0.0,0.0,0.0,0,6,6
org.apache.camel.component.log.LogFormatter,4,8,12,0.6666666666666666,1,0.25,278,69.5,4,0.3333333333333333,0.0,0.0,0.0006257822277847309,8.816593691394142e-07,1,3,4
org.apache.camel.component.mail.MailBinding,9,21,72,0.2916666666666667,1,0.1111111111111111,294,32.666666666666664,51,0.7083333333333334,0.13392857142857142,0.01488095238095238,0.0029816682617978354,5.0856172129006126e-05,2,8,10
org.apache.camel.component.mail.MailComponent,4,6,12,0.5,1,0.25,282,70.5,6,0.5,0.0,0.0,0.0025031289111389237,2.622120271922036e-05,2,4,6
org.apache.camel.component.mail.MailConfiguration,4,3,12,0.25,1,0.25,281,70.25,9,0.75,0.0,0.0,0.0029122942139212476,1.717603067286414e-05,2,3,5
org.apache.camel.component.mail.MailConsumer,5,9,20,0.45,1,0.2,294,58.8,11,0.55,0.0,0.0,0.002413731450026819,8.236858698809021e-06,2,4,6
org.apache.camel.component.mail.MailConverters,3,3,6,0.5,1,0.3333333333333333,278,92.66666666666667,3,0.5,0.0,0.0,0.0,0.0,0,2,2
org.apache.camel.component.mail.MailEndpoint,13,25,156,0.16025641025641027,1,0.07692307692307693,294,22.615384615384617,131,0.8397435897435898,0.20454545454545456,0.015734265734265736,0.003379224030037547,5.403089941292436e-05,5,12,17
org.apache.camel.component.mail.MailExchange,6,16,30,0.5333333333333333,1,0.16666666666666666,294,49.0,14,0.4666666666666667,0.25,0.041666666666666664,0.004224030037546934,0.00027153760777321324,6,5,11
org.apache.camel.component.mail.MailMessage,6,9,30,0.3,1,0.16666666666666666,294,49.0,21,0.7,0.2,0.03333333333333333,0.002816020025031289,7.200218181305215e-06,4,6,10
org.apache.camel.component.mail.MailProducer,4,4,12,0.3333333333333333,1,0.25,296,74.0,8,0.6666666666666666,0.0,0.0,0.0,0.0,0,3,3
org.apache.camel.component.mail.MailUtils,2,2,2,1.0,1,0.5,278,139.0,0,0.0,0.0,0.0,0.0023713852842368746,0.00010873798886052778,1,1,2
org.apache.camel.component.mail.security.DummySSLSocketFactory,3,2,6,0.3333333333333333,1,0.3333333333333333,1,0.3333333333333333,4,0.6666666666666666,0.0,0.0,0.0023713852842368746,5.4858805190896885e-06,1,2,3
org.apache.camel.component.mail.security.DummyTrustManager,1,0,0,0,1,1.0,-1,-1.0,0,0,0.0,0.0,0.002073670519521951,0.0,1,0,1
org.apache.camel.component.mina.MinaComponent,5,8,20,0.4,1,0.2,294,58.8,12,0.6,0.25,0.05,0.0020480145636591193,0.0001105666157002243,1,4,5
org.apache.camel.component.mina.MinaConsumer,4,6,12,0.5,1,0.25,294,73.5,6,0.5,0.5,0.125,0.002252816020025031,3.3894904635804144e-05,2,3,5
org.apache.camel.component.mina.MinaConverter,3,3,6,0.5,1,0.3333333333333333,3,1.0,3,0.5,0.0,0.0,0.0,0.0,0,2,2
org.apache.camel.component.mina.MinaEndpoint,10,16,90,0.17777777777777778,1,0.1,294,29.4,74,0.8222222222222222,0.4305555555555555,0.043055555555555555,0.0037546933667083854,0.00017453263563382428,6,9,15
org.apache.camel.component.mina.MinaExchange,3,4,6,0.6666666666666666,1,0.3333333333333333,283,94.33333333333333,2,0.3333333333333333,0.0,0.0,0.0025552774301209847,0.00024869978100887434,2,2,4
org.apache.camel.component.mina.MinaHelper,2,2,2,1.0,1,0.5,278,139.0,0,0.0,0.0,0.0,0.002190237797246558,7.543085713748322e-07,2,1,3
org.apache.camel.component.mina.MinaPayloadHelper,4,7,12,0.5833333333333334,1,0.25,294,73.5,5,0.4166666666666667,0.3333333333333333,0.08333333333333333,0.0025031289111389233,3.6964385402437663e-06,3,3,6
org.apache.camel.component.mina.MinaPayloadHolder,2,3,2,1.5,1,0.5,278,139.0,-1,-0.5,0.0,0.0,0.0019164580725907383,0.0,2,2,4
org.apache.camel.component.mina.MinaProducer,7,15,42,0.35714285714285715,1,0.14285714285714285,294,42.0,27,0.6428571428571429,0.3333333333333333,0.047619047619047616,0.002252816020025031,4.402092576062386e-05,2,6,8
org.apache.camel.component.mock.AssertionClause,6,14,30,0.4666666666666667,1,0.16666666666666666,282,47.0,16,0.5333333333333333,0.30000000000000004,0.05000000000000001,0.08276469256783746,0.0009679877518828129,16,6,22
org.apache.camel.component.mock.MockComponent,3,2,6,0.3333333333333333,1,0.3333333333333333,279,93.0,4,0.6666666666666666,0.0,0.0,0.0,0.0,0,2,2
org.apache.camel.component.mock.MockEndpoint,11,19,110,0.17272727272727273,1,0.09090909090909091,282,25.636363636363637,91,0.8272727272727273,0.1,0.009090909090909092,0.11305912590556542,0.001160015777471034,6,11,17
org.apache.camel.component.quartz.CamelJob,2,2,2,1.0,1,0.5,288,144.0,0,0.0,0.0,0.0,0.0014303593777936707,0.0,1,1,2
org.apache.camel.component.quartz.QuartzComponent,4,4,12,0.3333333333333333,1,0.25,288,72.0,8,0.6666666666666666,0.3333333333333333,0.08333333333333333,0.0014303593777936707,0.00015458427605577731,1,3,4
org.apache.camel.component.quartz.QuartzConsumer,2,2,2,1.0,1,0.5,288,144.0,0,0.0,0.0,0.0,0.0014303593777936707,0.0,1,1,2
org.apache.camel.component.quartz.QuartzEndpoint,10,16,90,0.17777777777777778,1,0.1,288,28.8,74,0.8222222222222222,0.3333333333333333,0.03333333333333333,0.0025031289111389237,0.00023987665650733843,4,9,13
org.apache.camel.component.quartz.QuartzExchange,4,6,12,0.5,1,0.25,284,71.0,6,0.5,0.3333333333333333,0.08333333333333333,0.002252816020025031,0.00027668430246637353,2,3,5
org.apache.camel.component.quartz.QuartzMessage,3,4,6,0.6666666666666666,1,0.3333333333333333,284,94.66666666666667,2,0.3333333333333333,0.5,0.16666666666666666,0.0015018773466833543,1.175545825519219e-06,1,2,3
org.apache.camel.component.ref.RefComponent,3,2,6,0.3333333333333333,1,0.3333333333333333,278,92.66666666666667,4,0.6666666666666666,0.0,0.0,0.0,0.0,0,2,2
org.apache.camel.component.ResourceBasedComponent,1,0,0,0,1,1.0,-1,-1.0,0,0,0.0,0.0,0.003407036573494646,0.0,5,0,5
org.apache.camel.component.ResourceBasedEndpoint,5,6,20,0.3,1,0.2,286,57.2,14,0.7,0.0,0.0,0.001668752607425949,3.1308703819661866e-05,2,4,6
org.apache.camel.component.rmi.RmiComponent,4,6,12,0.5,1,0.25,292,73.0,6,0.5,0.3333333333333333,0.08333333333333333,0.0011264080100125155,2.9728247765352706e-05,1,3,4
org.apache.camel.component.rmi.RmiConsumer,7,12,42,0.2857142857142857,1,0.14285714285714285,292,41.714285714285715,30,0.7142857142857143,0.1,0.014285714285714287,0.0011264080100125155,1.4465744464028165e-05,1,6,7
org.apache.camel.component.rmi.RmiEndpoint,12,19,132,0.14393939393939395,1,0.08333333333333333,292,24.333333333333332,113,0.8560606060606061,0.2590909090909091,0.02159090909090909,0.0018773466833541927,4.6881887089159325e-05,3,11,14
org.apache.camel.component.rmi.RmiProducer,5,6,20,0.3,1,0.2,292,58.4,14,0.7,0.25,0.05,0.0011264080100125155,2.656453673810216e-05,1,4,5
org.apache.camel.component.rmi.RmiRegistryBean,4,5,12,0.4166666666666667,1,0.25,278,69.5,7,0.5833333333333334,0.0,0.0,0.001112501738283966,5.355637505405179e-05,1,3,4
org.apache.camel.component.seda.CollectionProducer,4,6,12,0.5,1,0.25,278,69.5,6,0.5,0.0,0.0,0.0018773466833541927,2.1551673467852347e-06,1,3,4
org.apache.camel.component.seda.ListPollingConsumer,4,6,12,0.5,1,0.25,279,69.75,6,0.5,0.0,0.0,0.0,0.0,0,3,3
org.apache.camel.component.seda.QueueComponent,2,1,2,0.5,1,0.5,283,141.5,1,0.5,0.0,0.0,0.0,0.0,0,1,1
org.apache.camel.component.seda.SedaComponent,3,3,6,0.5,1,0.3333333333333333,282,94.0,3,0.5,0.5,0.16666666666666666,0.0022349365278026105,0.00011128500481581939,3,2,5
org.apache.camel.component.seda.SedaConsumer,6,8,30,0.26666666666666666,1,0.16666666666666666,282,47.0,22,0.7333333333333333,0.15000000000000002,0.025000000000000005,0.0015644555694618273,9.796215212660158e-06,1,5,6
org.apache.camel.component.seda.SedaEndpoint,9,11,72,0.1527777777777778,1,0.1111111111111111,282,31.333333333333332,61,0.8472222222222222,0.23214285714285712,0.025793650793650792,0.0026074259491030457,7.219810611730536e-05,4,8,12
org.apache.camel.component.spring.integration.adapter.AbstractCamelAdapter,2,1,2,0.5,1,0.5,278,139.0,1,0.5,0.0,0.0,0.0025552774301209847,0.00017502571179952819,3,1,4
org.apache.camel.component.spring.integration.adapter.CamelSourceAdapter,9,17,72,0.2361111111111111,1,0.1111111111111111,281,31.22222222222222,55,0.7638888888888888,0.09821428571428571,0.010912698412698412,0.0020025031289111392,0.00012251799825966974,3,8,11
org.apache.camel.component.spring.integration.adapter.CamelTargetAdapter,7,9,42,0.21428571428571427,1,0.14285714285714285,287,41.0,33,0.7857142857142857,0.0,0.0,0.0008343763037129745,0.00021897806405366335,1,6,7
org.apache.camel.component.spring.integration.adapter.config.AbstractCamelContextBeanDefinitionParaser,2,1,2,0.5,1,0.5,2,1.0,1,0.5,0.0,0.0,0.0014080100125156445,0.0,2,1,3
org.apache.camel.component.spring.integration.adapter.config.CamelSourceAdpaterParser,4,4,12,0.3333333333333333,1,0.25,283,70.75,8,0.6666666666666666,0.0,0.0,0.0006257822277847309,5.943037229013829e-06,1,3,4
org.apache.camel.component.spring.integration.adapter.config.CamelTargetAdapterParser,4,4,12,0.3333333333333333,1,0.25,289,72.25,8,0.6666666666666666,0.0,0.0,0.0006257822277847309,0.00010847675645485683,1,3,4
org.apache.camel.component.spring.integration.adapter.config.NamespaceHandler,3,2,6,0.3333333333333333,1,0.3333333333333333,293,97.66666666666667,4,0.6666666666666666,0.0,0.0,0.0,0.0,0,2,2
org.apache.camel.component.spring.integration.converter.SpringIntegrationConverter,5,5,20,0.25,1,0.2,292,58.4,15,0.75,0.0,0.0,0.0,0.0,0,4,4
org.apache.camel.component.spring.integration.SpringIntegrationBinding,2,2,2,1.0,1,0.5,278,139.0,0,0.0,0.0,0.0,0.004067584480600751,1.1102377241014845e-06,4,1,5
org.apache.camel.component.spring.integration.SpringIntegrationComponent,2,2,2,1.0,1,0.5,291,145.5,0,0.0,0.0,0.0,0.001738283966068697,0.0,1,1,2
org.apache.camel.component.spring.integration.SpringIntegrationConsumer,7,11,42,0.2619047619047619,1,0.14285714285714285,291,41.57142857142857,31,0.7380952380952381,0.11666666666666667,0.016666666666666666,0.001738283966068697,6.008345330431563e-06,1,6,7
org.apache.camel.component.spring.integration.SpringIntegrationEndpoint,11,18,110,0.16363636363636364,1,0.09090909090909091,291,26.454545454545453,92,0.8363636363636363,0.2833333333333333,0.025757575757575757,0.0031289111389236545,0.00031526957274780753,5,10,15
org.apache.camel.component.spring.integration.SpringIntegrationExchange,6,16,30,0.5333333333333333,1,0.16666666666666666,284,47.333333333333336,14,0.4666666666666667,0.2,0.03333333333333333,0.003681071928145476,0.00018529867615253782,4,5,9
org.apache.camel.component.spring.integration.SpringIntegrationMessage,3,5,6,0.8333333333333334,1,0.3333333333333333,284,94.66666666666667,1,0.16666666666666666,0.5,0.16666666666666666,0.002720792294716221,4.440950896405938e-06,4,3,7
org.apache.camel.component.spring.integration.SpringIntegrationProducer,4,6,12,0.5,1,0.25,291,72.75,6,0.5,0.3333333333333333,0.08333333333333333,0.001738283966068697,1.6914798267193204e-06,1,3,4
org.apache.camel.component.sql.SqlComponent,5,8,20,0.4,1,0.2,283,56.6,12,0.6,0.0,0.0,0.0,0.0,0,4,4
org.apache.camel.component.sql.SqlEndpoint,6,5,30,0.16666666666666666,1,0.16666666666666666,278,46.333333333333336,25,0.8333333333333334,0.0,0.0,0.0012515644555694619,3.591945577975391e-06,2,5,7
org.apache.camel.component.sql.SqlProducer,3,3,6,0.5,1,0.3333333333333333,279,93.0,3,0.5,0.0,0.0,0.0,0.0,0,2,2
org.apache.camel.component.stream.StreamComponent,4,4,12,0.3333333333333333,1,0.25,290,72.5,8,0.6666666666666666,0.0,0.0,0.0,0.0,0,3,3
org.apache.camel.component.stream.StreamConsumer,4,5,12,0.4166666666666667,1,0.25,285,71.25,7,0.5833333333333334,0.3333333333333333,0.08333333333333333,0.0011264080100125155,1.626171725301586e-05,1,3,4
org.apache.camel.component.stream.StreamEndpoint,7,8,42,0.19047619047619047,1,0.14285714285714285,285,40.714285714285715,34,0.8095238095238095,0.3333333333333333,0.047619047619047616,0.0018773466833541927,6.759388496735508e-05,3,6,9
org.apache.camel.component.stream.StreamMessage,2,2,2,1.0,1,0.5,281,140.5,0,0.0,0.0,0.0,0.0,0.0,0,1,1
org.apache.camel.component.stream.StreamProducer,5,7,20,0.35,1,0.2,285,57.0,13,0.65,0.25,0.05,0.0011264080100125155,4.898107606330079e-06,1,4,5
org.apache.camel.component.test.TestComponent,4,4,12,0.3333333333333333,1,0.25,279,69.75,8,0.6666666666666666,0.0,0.0,0.0,0.0,0,3,3
org.apache.camel.component.test.TestEndpoint,6,12,30,0.4,1,0.16666666666666666,284,47.333333333333336,18,0.6,0.0,0.0,0.0,0.0,0,5,5
org.apache.camel.component.timer.TimerComponent,3,3,6,0.5,1,0.3333333333333333,282,94.0,3,0.5,0.5,0.16666666666666666,0.0008343763037129745,1.3061620283546875e-07,1,2,3
org.apache.camel.component.timer.TimerConsumer,3,2,6,0.3333333333333333,1,0.3333333333333333,284,94.66666666666667,4,0.6666666666666666,0.0,0.0,0.0,0.0,0,2,2
org.apache.camel.component.timer.TimerEndpoint,7,7,42,0.16666666666666666,1,0.14285714285714285,282,40.285714285714285,35,0.8333333333333334,0.16666666666666666,0.023809523809523808,0.0012515644555694619,6.0579794875090415e-05,2,6,8
org.apache.camel.component.uface.swing.Main,5,8,20,0.4,1,0.2,309,61.8,12,0.6,0.0,0.0,0.0,0.0,0,4,4
org.apache.camel.component.uface.swing.SwingBrowser,3,3,6,0.5,1,0.3333333333333333,280,93.33333333333333,3,0.5,0.0,0.0,0.0006257822277847309,9.143134198482813e-07,1,2,3
org.apache.camel.component.uface.swing.SwingComponent,3,3,6,0.5,1,0.3333333333333333,287,95.66666666666667,3,0.5,0.0,0.0,0.0,0.0,0,2,2
org.apache.camel.component.uface.UFaceBrowser,4,3,12,0.25,1,0.25,279,69.75,9,0.75,0.0,0.0,0.0008343763037129745,1.6980106368610938e-06,1,3,4
org.apache.camel.component.uface.UFaceComponent,4,5,12,0.4166666666666667,1,0.25,286,71.5,7,0.5833333333333334,0.3333333333333333,0.08333333333333333,0.0012515644555694619,1.4237166109066094e-05,2,3,5
org.apache.camel.component.uface.UFaceEndpoint,3,3,6,0.5,1,0.3333333333333333,286,95.33333333333333,3,0.5,0.5,0.16666666666666666,0.0008343763037129745,4.702183302076876e-06,1,2,3
org.apache.camel.component.validator.jing.JingComponent,4,3,12,0.25,1,0.25,284,71.0,9,0.75,0.0,0.0,0.0006257822277847309,5.498942139373236e-05,1,3,4
org.apache.camel.component.validator.jing.JingValidator,3,4,6,0.6666666666666666,1,0.3333333333333333,282,94.0,2,0.3333333333333333,0.0,0.0,0.0012515644555694619,5.903852368163189e-05,2,2,4
org.apache.camel.component.validator.jing.RelaxNGCompactSyntaxComponent,3,3,6,0.5,1,0.3333333333333333,285,95.0,3,0.5,0.0,0.0,0.0,0.0,0,2,2
org.apache.camel.component.validator.SpringValidator,2,1,2,0.5,1,0.5,284,142.0,1,0.5,0.0,0.0,0.0012515644555694619,2.7429402595448443e-06,2,1,3
org.apache.camel.component.validator.ValidatorComponent,4,3,12,0.25,1,0.25,286,71.5,9,0.75,0.0,0.0,0.0006257822277847309,5.48588051908969e-05,1,3,4
org.apache.camel.component.velocity.VelocityComponent,3,3,6,0.5,1,0.3333333333333333,288,96.0,3,0.5,0.5,0.16666666666666666,0.0006257822277847309,1.175545825519219e-06,1,2,3
org.apache.camel.component.velocity.VelocityEndpoint,5,8,20,0.4,1,0.2,288,57.6,12,0.6,0.25,0.05,0.0006257822277847309,8.960271514513157e-06,1,4,5
org.apache.camel.component.vm.VmComponent,4,6,12,0.5,1,0.25,283,70.75,6,0.5,0.0,0.0,0.0,0.0,0,3,3
org.apache.camel.component.xmpp.RuntimeXmppException,1,0,0,0,1,1.0,-1,-1.0,0,0,0.0,0.0,0.0017329354000192548,0.0,2,0,2
org.apache.camel.component.xmpp.XmppBinding,4,10,12,0.8333333333333334,1,0.25,285,71.25,2,0.16666666666666666,0.0,0.0,0.003899104650043323,4.29696208232779e-06,5,3,8
org.apache.camel.component.xmpp.XmppComponent,4,7,12,0.5833333333333334,1,0.25,291,72.75,5,0.4166666666666667,0.3333333333333333,0.08333333333333333,0.001738283966068697,0.0001063215891080716,2,4,6
org.apache.camel.component.xmpp.XmppConsumer,2,2,2,1.0,1,0.5,291,145.5,0,0.0,0.0,0.0,0.001738283966068697,0.0,1,1,2
org.apache.camel.component.xmpp.XmppEndpoint,12,25,132,0.1893939393939394,1,0.08333333333333333,291,24.25,107,0.8106060606060606,0.32727272727272727,0.02727272727272727,0.0031289111389236545,0.000137499676724898,5,11,16
org.apache.camel.component.xmpp.XmppExchange,7,22,42,0.5238095238095238,1,0.14285714285714285,285,40.714285714285715,20,0.47619047619047616,0.1611111111111111,0.023015873015873014,0.003620597175040229,0.000288395600005369,4,6,10
org.apache.camel.component.xmpp.XmppGroupChatProducer,5,8,20,0.4,1,0.2,291,58.2,12,0.6,0.125,0.025,0.001738283966068697,1.2601353664031417e-06,1,4,5
org.apache.camel.component.xmpp.XmppMessage,5,12,20,0.6,1,0.2,285,57.0,8,0.4,0.16666666666666666,0.03333333333333333,0.002413731450026819,2.2857835496207033e-06,3,5,8
org.apache.camel.component.xmpp.XmppPrivateChatProducer,5,8,20,0.4,1,0.2,291,58.2,12,0.6,0.125,0.025,0.001738283966068697,1.2601353664031417e-06,1,4,5
org.apache.camel.component.xquery.ResultFormat,1,0,0,0,1,1.0,-1,-1.0,0,0,0.0,0.0,0.0014080100125156445,0.0,2,0,2
org.apache.camel.component.xquery.XQuery,1,0,0,0,1,1.0,-1,-1.0,0,0,0.0,0.0,0.0022349365278026105,0.0,3,0,3
org.apache.camel.component.xquery.XQueryAnnotationExpressionFactory,8,10,56,0.17857142857142858,1,0.125,282,35.25,46,0.8214285714285714,0.0,0.0,0.0,0.0,0,7,7
org.apache.camel.component.xquery.XQueryBuilder,11,15,110,0.13636363636363635,1,0.09090909090909091,283,25.727272727272727,95,0.8636363636363636,0.0,0.0,0.0006257822277847309,6.302269105726464e-05,2,11,13
org.apache.camel.component.xquery.XQueryComponent,4,4,12,0.3333333333333333,1,0.25,285,71.25,8,0.6666666666666666,0.0,0.0,0.0,0.0,0,3,3
org.apache.camel.component.xquery.XQueryLanguage,4,5,12,0.4166666666666667,1,0.25,2,0.5,7,0.5833333333333334,0.0,0.0,0.0,0.0,0,3,3
org.apache.camel.component.xslt.XsltComponent,5,6,20,0.3,1,0.2,294,58.8,14,0.7,0.0,0.0,0.0,0.0,0,4,4
org.apache.camel.Consumer,1,0,0,0,1,1.0,-1,-1.0,0,0,0.0,0.0,0.23520528271716437,0.0,33,0,33
org.apache.camel.Converter,1,0,0,0,1,1.0,-1,-1.0,0,0,0.0,0.0,0.12503641060276752,0.0,26,0,26
org.apache.camel.converter.CamelConverter,3,2,6,0.3333333333333333,1,0.3333333333333333,278,92.66666666666667,4,0.6666666666666666,0.0,0.0,0.0,0.0,0,2,2
org.apache.camel.converter.CollectionConverter,3,2,6,0.3333333333333333,1,0.3333333333333333,1,0.3333333333333333,4,0.6666666666666666,0.0,0.0,0.0,0.0,0,2,2
org.apache.camel.converter.HasAnnotation,1,0,0,0,1,1.0,-1,-1.0,0,0,0.0,0.0,0.0008343763037129745,0.0,1,0,1
org.apache.camel.converter.IOConverter,4,3,12,0.25,1,0.25,2,0.5,9,0.75,0.0,0.0,0.10522906884689556,4.975217814646875e-05,19,3,22
org.apache.camel.converter.jaxb.ExchangeType,2,1,2,0.5,1,0.5,0,0.0,1,0.5,0.0,0.0,0.0,0.0,0,1,1
org.apache.camel.converter.jaxb.FallbackTypeConverter,3,3,6,0.5,1,0.3333333333333333,1,0.3333333333333333,3,0.5,0.0,0.0,0.0,0.0,0,2,2
org.apache.camel.converter.jaxb.HeaderType,1,0,0,0,1,1.0,-1,-1.0,0,0,0.0,0.0,0.003407036573494646,0.0,5,0,5
org.apache.camel.converter.jaxb.IntegerHeader,2,1,2,0.5,1,0.5,0,0.0,1,0.5,0.0,0.0,0.0011264080100125155,0.0,1,1,2
org.apache.camel.converter.jaxb.JaxbConverter,7,12,42,0.2857142857142857,1,0.14285714285714285,288,41.142857142857146,30,0.7142857142857143,0.0,0.0,0.0006257822277847309,1.222206620551618e-05,1,6,7
org.apache.camel.converter.jaxb.JaxbDataFormat,4,5,12,0.4166666666666667,1,0.25,278,69.5,7,0.5833333333333334,0.0,0.0,0.0,0.0,0,3,3
org.apache.camel.converter.jaxb.LongHeader,2,1,2,0.5,1,0.5,0,0.0,1,0.5,0.0,0.0,0.0011264080100125155,0.0,1,1,2
org.apache.camel.converter.jaxb.MessageType,6,9,30,0.3,1,0.16666666666666666,282,47.0,21,0.7,0.0,0.0,0.0012515644555694619,3.3307131723044538e-06,2,5,7
org.apache.camel.converter.jaxb.ObjectHeader,2,1,2,0.5,1,0.5,0,0.0,1,0.5,0.0,0.0,0.0,0.0,0,1,1
org.apache.camel.converter.jaxb.PropertyType,1,0,0,0,1,1.0,-1,-1.0,0,0,0.0,0.0,0.0006257822277847309,0.0,1,0,1
org.apache.camel.converter.jaxb.StringHeader,2,1,2,0.5,1,0.5,0,0.0,1,0.5,0.0,0.0,0.0011264080100125155,0.0,1,1,2
org.apache.camel.converter.jaxp.BytesSource,1,0,0,0,1,1.0,-1,-1.0,0,0,0.0,0.0,0.006963436806295936,0.0,2,0,2
org.apache.camel.converter.jaxp.DomConverter,2,1,2,0.5,1,0.5,0,0.0,1,0.5,0.0,0.0,0.0,0.0,0,1,1
org.apache.camel.converter.jaxp.StaxConverter,2,1,2,0.5,1,0.5,0,0.0,1,0.5,0.0,0.0,0.0006257822277847309,3.918486085064063e-07,1,1,2
org.apache.camel.converter.jaxp.StreamSourceConverter,2,1,2,0.5,1,0.5,0,0.0,1,0.5,0.0,0.0,0.0,0.0,0,1,1
org.apache.camel.converter.jaxp.StringSource,1,0,0,0,1,1.0,-1,-1.0,0,0,0.0,0.0,0.007145619015639469,0.0,2,0,2
org.apache.camel.converter.jaxp.XmlConverter,7,9,42,0.21428571428571427,1,0.14285714285714285,9,1.2857142857142858,33,0.7857142857142857,0.0,0.0,0.008433469297762099,0.00014720212816337976,8,6,14
org.apache.camel.converter.NIOConverter,3,3,6,0.5,1,0.3333333333333333,3,1.0,3,0.5,0.0,0.0,0.007174784807540038,1.175545825519219e-06,3,2,5
org.apache.camel.converter.ObjectConverter,2,1,2,0.5,1,0.5,0,0.0,1,0.5,0.0,0.0,0.13732403547274466,0.00027102436704921863,4,1,5
org.apache.camel.converter.stream.StreamCache,1,0,0,0,1,1.0,-1,-1.0,0,0,0.0,0.0,0.0032183086000357585,0.0,5,0,5
org.apache.camel.converter.stream.StreamCacheConverter,7,11,42,0.2619047619047619,1,0.14285714285714285,13,1.8571428571428572,31,0.7380952380952381,0.0,0.0,0.0006257822277847309,1.3061620283546878e-06,1,6,7
org.apache.camel.converter.xmlbeans.XmlBeansConverter,5,10,20,0.5,1,0.2,10,2.0,10,0.5,0.0,0.0,0.0,0.0,0,4,4
org.apache.camel.converter.xmlbeans.XmlBeansDataFormat,3,4,6,0.6666666666666666,1,0.3333333333333333,278,92.66666666666667,2,0.3333333333333333,0.0,0.0,0.0,0.0,0,2,2
org.apache.camel.dataformat.csv.CsvDataFormat,3,4,6,0.6666666666666666,1,0.3333333333333333,278,92.66666666666667,2,0.3333333333333333,0.0,0.0,0.0,0.0,0,2,2
org.apache.camel.dataformat.xstream.XStreamDataFormat,4,5,12,0.4166666666666667,1,0.25,279,69.75,7,0.5833333333333334,0.0,0.0,0.0,0.0,0,3,3
org.apache.camel.Endpoint,8,15,56,0.26785714285714285,1,0.125,277,34.625,41,0.7321428571428571,0.42857142857142855,0.05357142857142857,0.3148639224612947,0.009720874371660998,120,7,127
org.apache.camel.EndpointInject,1,0,0,0,1,1.0,-1,-1.0,0,0,0.0,0.0,0.006221011558565854,0.0,9,0,9
org.apache.camel.Exchange,5,9,20,0.45,1,0.2,277,55.4,11,0.55,0.5,0.1,0.3691894745757088,0.03249339468129104,264,5,269
org.apache.camel.ExchangePattern,1,1,0,0,1,1.0,-1,-1.0,-1,0,0.0,0.0,0.288594993278349,0.0,40,1,41
org.apache.camel.ExchangeProperty,3,4,6,0.6666666666666666,1,0.3333333333333333,278,92.66666666666667,2,0.3333333333333333,0.0,0.0,0.03150730602932886,8.738967463237013e-06,4,3,7
org.apache.camel.ExchangeTimedOutException,3,4,6,0.6666666666666666,1,0.3333333333333333,278,92.66666666666667,2,0.3333333333333333,0.0,0.0,0.009042553191489361,2.3053759800460237e-05,4,2,6
org.apache.camel.ExpectedBodyTypeException,3,3,6,0.5,1,0.3333333333333333,278,92.66666666666667,3,0.5,0.0,0.0,0.0008343763037129745,3.918486085064063e-07,1,2,3
org.apache.camel.Expression,1,0,0,0,1,1.0,-1,-1.0,0,0,0.0,0.0,0.22406260887814905,0.0,55,0,55
org.apache.camel.FailedToCreateProducerException,3,2,6,0.3333333333333333,1,0.3333333333333333,277,92.33333333333333,4,0.6666666666666666,0.0,0.0,0.107618156910003,1.266977167504047e-06,2,2,4
org.apache.camel.Header,1,0,0,0,1,1.0,-1,-1.0,0,0,0.0,0.0,0.10400842188746584,0.0,6,0,6
org.apache.camel.Headers,1,0,0,0,1,1.0,-1,-1.0,0,0,0.0,0.0,0.10423625880446906,0.0,7,0,7
org.apache.camel.impl.BinaryPredicateSupport,3,2,6,0.3333333333333333,1,0.3333333333333333,1,0.3333333333333333,4,0.6666666666666666,0.0,0.0,0.0,0.0,0,2,2
org.apache.camel.impl.converter.AnnotationTypeConverterLoader,9,12,72,0.16666666666666666,1,0.1111111111111111,14,1.5555555555555556,60,0.8333333333333334,0.0,0.0,0.13722519365815866,0.004511810708387072,3,8,11
org.apache.camel.impl.converter.ArrayTypeConverter,2,1,2,0.5,1,0.5,0,0.0,1,0.5,0.0,0.0,0.1368186598336506,0.0,1,1,2
org.apache.camel.impl.converter.AsyncProcessorTypeConverter,5,6,20,0.3,1,0.2,277,55.4,14,0.7,0.0,0.0,0.1395366141568675,0.0004840978567137517,7,4,11
org.apache.camel.impl.converter.CachingInjector,3,3,6,0.5,1,0.3333333333333333,2,0.6666666666666666,3,0.5,0.0,0.0,0.1167983720258773,9.796215212660157e-07,2,2,4
org.apache.camel.impl.converter.DefaultTypeConverter,14,25,182,0.13736263736263737,1,0.07142857142857142,24,1.7142857142857142,157,0.8626373626373627,0.0,0.0,0.16621280222826687,0.008829002752606337,5,13,18
org.apache.camel.impl.converter.EnumTypeConverter,3,2,6,0.3333333333333333,1,0.3333333333333333,1,0.3333333333333333,4,0.6666666666666666,0.0,0.0,0.1368186598336506,1.9592430425320314e-06,1,2,3
org.apache.camel.impl.converter.InstanceMethodTypeConverter,4,3,12,0.25,1,0.25,4,1.0,9,0.75,0.0,0.0,0.11662305154169986,1.3061620283546876e-06,1,3,4
org.apache.camel.impl.converter.PropertyEditorTypeConverter,2,1,2,0.5,1,0.5,0,0.0,1,0.5,0.0,0.0,0.1368186598336506,0.0,1,1,2
org.apache.camel.impl.converter.StaticMethodTypeConverter,2,1,2,0.5,1,0.5,0,0.0,1,0.5,0.0,0.0,0.11662305154169986,1.3061620283546875e-07,1,1,2
org.apache.camel.impl.converter.ToStringTypeConverter,2,1,2,0.5,1,0.5,0,0.0,1,0.5,0.0,0.0,0.1368186598336506,0.0,1,1,2
org.apache.camel.impl.converter.TypeConverterLoader,2,1,2,0.5,1,0.5,2,1.0,1,0.5,0.0,0.0,0.13738875815056154,0.0,2,1,3
org.apache.camel.impl.converter.TypeConverterRegistry,3,2,6,0.3333333333333333,1,0.3333333333333333,1,0.3333333333333333,4,0.6666666666666666,0.0,0.0,0.13820357390174992,2.2857835496207033e-06,6,2,8
org.apache.camel.impl.DefaultCamelContext,35,96,1190,0.08067226890756303,1,0.02857142857142857,277,7.914285714285715,1094,0.9193277310924369,0.042186571598336296,0.0012053306170953227,0.21045382410395128,0.0316174265273861,71,34,105
org.apache.camel.impl.DefaultComponent,12,22,132,0.16666666666666666,1,0.08333333333333333,281,23.416666666666668,110,0.8333333333333334,0.0,0.0,0.004022885750044699,0.00021790048038027076,4,11,15
org.apache.camel.impl.DefaultComponentResolver,8,15,56,0.26785714285714285,1,0.125,277,34.625,41,0.7321428571428571,0.0,0.0,0.1651224428766046,0.0,1,7,8
org.apache.camel.impl.DefaultConsumer,10,15,90,0.16666666666666666,1,0.1,278,27.8,75,0.8333333333333334,0.0,0.0,0.008126712444609817,0.00030699623241725414,7,9,16
org.apache.camel.impl.DefaultEndpoint,10,26,90,0.28888888888888886,1,0.1,280,28.0,64,0.7111111111111111,0.0,0.0,0.012356863990435805,0.000523928621864128,5,9,14
org.apache.camel.impl.DefaultExchange,11,28,110,0.2545454545454545,1,0.09090909090909091,282,25.636363636363637,82,0.7454545454545455,0.0,0.0,0.04087289455330614,0.0009266852621844729,23,11,34
org.apache.camel.impl.DefaultExchangeConverter,3,4,6,0.6666666666666666,1,0.3333333333333333,277,92.33333333333333,2,0.3333333333333333,0.0,0.0,0.16515167326125263,9.18449811357875e-06,1,2,3
org.apache.camel.impl.DefaultExchangeFormatter,3,5,6,0.8333333333333334,1,0.3333333333333333,277,92.33333333333333,1,0.16666666666666666,0.0,0.0,0.11185011416530585,0.0,2,3,5
org.apache.camel.impl.DefaultLanguageResolver,8,13,56,0.23214285714285715,1,0.125,277,34.625,43,0.7678571428571429,0.0,0.0,0.1651224428766046,0.0004784471509863221,1,7,8
org.apache.camel.impl.DefaultLifecycleStrategy,4,7,12,0.5833333333333334,1,0.25,277,69.25,5,0.4166666666666667,0.0,0.0,0.16521016508815584,1.5813352014286676e-05,2,3,5
org.apache.camel.impl.DefaultMessage,3,4,6,0.6666666666666666,1,0.3333333333333333,280,93.33333333333333,2,0.3333333333333333,0.0,0.0,0.03757139421018944,0.00025872877295444487,18,3,21
org.apache.camel.impl.DefaultPollingEndpoint,7,11,42,0.2619047619047619,1,0.14285714285714285,281,40.142857142857146,31,0.7380952380952381,0.0,0.0,0.012800091022869496,0.0009204449175985291,5,6,11
org.apache.camel.impl.DefaultProducer,5,9,20,0.45,1,0.2,278,55.6,11,0.55,0.0,0.0,0.008382571237302442,1.048848108768814e-05,4,4,8
org.apache.camel.impl.DefaultProducerTemplate,10,25,90,0.2777777777777778,1,0.1,278,27.8,65,0.7222222222222222,0.0,0.0,0.0006257822277847309,5.64261996249225e-06,1,9,10
org.apache.camel.impl.DefaultRouteContext,19,64,342,0.1871345029239766,1,0.05263157894736842,277,14.578947368421053,278,0.8128654970760234,0.19226579520697168,0.0101192523793143,0.1652394265414127,0.003272680426020922,3,18,21
org.apache.camel.impl.DefaultScheduledPollConsumer,4,4,12,0.3333333333333333,1,0.25,279,69.75,8,0.6666666666666666,0.0,0.0,0.009132104786155108,1.5719660011248667e-05,1,3,4
org.apache.camel.impl.DefaultUnitOfWork,5,9,20,0.45,1,0.2,279,55.8,11,0.55,0.0,0.0,0.0006257822277847309,9.796215212660157e-07,1,4,5
org.apache.camel.impl.DelegateLifecycleStrategy,4,7,12,0.5833333333333334,1,0.25,278,69.5,5,0.4166666666666667,0.0,0.0,0.0,0.0,0,3,3
org.apache.camel.impl.EventDrivenConsumerRoute,5,7,20,0.35,1,0.2,277,55.4,13,0.65,0.0,0.0,0.1370763741188387,1.2874870212588065e-05,7,4,11
org.apache.camel.impl.EventDrivenPollingConsumer,7,14,42,0.3333333333333333,1,0.14285714285714285,279,39.857142857142854,28,0.6666666666666666,0.0,0.0,0.013443321724040034,0.000151701389864623,3,6,9
org.apache.camel.impl.ExpressionSupport,2,1,2,0.5,1,0.5,0,0.0,1,0.5,0.0,0.0,0.001668752607425949,8.816593691394142e-07,2,1,3
org.apache.camel.impl.JndiRegistry,3,2,6,0.3333333333333333,1,0.3333333333333333,1,0.3333333333333333,4,0.6666666666666666,0.0,0.0,0.17701659182331766,7.04212592723043e-05,9,2,11
org.apache.camel.impl.LoggingExceptionHandler,3,2,6,0.3333333333333333,1,0.3333333333333333,277,92.33333333333333,4,0.6666666666666666,0.0,0.0,0.10738280412670535,9.759642675866227e-05,4,2,6
org.apache.camel.impl.MessageSupport,5,8,20,0.4,1,0.2,279,55.8,12,0.6,0.0,0.0,0.03443096337186624,0.00033962825061278597,5,4,9
org.apache.camel.impl.NoPolicy,3,3,6,0.5,1,0.3333333333333333,278,92.66666666666667,3,0.5,0.0,0.0,0.0,0.0,0,2,2
org.apache.camel.impl.PollingConsumerSupport,6,7,30,0.23333333333333334,1,0.16666666666666666,278,46.333333333333336,23,0.7666666666666667,0.0,0.0,0.018582821550193557,0.00014693016656961886,6,5,11
org.apache.camel.impl.PredicateSupport,2,1,2,0.5,1,0.5,0,0.0,1,0.5,0.0,0.0,0.0,0.0,0,1,1
org.apache.camel.impl.ProcessorEndpoint,9,17,72,0.2361111111111111,1,0.1111111111111111,285,31.666666666666668,55,0.7638888888888888,0.0,0.0,0.0029816682617978354,0.00017619301636463035,3,8,11
org.apache.camel.impl.ProcessorPollingConsumer,6,9,30,0.3,1,0.16666666666666666,280,46.666666666666664,21,0.7,0.0,0.0,0.0023177119547582625,3.676193028804268e-05,1,5,6
org.apache.camel.impl.ProducerCache,9,15,72,0.20833333333333334,1,0.1111111111111111,277,30.77777777777778,57,0.7916666666666666,0.0,0.0,0.12249761058991808,0.00046861221739924995,4,8,12
org.apache.camel.impl.ReportingTypeConverterLoader,4,4,12,0.3333333333333333,1,0.25,16,4.0,8,0.6666666666666666,0.0,0.0,0.0,0.0,0,3,3
org.apache.camel.impl.ReportingTypeConverterRegistry,4,5,12,0.4166666666666667,1,0.25,2,0.5,7,0.5833333333333334,0.0,0.0,0.0006257822277847309,9.796215212660157e-07,1,3,4
org.apache.camel.impl.ScheduledPollConsumer,2,1,2,0.5,1,0.5,278,139.0,1,0.5,0.0,0.0,0.01448569971723914,1.0097637219203545e-06,9,1,10
org.apache.camel.impl.ScheduledPollEndpoint,4,5,12,0.4166666666666667,1,0.25,278,69.5,7,0.5833333333333334,0.0,0.0,0.02144380880959499,0.00028705116216665963,7,3,10
org.apache.camel.impl.SerializationDataFormat,4,5,12,0.4166666666666667,1,0.25,277,69.25,7,0.5833333333333334,0.0,0.0,0.11664688700335285,0.00023227199458368186,1,3,4
org.apache.camel.impl.ServiceSupport,3,2,6,0.3333333333333333,1,0.3333333333333333,1,0.3333333333333333,4,0.6666666666666666,0.0,0.0,0.20171525794762218,0.00026033799368960263,40,2,42
org.apache.camel.impl.StringDataFormat,4,5,12,0.4166666666666667,1,0.25,277,69.25,7,0.5833333333333334,0.0,0.0,0.11653032753595004,0.00023042004342205044,1,3,4
org.apache.camel.Intercept,2,1,2,0.5,1,0.5,277,138.5,1,0.5,0.0,0.0,0.17005865881385637,0.0,3,1,4
org.apache.camel.InvalidHeaderTypeException,2,1,2,0.5,1,0.5,0,0.0,1,0.5,0.0,0.0,0.0,0.0,0,1,1
org.apache.camel.InvalidPayloadException,4,7,12,0.5833333333333334,1,0.25,277,69.25,5,0.4166666666666667,0.0,0.0,0.12748589809412628,0.0004165429293446197,9,3,12
org.apache.camel.InvalidPayloadRuntimeException,4,6,12,0.5,1,0.25,279,69.75,6,0.5,0.0,0.0,0.0,0.0,0,3,3
org.apache.camel.InvalidTypeException,4,7,12,0.5833333333333334,1,0.25,277,69.25,5,0.4166666666666667,0.0,0.0,0.10203891526335077,4.377472857170825e-05,1,3,4
org.apache.camel.language.bean.BeanExpression,4,3,12,0.25,1,0.25,277,69.25,9,0.75,0.0,0.0,0.12280397554992972,0.0011651929125673312,2,3,5
org.apache.camel.language.bean.BeanLanguage,5,6,20,0.3,1,0.2,278,55.6,14,0.7,0.0,0.0,0.0,0.0,0,4,4
org.apache.camel.language.bean.RuntimeBeanExpressionException,3,3,6,0.5,1,0.3333333333333333,277,92.33333333333333,3,0.5,0.0,0.0,0.10588375919337376,0.0004788389995948285,1,2,3
org.apache.camel.language.ExpressionEvaluationException,4,4,12,0.3333333333333333,1,0.25,278,69.5,8,0.6666666666666666,0.0,0.0,0.0022349365278026105,3.541751637171475e-05,3,3,6
org.apache.camel.language.groovy.CamelGroovyMethods,5,9,20,0.45,1,0.2,279,55.8,11,0.55,0.0,0.0,0.0,0.0,0,4,4
org.apache.camel.language.groovy.GroovyExpression,2,2,2,1.0,1,0.5,278,139.0,0,0.0,0.0,0.0,0.0,0.0,0,1,1
org.apache.camel.language.groovy.GroovyLanguage,3,2,6,0.3333333333333333,1,0.3333333333333333,279,93.0,4,0.6666666666666666,0.0,0.0,0.0006257822277847309,1.5673944340256252e-06,1,2,3
org.apache.camel.language.groovy.GroovyRouteBuilder,2,1,2,0.5,1,0.5,278,139.0,1,0.5,0.0,0.0,0.0,0.0,0,1,1
org.apache.camel.language.IllegalSyntaxException,3,2,6,0.3333333333333333,1,0.3333333333333333,3,1.0,4,0.6666666666666666,0.0,0.0,0.0014080100125156445,9.796215212660157e-07,2,2,4
org.apache.camel.language.juel.JuelExpression,4,5,12,0.4166666666666667,1,0.25,279,69.75,7,0.5833333333333334,0.0,0.0,0.0012515644555694619,0.0001167708853349091,3,4,7
org.apache.camel.language.juel.JuelLanguage,5,7,20,0.35,1,0.2,280,56.0,13,0.65,0.0,0.0,0.0,0.0,0,4,4
org.apache.camel.language.jxpath.JXPath,1,0,0,0,1,1.0,-1,-1.0,0,0,0.0,0.0,0.0008343763037129745,0.0,1,0,1
org.apache.camel.language.jxpath.JXPathExpression,3,4,6,0.6666666666666666,1,0.3333333333333333,279,93.0,2,0.3333333333333333,0.0,0.0,0.0006257822277847309,0.00010854206455627457,1,2,3
org.apache.camel.language.jxpath.JXPathLanguage,5,6,20,0.3,1,0.2,280,56.0,14,0.7,0.0,0.0,0.0,0.0,0,4,4
org.apache.camel.language.LanguageAnnotation,1,0,0,0,1,1.0,-1,-1.0,0,0,0.0,0.0,0.10340495609552884,0.0,4,0,4
org.apache.camel.language.NamespacePrefix,1,0,0,0,1,1.0,-1,-1.0,0,0,0.0,0.0,0.0012515644555694619,0.0,2,0,2
org.apache.camel.language.ognl.OgnlExpression,7,10,42,0.23809523809523808,1,0.14285714285714285,283,40.42857142857143,32,0.7619047619047619,0.16666666666666666,0.023809523809523808,0.0006257822277847309,0.0001097176103817938,1,6,7
org.apache.camel.language.ognl.OgnlLanguage,5,7,20,0.35,1,0.2,283,56.6,13,0.65,0.25,0.05,0.0006257822277847309,7.836972170128126e-07,1,4,5
org.apache.camel.language.ognl.RootObject,4,8,12,0.6666666666666666,1,0.25,278,69.5,4,0.3333333333333333,0.0,0.0,0.0008343763037129745,4.796422892422667e-05,1,3,4
org.apache.camel.language.Simple,1,0,0,0,1,1.0,-1,-1.0,0,0,0.0,0.0,0.001668752607425949,0.0,2,0,2
org.apache.camel.language.simple.SimpleLanguage,5,7,20,0.35,1,0.2,4,0.8,13,0.65,0.0,0.0,0.0,0.0,0,4,4
org.apache.camel.language.XPath,1,0,0,0,1,1.0,-1,-1.0,0,0,0.0,0.0,0.0022349365278026105,0.0,3,0,3
org.apache.camel.management.CamelNamingStrategy,9,10,72,0.1388888888888889,1,0.1111111111111111,277,30.77777777777778,62,0.8611111111111112,0.0,0.0,0.13587850309537083,0.00047936146440617035,1,8,9
org.apache.camel.management.Counter,1,0,0,0,1,1.0,-1,-1.0,0,0,0.0,0.0,0.11591339018974955,0.0,1,0,1
org.apache.camel.management.DefaultInstrumentationAgent,4,3,12,0.25,1,0.25,4,1.0,9,0.75,0.0,0.0,0.0,0.0,0,3,3
org.apache.camel.management.InstrumentationErrorHandlerWrappingStrategy,5,11,20,0.55,1,0.2,277,55.4,9,0.45,0.0,0.0,0.13587850309537083,4.278682718836606e-06,1,4,5
org.apache.camel.management.InstrumentationInterceptStrategy,5,9,20,0.45,1,0.2,277,55.4,11,0.55,0.0,0.0,0.13585871592439436,2.3032188336658625e-05,1,4,5
org.apache.camel.management.InstrumentationLifecycleStrategy,15,38,210,0.18095238095238095,1,0.06666666666666667,277,18.466666666666665,172,0.819047619047619,0.2765567765567766,0.018437118437118438,0.16515167326125263,0.004796674128041755,2,14,16
org.apache.camel.management.InstrumentationProcessor,4,5,12,0.4166666666666667,1,0.25,278,69.5,7,0.5833333333333334,0.0,0.0,0.0,0.0,0,3,3
org.apache.camel.management.JmxSystemPropertyKeys,1,0,0,0,1,1.0,-1,-1.0,0,0,0.0,0.0,0.1775755313569015,0.0,12,0,12
org.apache.camel.management.ManagedEndpoint,2,1,2,0.5,1,0.5,277,138.5,1,0.5,0.0,0.0,0.13599734726717436,1.2404298483563187e-06,2,1,3
org.apache.camel.management.ManagedRoute,3,2,6,0.3333333333333333,1,0.3333333333333333,277,92.33333333333333,4,0.6666666666666666,0.0,0.0,0.13601717484368217,9.143134198482814e-07,2,2,4
org.apache.camel.management.ManagedService,3,3,6,0.5,1,0.3333333333333333,2,0.6666666666666666,3,0.5,0.0,0.0,0.1360813438525257,1.175545825519219e-06,2,2,4
org.apache.camel.management.ObjectNameEncoder,1,0,0,0,1,1.0,-1,-1.0,0,0,0.0,0.0,0.11571277361629716,0.0,2,0,2
org.apache.camel.management.PerformanceCounter,2,1,2,0.5,1,0.5,0,0.0,1,0.5,0.0,0.0,0.1363792452182274,0.0004788389995948285,4,1,5
org.apache.camel.Message,2,4,2,2.0,1,0.5,277,138.5,-2,-1.0,0.0,0.0,0.27128287358325565,0.004271884213947439,83,2,85
org.apache.camel.MessageDriven,1,0,0,0,1,1.0,-1,-1.0,0,0,0.0,0.0,0.0020025031289111392,0.0,3,0,3
org.apache.camel.model.AggregatorType,12,33,132,0.25,1,0.08333333333333333,277,23.083333333333332,99,0.75,0.0,0.0,0.1671938713714724,0.002094561428669577,2,12,14
org.apache.camel.model.BeanRef,7,10,42,0.23809523809523808,1,0.14285714285714285,277,39.57142857142857,32,0.7619047619047619,0.0,0.0,0.1671938713714724,0.010187357417735778,1,6,7
org.apache.camel.model.Block,2,3,2,1.5,1,0.5,277,138.5,-1,-0.5,0.0,0.0,0.16770479997354235,0.00014398333043058015,5,1,6
org.apache.camel.model.CatchType,4,6,12,0.5,1,0.25,277,69.25,6,0.5,0.0,0.0,0.13719732386070824,0.0,1,3,4
org.apache.camel.model.ChoiceType,13,41,156,0.26282051282051283,1,0.07692307692307693,277,21.307692307692307,115,0.7371794871794872,0.25,0.019230769230769232,0.19628483110726197,0.009326658915694851,8,13,21
org.apache.camel.model.CompletedPredicate,4,6,12,0.5,1,0.25,277,69.25,6,0.5,0.0,0.0,0.13723768788655724,0.0,1,3,4
org.apache.camel.model.config.BatchResequencerConfig,1,1,0,0,1,1.0,-1,-1.0,-1,0,0.0,0.0,0.13740193916119603,0.0,3,1,4
org.apache.camel.model.config.StreamResequencerConfig,3,4,6,0.6666666666666666,1,0.3333333333333333,277,92.33333333333333,2,0.3333333333333333,0.0,0.0,0.13750063408295005,0.00047942677250758814,5,3,8
org.apache.camel.model.ConvertBodyType,5,11,20,0.55,1,0.2,277,55.4,9,0.45,0.0,0.0,0.1671938713714724,3.172955940308368e-07,2,4,6
org.apache.camel.model.dataformat.ArtixDSContentType,1,0,0,0,1,1.0,-1,-1.0,0,0,0.0,0.0,0.13766508371174044,0.0,2,0,2
org.apache.camel.model.dataformat.ArtixDSDataFormat,4,4,12,0.3333333333333333,1,0.25,277,69.25,8,0.6666666666666666,0.0,0.0,0.13756145712958065,2.3641532713219845e-06,4,3,7
org.apache.camel.model.dataformat.CsvDataFormat,2,1,2,0.5,1,0.5,277,138.5,1,0.5,0.0,0.0,0.13739938177508337,0.0,3,1,4
org.apache.camel.model.dataformat.DataFormatType,6,7,30,0.23333333333333334,1,0.16666666666666666,277,46.166666666666664,23,0.7666666666666667,0.0,0.0,0.16815821958414132,0.0008622429461726114,13,5,18
org.apache.camel.model.dataformat.JaxbDataFormat,3,3,6,0.5,1,0.3333333333333333,277,92.33333333333333,3,0.5,0.0,0.0,0.13756145712958065,4.049102287899531e-07,4,2,6
org.apache.camel.model.dataformat.SerializationDataFormat,5,7,20,0.35,1,0.2,277,55.4,13,0.65,0.0,0.0,0.13754117680271505,0.0007415270664112946,4,4,8
org.apache.camel.model.dataformat.StringDataFormat,5,7,20,0.35,1,0.2,277,55.4,13,0.65,0.0,0.0,0.13737914920524458,0.0007392625177810634,3,4,7
org.apache.camel.model.dataformat.XMLBeansDataFormat,2,1,2,0.5,1,0.5,277,138.5,1,0.5,0.0,0.0,0.13756145712958065,0.0,4,1,5
org.apache.camel.model.dataformat.XStreamDataFormat,2,1,2,0.5,1,0.5,277,138.5,1,0.5,0.0,0.0,0.13727807566992586,0.0,1,1,2
org.apache.camel.model.DelayerType,7,14,42,0.3333333333333333,1,0.14285714285714285,277,39.57142857142857,28,0.6666666666666666,0.0,0.0,0.1671938713714724,0.0011915463103665638,1,6,7
org.apache.camel.model.Description,1,0,0,0,1,1.0,-1,-1.0,0,0,0.0,0.0,0.1471467734290564,0.0,1,0,1
org.apache.camel.model.ExceptionType,8,23,56,0.4107142857142857,1,0.125,277,34.625,33,0.5892857142857143,0.22619047619047616,0.02827380952380952,0.19934653894290943,0.0078612504383926,13,8,21
org.apache.camel.model.ExpressionNode,7,18,42,0.42857142857142855,1,0.14285714285714285,277,39.57142857142857,24,0.5714285714285714,0.1,0.014285714285714287,0.18006983251357192,0.000971289773495971,15,6,21
org.apache.camel.model.FilterType,7,14,42,0.3333333333333333,1,0.14285714285714285,277,39.57142857142857,28,0.6666666666666666,0.0,0.0,0.16749403990176231,0.00010668054802842708,5,6,11
org.apache.camel.model.FinallyType,5,5,20,0.25,1,0.2,277,55.4,15,0.75,0.0,0.0,0.1372175029052531,1.9592430425320315e-07,1,4,5
org.apache.camel.model.FromType,4,5,12,0.4166666666666667,1,0.25,277,69.25,7,0.5833333333333334,0.16666666666666666,0.041666666666666664,0.18496070623568914,5.449079760879664e-05,10,3,13
org.apache.camel.model.HandleFaultType,3,2,6,0.3333333333333333,1,0.3333333333333333,277,92.33333333333333,4,0.6666666666666666,0.0,0.0,0.16722383980154437,0.0004780553023778157,1,2,3
org.apache.camel.model.IdempotentConsumerType,8,17,56,0.30357142857142855,1,0.125,277,34.625,39,0.6964285714285714,0.0,0.0,0.1671938713714724,0.0011919381589750701,1,7,8
org.apache.camel.model.IdentifiedType,1,0,0,0,1,1.0,-1,-1.0,0,0,0.0,0.0,0.13945121110327618,0.0,14,0,14
org.apache.camel.model.InterceptorRef,5,8,20,0.4,1,0.2,277,55.4,12,0.6,0.0,0.0,0.17896447386395858,0.0001430450005561114,5,4,9
org.apache.camel.model.InterceptorType,5,4,20,0.2,1,0.2,277,55.4,16,0.8,0.0,0.0,0.18217961379668346,0.00021980921318112576,6,4,10
org.apache.camel.model.InterceptType,10,27,90,0.3,1,0.1,277,27.7,63,0.7,0.0,0.0,0.19591386019588747,0.0010367871090245593,4,10,14
org.apache.camel.model.language.ELExpression,2,2,2,1.0,1,0.5,278,139.0,0,0.0,0.0,0.0,0.0,0.0,0,1,1
org.apache.camel.model.language.ExpressionType,9,13,72,0.18055555555555555,1,0.1111111111111111,277,30.77777777777778,59,0.8194444444444444,0.0,0.0,0.17152818574238207,0.0026413796298259745,36,9,45
org.apache.camel.model.language.GroovyExpression,2,2,2,1.0,1,0.5,278,139.0,0,0.0,0.0,0.0,0.0014080100125156445,0.00011052090002923191,2,1,3
org.apache.camel.model.language.HeaderExpression,2,2,2,1.0,1,0.5,278,139.0,0,0.0,0.0,0.0,0.0,0.0,0,1,1
org.apache.camel.model.language.JavaScriptExpression,2,2,2,1.0,1,0.5,278,139.0,0,0.0,0.0,0.0,0.0,0.0,0,1,1
org.apache.camel.model.language.JXPathExpression,2,2,2,1.0,1,0.5,278,139.0,0,0.0,0.0,0.0,0.0,0.0,0,1,1
org.apache.camel.model.language.LanguageExpression,2,2,2,1.0,1,0.5,277,138.5,0,0.0,0.0,0.0,0.16722383980154437,0.0,1,1,2
org.apache.camel.model.language.MethodCallExpression,6,9,30,0.3,1,0.16666666666666666,277,46.166666666666664,21,0.7,0.0,0.0,0.1460231338633301,0.0015263616409734405,1,5,6
org.apache.camel.model.language.NamespaceAwareExpression,4,5,12,0.4166666666666667,1,0.25,277,69.25,7,0.5833333333333334,0.0,0.0,0.1467351057333778,0.00026605991832954465,3,3,6
org.apache.camel.model.language.OgnlExpression,2,2,2,1.0,1,0.5,278,139.0,0,0.0,0.0,0.0,0.0008343763037129745,0.00011645348796201891,1,1,2
org.apache.camel.model.language.PhpExpression,2,2,2,1.0,1,0.5,278,139.0,0,0.0,0.0,0.0,0.0,0.0,0,1,1
org.apache.camel.model.language.PythonExpression,2,2,2,1.0,1,0.5,278,139.0,0,0.0,0.0,0.0,0.0,0.0,0,1,1
org.apache.camel.model.language.RubyExpression,2,2,2,1.0,1,0.5,278,139.0,0,0.0,0.0,0.0,0.0,0.0,0,1,1
org.apache.camel.model.language.SimpleExpression,2,2,2,1.0,1,0.5,278,139.0,0,0.0,0.0,0.0,0.0,0.0,0,1,1
org.apache.camel.model.language.SqlExpression,2,2,2,1.0,1,0.5,278,139.0,0,0.0,0.0,0.0,0.0,0.0,0,1,1
org.apache.camel.model.language.XPathExpression,3,3,6,0.5,1,0.3333333333333333,277,92.33333333333333,3,0.5,0.0,0.0,0.14655070723418412,0.0003325845131354415,3,2,5
org.apache.camel.model.language.XQueryExpression,3,3,6,0.5,1,0.3333333333333333,277,92.33333333333333,3,0.5,0.0,0.0,0.1467351057333778,0.0002528422950342227,4,2,6
org.apache.camel.model.loadbalancer.LoadBalancerType,7,10,42,0.23809523809523808,1,0.14285714285714285,277,39.57142857142857,32,0.7619047619047619,0.0,0.0,0.13770358704838614,4.567650624811148e-05,7,6,13
org.apache.camel.model.loadbalancer.RandomLoadBalanceStrategy,5,6,20,0.3,1,0.2,277,55.4,14,0.7,0.0,0.0,0.1374196203053198,2.1367313460278757e-06,2,4,6
org.apache.camel.model.loadbalancer.RoundRobinLoadBalanceStrategy,5,6,20,0.3,1,0.2,277,55.4,14,0.7,0.0,0.0,0.1374398647985881,2.729253938890593e-06,3,4,7
org.apache.camel.model.loadbalancer.StickyLoadBalanceStrategy,4,5,12,0.4166666666666667,1,0.25,277,69.25,7,0.5833333333333334,0.0,0.0,0.1374601152575241,2.250330580279648e-06,3,3,6
org.apache.camel.model.loadbalancer.TopicLoadBalanceStrategy,5,6,20,0.3,1,0.2,277,55.4,14,0.7,0.0,0.0,0.1374196203053198,2.7245042587874856e-06,2,4,6
org.apache.camel.model.LoadBalanceType,17,42,272,0.15441176470588236,1,0.058823529411764705,277,16.294117647058822,230,0.8455882352941176,0.0,0.0,0.16722383980154437,0.006070648264802195,3,17,20
org.apache.camel.model.MarshalType,13,23,156,0.14743589743589744,1,0.07692307692307693,277,21.307692307692307,133,0.8525641025641025,0.0,0.0,0.1671938713714724,0.002038003321604899,1,12,13
org.apache.camel.model.MulticastType,6,8,30,0.26666666666666666,1,0.16666666666666666,277,46.166666666666664,22,0.7333333333333333,0.0,0.0,0.16752411604467876,0.00010900554930778452,5,6,11
org.apache.camel.model.NodeFactory,3,3,6,0.5,1,0.3333333333333333,277,92.33333333333333,3,0.5,0.0,0.0,0.1671938713714724,0.0,1,2,3
org.apache.camel.model.OptionalIdentifiedType,2,1,2,0.5,1,0.5,0,0.0,1,0.5,0.0,0.0,0.18187438463123667,0.0004788389995948285,8,1,9
org.apache.camel.model.OtherwiseType,5,5,20,0.25,1,0.2,277,55.4,15,0.75,0.0,0.0,0.1564551068678209,2.0914882832305558e-05,3,4,7
org.apache.camel.model.OutputType,2,2,2,1.0,1,0.5,277,138.5,0,0.0,0.0,0.0,0.16007923854715442,0.0006764545721791511,17,1,18
org.apache.camel.model.PipelineType,4,4,12,0.3333333333333333,1,0.25,278,69.5,8,0.6666666666666666,0.0,0.0,0.0,0.0,0,3,3
org.apache.camel.model.PolicyRef,5,6,20,0.3,1,0.2,277,55.4,14,0.7,0.0,0.0,0.1671938713714724,2.1498135749805944e-05,1,4,5
org.apache.camel.model.ProceedType,4,4,12,0.3333333333333333,1,0.25,277,69.25,8,0.6666666666666666,0.0,0.0,0.17865603260299046,2.1498135749805944e-05,2,3,5
org.apache.camel.model.ProcessorRef,4,4,12,0.3333333333333333,1,0.25,277,69.25,8,0.6666666666666666,0.0,0.0,0.16722383980154437,2.156352866693981e-05,2,3,5
org.apache.camel.model.ProcessorType,64,261,4032,0.06473214285714286,1,0.015625,277,4.328125,3771,0.9352678571428571,0.665873015873016,0.010404265873015874,0.2139284114315102,0.09187099837316054,29,64,93
org.apache.camel.model.RecipientListType,7,13,42,0.30952380952380953,1,0.14285714285714285,277,39.57142857142857,29,0.6904761904761905,0.0,0.0,0.16740387623413172,0.0009617769741868653,3,6,9
org.apache.camel.model.RedeliveryPolicyType,2,3,2,1.5,1,0.5,0,0.0,-1,-0.5,0.0,0.0,0.1583311738792433,0.0,2,2,4
org.apache.camel.model.ResequencerType,11,24,110,0.21818181818181817,1,0.09090909090909091,277,25.181818181818183,86,0.7818181818181819,0.2,0.018181818181818184,0.1671938713714724,0.007140424931242063,3,11,14
org.apache.camel.model.RouteBuilderRef,5,7,20,0.35,1,0.2,290,58.0,13,0.65,0.0,0.0,0.001738283966068697,5.613386812333836e-07,1,4,5
org.apache.camel.model.RouteContainer,1,0,0,0,1,1.0,-1,-1.0,0,0,0.0,0.0,0.08380435815516894,0.0,5,0,5
org.apache.camel.model.RoutesType,15,34,210,0.1619047619047619,1,0.06666666666666667,280,18.666666666666668,176,0.8380952380952381,0.0,0.0,0.11434454358270417,0.0008354569471834934,3,15,18
org.apache.camel.model.RouteType,15,55,210,0.2619047619047619,1,0.06666666666666667,277,18.466666666666665,155,0.7380952380952381,0.44505494505494503,0.02967032967032967,0.20699840298487154,0.01294853064517292,21,15,36
org.apache.camel.model.RoutingSlipType,5,11,20,0.55,1,0.2,277,55.4,9,0.45,0.41666666666666663,0.08333333333333333,0.1674339200023001,0.0009486694720615442,4,4,8
org.apache.camel.model.ServiceActivationType,2,2,2,1.0,1,0.5,278,139.0,0,0.0,0.0,0.0,0.08292580343950615,2.3240713118719987e-05,1,1,2
org.apache.camel.model.SetBodyType,6,12,30,0.4,1,0.16666666666666666,277,46.166666666666664,18,0.6,0.0,0.0,0.16722383980154437,1.1437399319716209e-07,2,5,7
org.apache.camel.model.SetHeaderType,7,14,42,0.3333333333333333,1,0.14285714285714285,277,39.57142857142857,28,0.6666666666666666,0.0,0.0,0.16722383980154437,0.0004781696763710129,2,6,8
org.apache.camel.model.SplitterType,8,16,56,0.2857142857142857,1,0.125,277,34.625,40,0.7142857142857143,0.0,0.0,0.16740387623413172,0.0025885461189012107,3,7,10
org.apache.camel.model.ThreadType,4,10,12,0.8333333333333334,1,0.25,277,69.25,2,0.16666666666666666,0.0,0.0,0.16716391368084862,0.0,2,4,6
org.apache.camel.model.ThrottlerType,5,12,20,0.6,1,0.2,277,55.4,8,0.4,0.16666666666666666,0.03333333333333333,0.16716391368084862,0.000954739134625859,2,5,7
org.apache.camel.model.ThrowFaultType,6,12,30,0.4,1,0.16666666666666666,277,46.166666666666664,18,0.6,0.1,0.016666666666666666,0.16716391368084862,0.0004780553023778157,1,5,6
org.apache.camel.model.ToType,7,19,42,0.4523809523809524,1,0.14285714285714285,277,39.57142857142857,23,0.5476190476190477,0.11666666666666667,0.016666666666666666,0.1675843007459702,0.00025124647440903143,4,6,10
org.apache.camel.model.TransformType,7,14,42,0.3333333333333333,1,0.14285714285714285,277,39.57142857142857,28,0.6666666666666666,0.0,0.0,0.16722383980154437,0.0004781696763710129,2,6,8
org.apache.camel.model.TryType,9,25,72,0.3472222222222222,1,0.1111111111111111,277,30.77777777777778,47,0.6527777777777778,0.3571428571428571,0.03968253968253968,0.16716391368084862,0.004219866223662038,2,9,11
org.apache.camel.model.UnmarshalType,13,23,156,0.14743589743589744,1,0.07692307692307693,277,21.307692307692307,133,0.8525641025641025,0.0,0.0,0.1671938713714724,0.002038003321604899,1,12,13
org.apache.camel.model.WhenType,6,13,30,0.43333333333333335,1,0.16666666666666666,277,46.166666666666664,17,0.5666666666666667,0.0,0.0,0.1564551068678209,5.1427261493797265e-05,3,5,8
org.apache.camel.NoSuchBeanException,2,1,2,0.5,1,0.5,0,0.0,1,0.5,0.0,0.0,0.10211677283742694,2.7429402595448443e-06,1,1,2
org.apache.camel.NoSuchEndpointException,2,1,2,0.5,1,0.5,0,0.0,1,0.5,0.0,0.0,0.17346771639786412,1.5926779990030622e-05,11,1,12
org.apache.camel.NoSuchHeaderException,3,4,6,0.6666666666666666,1,0.3333333333333333,277,92.33333333333333,2,0.3333333333333333,0.0,0.0,0.10203891526335077,4.377472857170825e-05,1,2,3
org.apache.camel.NoSuchLanguageException,2,1,2,0.5,1,0.5,0,0.0,1,0.5,0.0,0.0,0.13598233239745258,3.918486085064063e-07,1,1,2
org.apache.camel.NoSuchPropertyException,3,4,6,0.6666666666666666,1,0.3333333333333333,277,92.33333333333333,2,0.3333333333333333,0.0,0.0,0.12030197321119486,4.7040133642594966e-05,5,2,7
org.apache.camel.NoTypeConversionAvailableException,2,1,2,0.5,1,0.5,0,0.0,1,0.5,0.0,0.0,0.0,0.0,0,1,1
org.apache.camel.osgi.CamelContextFactoryBean,5,8,20,0.4,1,0.2,311,62.2,12,0.6,0.0,0.0,0.0006257822277847309,1.0219138994698299e-05,1,4,5
org.apache.camel.osgi.CamelNamespaceHandler,11,28,110,0.2545454545454545,1,0.09090909090909091,328,29.818181818181817,82,0.7454545454545455,0.0,0.0,0.0,0.0,0,10,10
org.apache.camel.osgi.OsgiComponentResolver,7,12,42,0.2857142857142857,1,0.14285714285714285,280,40.0,30,0.7142857142857143,0.16666666666666666,0.023809523809523808,0.0014080100125156445,0.00011222326453952086,2,6,8
org.apache.camel.OutHeaders,1,0,0,0,1,1.0,-1,-1.0,0,0,0.0,0.0,0.10341405654427442,0.0,2,0,2
org.apache.camel.PollingConsumer,1,0,0,0,1,1.0,-1,-1.0,0,0,0.0,0.0,0.22881258281961164,0.0,16,0,16
org.apache.camel.Predicate,1,0,0,0,1,1.0,-1,-1.0,0,0,0.0,0.0,0.24544416078506345,0.0,47,0,47
org.apache.camel.Processor,2,2,2,1.0,1,0.5,277,138.5,0,0.0,0.0,0.0,0.27247132075140656,0.00184312719967489,143,1,144
org.apache.camel.processor.aggregate.AggregationCollection,3,4,6,0.6666666666666666,1,0.3333333333333333,277,92.33333333333333,2,0.3333333333333333,0.0,0.0,0.1675542029908075,2.027637131159615e-06,4,2,6
org.apache.camel.processor.aggregate.AggregationStrategy,2,2,2,1.0,1,0.5,277,138.5,0,0.0,0.0,0.0,0.16925649532888537,4.124960159546285e-06,14,1,15
org.apache.camel.processor.aggregate.PredicateAggregationCollection,5,8,20,0.4,1,0.2,277,55.4,12,0.6,0.0,0.0,0.11645759608698242,3.1347888680512505e-07,1,4,5
org.apache.camel.processor.aggregate.UseLatestAggregationStrategy,2,2,2,1.0,1,0.5,277,138.5,0,0.0,0.0,0.0,0.12227284433195493,0.0,2,1,3
org.apache.camel.processor.Aggregator,8,12,56,0.21428571428571427,1,0.125,277,34.625,44,0.7857142857142857,0.0,0.0,0.13727807566992586,0.0011434795477231114,1,7,8
org.apache.camel.processor.BatchProcessor,9,15,72,0.20833333333333334,1,0.1111111111111111,277,30.77777777777778,57,0.7916666666666666,0.0,0.0,0.1169979686798114,0.0008857927499772386,5,8,13
org.apache.camel.processor.CatchProcessor,2,1,2,0.5,1,0.5,277,138.5,1,0.5,0.0,0.0,0.15850183524512676,2.587205556164093e-07,4,1,5
org.apache.camel.processor.ChoiceProcessor,7,12,42,0.2857142857142857,1,0.14285714285714285,277,39.57142857142857,30,0.7142857142857143,0.0,0.0,0.1564551068678209,5.144454853820739e-06,2,6,8
org.apache.camel.processor.CompositeProcessor,4,5,12,0.4166666666666667,1,0.25,278,69.5,7,0.5833333333333334,0.0,0.0,0.0,0.0,0,3,3
org.apache.camel.processor.ConvertBodyProcessor,3,5,6,0.8333333333333334,1,0.3333333333333333,277,92.33333333333333,1,0.16666666666666666,0.0,0.0,0.16728380890314076,5.1776406338268665e-06,2,2,4
org.apache.camel.processor.DeadLetterChannel,12,28,132,0.21212121212121213,1,0.08333333333333333,279,23.25,104,0.7878787878787878,0.08181818181818182,0.006818181818181818,0.0006257822277847309,0.00010893391316478098,1,11,12
org.apache.camel.processor.Delayer,5,9,20,0.45,1,0.2,277,55.4,11,0.55,0.08333333333333333,0.016666666666666666,0.1374601152575241,0.0007171809157188501,2,4,6
org.apache.camel.processor.DelayProcessorSupport,5,9,20,0.45,1,0.2,277,55.4,11,0.55,0.08333333333333333,0.016666666666666666,0.11657401002784157,0.00047994923731893005,2,4,6
org.apache.camel.processor.DelegateAsyncProcessor,5,7,20,0.35,1,0.2,278,55.6,13,0.65,0.0,0.0,0.08607887691329373,9.46225757119618e-05,3,4,7
org.apache.camel.processor.DelegateProcessor,5,7,20,0.35,1,0.2,277,55.4,13,0.65,0.0,0.0,0.1963261368377138,0.00030351186176409977,5,4,9
org.apache.camel.processor.ErrorHandler,1,0,0,0,1,1.0,-1,-1.0,0,0,0.0,0.0,0.11159190210595822,0.0,1,0,1
org.apache.camel.processor.ErrorHandlerSupport,7,13,42,0.30952380952380953,1,0.14285714285714285,277,39.57142857142857,29,0.6904761904761905,0.0,0.0,0.13044488286532663,0.0014593067272606426,6,6,12
org.apache.camel.processor.exceptionpolicy.DefaultExceptionPolicyStrategy,4,7,12,0.5833333333333334,1,0.25,277,69.25,5,0.4166666666666667,0.0,0.0,0.11156921815986799,0.00010432969201483068,2,3,5
org.apache.camel.processor.exceptionpolicy.ExceptionPolicyStrategy,3,4,6,0.6666666666666666,1,0.3333333333333333,277,92.33333333333333,2,0.3333333333333333,0.0,0.0,0.11845375853895582,6.563464192482306e-07,5,2,7
org.apache.camel.processor.FilterProcessor,4,5,12,0.4166666666666667,1,0.25,277,69.25,7,0.5833333333333334,0.0,0.0,0.15769807340311293,5.391381675371601e-06,6,3,9
org.apache.camel.processor.HandleFaultProcessor,2,2,2,1.0,1,0.5,277,138.5,0,0.0,0.0,0.0,0.13729827847723564,3.8531779836463286e-06,1,1,2
org.apache.camel.processor.idempotent.IdempotentConsumer,9,13,72,0.18055555555555555,1,0.1111111111111111,277,30.77777777777778,59,0.8194444444444444,0.0,0.0,0.1374398647985881,0.0007201799994410984,2,8,10
org.apache.camel.processor.idempotent.jpa.JpaMessageIdRepository,3,3,6,0.5,1,0.3333333333333333,1,0.3333333333333333,3,0.5,0.0,0.0,0.0,0.0,1,3,4
org.apache.camel.processor.idempotent.jpa.MessageProcessed,1,0,0,0,1,1.0,-1,-1.0,0,0,0.0,0.0,0.0006257822277847309,0.0,1,0,1
org.apache.camel.processor.idempotent.MemoryMessageIdRepository,3,2,6,0.3333333333333333,1,0.3333333333333333,1,0.3333333333333333,4,0.6666666666666666,0.0,0.0,0.0008343763037129745,1.175545825519219e-06,1,2,3
org.apache.camel.processor.idempotent.MessageIdRepository,1,0,0,0,1,1.0,-1,-1.0,0,0,0.0,0.0,0.16816715962217346,0.0,5,0,5
org.apache.camel.processor.idempotent.NoMessageIdException,4,4,12,0.3333333333333333,1,0.25,277,69.25,8,0.6666666666666666,0.0,0.0,0.11657401002784157,6.530810141773438e-07,1,3,4
org.apache.camel.processor.Interceptor,5,7,20,0.35,1,0.2,277,55.4,13,0.65,0.0,0.0,0.1600517759912191,4.6537786728105946e-05,4,4,8
org.apache.camel.processor.interceptor.Breakpoint,2,2,2,1.0,1,0.5,278,139.0,0,0.0,0.0,0.0,0.00341152246760063,4.667810617120173e-07,2,1,3
org.apache.camel.processor.interceptor.Debugger,12,31,132,0.23484848484848486,1,0.08333333333333333,281,23.416666666666668,101,0.7651515151515151,0.0,0.0,0.0031680225281602,0.000121297774003415,3,12,15
org.apache.camel.processor.interceptor.DebugInterceptor,6,11,30,0.36666666666666664,1,0.16666666666666666,280,46.666666666666664,19,0.6333333333333333,0.15000000000000002,0.025000000000000005,0.0032183086000357585,0.00020877350134371756,3,5,8
org.apache.camel.processor.interceptor.ExceptionEvent,3,5,6,0.8333333333333334,1,0.3333333333333333,280,93.33333333333333,1,0.16666666666666666,0.0,0.0,0.003107332441413836,4.667810617120173e-07,2,2,4
org.apache.camel.processor.interceptor.ExchangeFormatter,2,2,2,1.0,1,0.5,277,138.5,0,0.0,0.0,0.0,0.12327455103763427,0.0,4,1,5
org.apache.camel.processor.interceptor.StreamCachingInterceptor,5,7,20,0.35,1,0.2,277,55.4,13,0.65,0.0,0.0,0.17662661913154412,0.000297359264021698,4,4,8
org.apache.camel.processor.interceptor.TraceFormatter,5,10,20,0.5,1,0.2,277,55.4,10,0.5,0.125,0.025,0.13605684734618873,6.033969348669522e-06,3,4,7
org.apache.camel.processor.interceptor.TraceInterceptor,8,16,56,0.2857142857142857,1,0.125,277,34.625,40,0.7142857142857143,0.11904761904761904,0.01488095238095238,0.13605684734618873,0.001228092380193082,3,7,10
org.apache.camel.processor.interceptor.Tracer,7,16,42,0.38095238095238093,1,0.14285714285714285,277,39.57142857142857,26,0.6190476190476191,0.0,0.0,0.1651809139966034,0.00382844134102944,2,6,8
org.apache.camel.processor.loadbalancer.LoadBalancer,2,1,2,0.5,1,0.5,277,138.5,1,0.5,0.0,0.0,0.14069398314776294,6.857350648862111e-07,11,1,12
org.apache.camel.processor.loadbalancer.LoadBalancerConsumer,3,2,6,0.3333333333333333,1,0.3333333333333333,278,92.66666666666667,4,0.6666666666666666,0.0,0.0,0.0023558860340131046,2.2988451699042506e-06,2,2,4
org.apache.camel.processor.loadbalancer.LoadBalancerSupport,5,6,20,0.3,1,0.2,277,55.4,14,0.7,0.0,0.0,0.11857419957458261,2.277293496436398e-05,2,4,6
org.apache.camel.processor.loadbalancer.QueueLoadBalancer,4,6,12,0.5,1,0.25,277,69.25,6,0.5,0.0,0.0,0.11738069983050026,1.76789030537807e-05,3,3,6
org.apache.camel.processor.loadbalancer.RandomLoadBalancer,4,7,12,0.5833333333333334,1,0.25,277,69.25,5,0.4166666666666667,0.0,0.0,0.1374601152575241,0.00016012535747011075,2,3,5
org.apache.camel.processor.loadbalancer.RoundRobinLoadBalancer,4,7,12,0.5833333333333334,1,0.25,277,69.25,5,0.4166666666666667,0.0,0.0,0.13835708175186356,0.00017637401310284298,5,3,8
org.apache.camel.processor.loadbalancer.StickyLoadBalancer,6,12,30,0.4,1,0.16666666666666666,277,46.166666666666664,18,0.6,0.0,0.0,0.13729827847723564,0.0001578885549965534,1,5,6
org.apache.camel.processor.loadbalancer.TopicLoadBalancer,4,6,12,0.5,1,0.25,277,69.25,6,0.5,0.0,0.0,0.13905825044758027,0.0004809024246086698,4,3,7
org.apache.camel.processor.Logger,5,9,20,0.45,1,0.2,277,55.4,11,0.55,0.0,0.0,0.13088409122514255,0.0016505806282064645,23,4,27
org.apache.camel.processor.LoggingErrorHandler,6,8,30,0.26666666666666666,1,0.16666666666666666,278,46.333333333333336,22,0.7333333333333333,0.0,0.0,0.06505060351827409,2.3837457017473048e-06,1,5,6
org.apache.camel.processor.LoggingLevel,1,0,0,0,1,1.0,-1,-1.0,0,0,0.0,0.0,0.13699905999637796,0.0,8,0,8
org.apache.camel.processor.MarshalProcessor,3,4,6,0.6666666666666666,1,0.3333333333333333,277,92.33333333333333,2,0.3333333333333333,0.0,0.0,0.13727807566992586,6.857350648862111e-07,1,2,3
org.apache.camel.processor.MulticastProcessor,7,12,42,0.2857142857142857,1,0.14285714285714285,277,39.57142857142857,30,0.7142857142857143,0.13333333333333333,0.019047619047619046,0.11691000028230777,0.0004845991741398727,3,6,9
org.apache.camel.processor.Pipeline,6,11,30,0.36666666666666664,1,0.16666666666666666,278,46.333333333333336,19,0.6333333333333333,0.0,0.0,0.0,0.0,0,5,5
org.apache.camel.processor.ProceedProcessor,3,4,6,0.6666666666666666,1,0.3333333333333333,277,92.33333333333333,2,0.3333333333333333,0.0,0.0,0.13597752547045855,3.1347888680512505e-07,1,2,3
org.apache.camel.processor.RecipientList,6,10,30,0.3333333333333333,1,0.16666666666666666,277,46.166666666666664,20,0.6666666666666666,0.0,0.0,0.145295406050898,0.0011009246369493623,3,5,8
org.apache.camel.processor.RedeliveryPolicy,1,1,0,0,1,1.0,-1,-1.0,-1,0,0.0,0.0,0.15902151304489087,0.0,8,1,9
org.apache.camel.processor.Resequencer,5,5,20,0.25,1,0.2,277,55.4,15,0.75,0.0,0.0,0.1374196203053198,0.0014482576849691193,2,4,6
org.apache.camel.processor.resequencer.DefaultExchangeComparator,4,4,12,0.3333333333333333,1,0.25,277,69.25,8,0.6666666666666666,0.0,0.0,0.11661772528160201,0.00010815021594776816,1,3,4
org.apache.camel.processor.resequencer.Element,3,4,6,0.6666666666666666,1,0.3333333333333333,1,0.3333333333333333,2,0.3333333333333333,0.0,0.0,0.1297672537887429,0.0006773479832262971,19,2,21
org.apache.camel.processor.resequencer.ElementComparator,3,2,6,0.3333333333333333,1,0.3333333333333333,3,1.0,4,0.6666666666666666,0.0,0.0,0.1013645901865094,0.0,1,2,3
org.apache.camel.processor.resequencer.ExpressionResultComparator,1,0,0,0,1,1.0,-1,-1.0,0,0,0.0,0.0,0.13772595257705145,0.0,3,0,3
org.apache.camel.processor.resequencer.ResequencerEngine,7,13,42,0.30952380952380953,1,0.14285714285714285,5,0.7142857142857143,29,0.6904761904761905,0.0,0.0,0.11664843193550044,0.0012506777868280562,1,6,7
org.apache.camel.processor.resequencer.Sequence,2,1,2,0.5,1,0.5,0,0.0,1,0.5,0.0,0.0,0.1013645901865094,0.0,1,1,2
org.apache.camel.processor.resequencer.SequenceElementComparator,1,0,0,0,1,1.0,-1,-1.0,0,0,0.0,0.0,0.11717799545413798,0.0,4,0,4
org.apache.camel.processor.resequencer.SequenceSender,3,4,6,0.6666666666666666,1,0.3333333333333333,277,92.33333333333333,2,0.3333333333333333,0.0,0.0,0.1165594455588226,0.0,1,2,3
org.apache.camel.processor.resequencer.Timeout,2,2,2,1.0,1,0.5,0,0.0,0,0.0,0.0,0.0,0.1115480073501073,0.0,3,1,4
org.apache.camel.processor.resequencer.TimeoutHandler,2,2,2,1.0,1,0.5,0,0.0,0,0.0,0.0,0.0,0.1115480073501073,0.0,3,1,4
org.apache.camel.processor.RoutingSlip,8,15,56,0.26785714285714285,1,0.125,277,34.625,41,0.7321428571428571,0.14285714285714285,0.017857142857142856,0.1373589225931708,0.0003238652222426883,1,7,8
org.apache.camel.processor.SendProcessor,5,7,20,0.35,1,0.2,277,55.4,13,0.65,0.0,0.0,0.15656012791623025,0.00013754072753150259,4,4,8
org.apache.camel.processor.SetHeaderProcessor,3,3,6,0.5,1,0.3333333333333333,277,92.33333333333333,3,0.5,0.0,0.0,0.13729827847723564,6.204269634684767e-07,1,2,3
org.apache.camel.processor.Splitter,8,13,56,0.23214285714285715,1,0.125,277,34.625,43,0.7678571428571429,0.0,0.0,0.13766294853959216,0.002119720995244791,3,7,10
org.apache.camel.processor.StreamResequencer,6,10,30,0.3333333333333333,1,0.16666666666666666,277,46.166666666666664,20,0.6666666666666666,0.0,0.0,0.1374196203053198,0.0026855261636213206,2,5,7
org.apache.camel.processor.ThreadProcessor,4,7,12,0.5833333333333334,1,0.25,279,69.75,5,0.4166666666666667,0.16666666666666666,0.041666666666666664,0.0006257822277847309,3.918486085064063e-07,1,3,4
org.apache.camel.processor.Throttler,4,7,12,0.5833333333333334,1,0.25,277,69.25,5,0.4166666666666667,0.0,0.0,0.13725787880724083,0.00047865613691085884,1,3,4
org.apache.camel.processor.ThroughputLogger,4,6,12,0.5,1,0.25,278,69.5,6,0.5,0.0,0.0,0.0018773466833541927,1.8931993278840426e-05,3,3,6
org.apache.camel.processor.ThrowFaultProcessor,2,2,2,1.0,1,0.5,277,138.5,0,0.0,0.0,0.0,0.13725787880724083,8.62066938714094e-07,1,1,2
org.apache.camel.processor.TransformProcessor,3,3,6,0.5,1,0.3333333333333333,277,92.33333333333333,3,0.5,0.0,0.0,0.13729827847723564,6.204269634684767e-07,1,2,3
org.apache.camel.processor.TryProcessor,8,12,56,0.21428571428571427,1,0.125,277,34.625,44,0.7857142857142857,0.0,0.0,0.13725787880724083,0.0026365155410502782,1,7,8
org.apache.camel.processor.UnitOfWorkProcessor,5,9,20,0.45,1,0.2,281,56.2,11,0.55,0.0,0.0,0.0,0.0,0,4,4
org.apache.camel.processor.UnmarshalProcessor,3,4,6,0.6666666666666666,1,0.3333333333333333,277,92.33333333333333,2,0.3333333333333333,0.0,0.0,0.13727807566992586,6.857350648862111e-07,1,2,3
org.apache.camel.processor.validation.DefaultValidationErrorHandler,4,6,12,0.5,1,0.25,281,70.25,6,0.5,0.0,0.0,0.0023587176278039856,6.596118243191172e-06,2,3,5
org.apache.camel.processor.validation.NoXmlBodyValidationException,3,4,6,0.6666666666666666,1,0.3333333333333333,279,93.0,2,0.3333333333333333,0.0,0.0,0.0012515644555694619,4.3103346935704695e-06,1,2,3
org.apache.camel.processor.validation.SchemaValidationException,3,4,6,0.6666666666666666,1,0.3333333333333333,279,93.0,2,0.3333333333333333,0.0,0.0,0.0019071458370582275,3.8531779836463286e-06,1,2,3
org.apache.camel.processor.validation.ValidatingProcessor,5,9,20,0.45,1,0.2,283,56.6,11,0.55,0.0,0.0,0.0014080100125156445,0.00017045414470028678,2,4,6
org.apache.camel.processor.validation.ValidatorErrorHandler,2,2,2,1.0,1,0.5,278,139.0,0,0.0,0.0,0.0,0.0023558860340131046,0.0,2,1,3
org.apache.camel.Producer,3,5,6,0.8333333333333334,1,0.3333333333333333,277,92.33333333333333,1,0.16666666666666666,0.0,0.0,0.23708813271990242,0.00025039685867285803,47,2,49
org.apache.camel.ProducerTemplate,4,6,12,0.5,1,0.25,277,69.25,6,0.5,0.0,0.0,0.2788230132255876,0.001943787895869621,60,3,63
org.apache.camel.Properties,1,0,0,0,1,1.0,-1,-1.0,0,0,0.0,0.0,0.14629368162307826,0.0,14,0,14
org.apache.camel.Property,1,0,0,0,1,1.0,-1,-1.0,0,0,0.0,0.0,0.10319940234514566,0.0,1,0,1
org.apache.camel.ResolveEndpointFailedException,2,1,2,0.5,1,0.5,0,0.0,1,0.5,0.0,0.0,0.16692936552970597,7.44512356162172e-06,7,1,8
org.apache.camel.Route,3,2,6,0.3333333333333333,1,0.3333333333333333,277,92.33333333333333,4,0.6666666666666666,0.0,0.0,0.17910190098921405,0.0002456030905161879,15,2,17
org.apache.camel.Routes,2,2,2,1.0,1,0.5,277,138.5,0,0.0,0.0,0.0,0.2697923083437872,0.0,3,1,4
org.apache.camel.RuntimeCamelException,1,0,0,0,1,1.0,-1,-1.0,0,0,0.0,0.0,0.22197695070863926,0.0,56,0,56
org.apache.camel.RuntimeExchangeException,3,3,6,0.5,1,0.3333333333333333,278,92.66666666666667,3,0.5,0.0,0.0,0.009123904881101378,2.547015955291641e-06,3,2,5
org.apache.camel.RuntimeExpressionException,2,1,2,0.5,1,0.5,0,0.0,1,0.5,0.0,0.0,0.09380947717566711,3.918486085064063e-06,5,1,6
org.apache.camel.RuntimeTransformException,2,1,2,0.5,1,0.5,0,0.0,1,0.5,0.0,0.0,0.0008343763037129745,3.918486085064063e-07,1,1,2
org.apache.camel.Service,1,0,0,0,1,1.0,-1,-1.0,0,0,0.0,0.0,0.17819808806781126,0.0,13,0,13
org.apache.camel.spi.BrowsableEndpoint,1,0,0,0,1,1.0,-1,-1.0,0,0,0.0,0.0,0.08768650801439073,0.0,5,0,5
org.apache.camel.spi.ComponentResolver,3,4,6,0.6666666666666666,1,0.3333333333333333,277,92.33333333333333,2,0.3333333333333333,0.0,0.0,0.16547389185044628,0.0,3,2,5
org.apache.camel.spi.DataFormat,2,2,2,1.0,1,0.5,277,138.5,0,0.0,0.0,0.0,0.17052491359035205,0.00016801279390395564,19,1,20
org.apache.camel.spi.ErrorHandlerWrappingStrategy,3,4,6,0.6666666666666666,1,0.3333333333333333,277,92.33333333333333,2,0.3333333333333333,0.0,0.0,0.170369211514393,0.0,4,2,6
org.apache.camel.spi.ExceptionHandler,1,0,0,0,1,1.0,-1,-1.0,0,0,0.0,0.0,0.10754639063589527,0.0,5,0,5
org.apache.camel.spi.ExchangeConverter,2,2,2,1.0,1,0.5,277,138.5,0,0.0,0.0,0.0,0.2518061544542014,3.953116988664215e-05,4,1,5
org.apache.camel.spi.Injector,1,0,0,0,1,1.0,-1,-1.0,0,0,0.0,0.0,0.26252082684131706,0.0,20,0,20
org.apache.camel.spi.InstrumentationAgent,1,0,0,0,1,1.0,-1,-1.0,0,0,0.0,0.0,0.1362644672852275,0.0,3,0,3
org.apache.camel.spi.InterceptStrategy,3,5,6,0.8333333333333334,1,0.3333333333333333,277,92.33333333333333,1,0.16666666666666666,0.0,0.0,0.25871930178946645,0.059681846986787024,8,2,10
org.apache.camel.spi.Language,3,2,6,0.3333333333333333,1,0.3333333333333333,1,0.3333333333333333,4,0.6666666666666666,0.0,0.0,0.27791194305103933,0.0005064295503878629,20,2,22
org.apache.camel.spi.LanguageResolver,3,3,6,0.5,1,0.3333333333333333,277,92.33333333333333,3,0.5,0.0,0.0,0.165356576081676,0.0,3,2,5
org.apache.camel.spi.LifecycleStrategy,3,4,6,0.6666666666666666,1,0.3333333333333333,277,92.33333333333333,2,0.3333333333333333,0.5,0.16666666666666666,0.25207830377001245,0.001679426931084416,8,2,10
org.apache.camel.spi.NamespaceAware,1,0,0,0,1,1.0,-1,-1.0,0,0,0.0,0.0,0.12390794622481172,0.0,6,0,6
org.apache.camel.spi.Policy,2,1,2,0.5,1,0.5,277,138.5,1,0.5,0.0,0.0,0.16749403990176231,0.0,3,1,4
org.apache.camel.spi.Registry,1,0,0,0,1,1.0,-1,-1.0,0,0,0.0,0.0,0.2566471160398623,0.0,16,0,16
org.apache.camel.spi.RouteContext,10,34,90,0.37777777777777777,1,0.1,277,27.7,56,0.6222222222222222,0.29398148148148145,0.029398148148148145,0.21802799772208833,0.008489403865782712,69,9,78
org.apache.camel.spi.Synchronization,2,2,2,1.0,1,0.5,277,138.5,0,0.0,0.0,0.0,0.18931448909350976,1.04492962268375e-06,3,1,4
org.apache.camel.spi.TypeConverterAware,2,1,2,0.5,1,0.5,0,0.0,1,0.5,0.0,0.0,0.13702186539621455,0.0,2,1,3
org.apache.camel.spi.UnitOfWork,3,5,6,0.8333333333333334,1,0.3333333333333333,277,92.33333333333333,1,0.16666666666666666,0.5,0.16666666666666666,0.25099322094506754,0.0004764879079437901,3,2,5
org.apache.camel.spring.CamelBeanPostProcessor,13,24,156,0.15384615384615385,1,0.07692307692307693,287,22.076923076923077,132,0.8461538461538461,0.0,0.0,0.0,0.0,0,12,12
org.apache.camel.spring.CamelContextFactoryBean,22,59,462,0.1277056277056277,1,0.045454545454545456,307,13.954545454545455,403,0.8722943722943723,0.0,0.0,0.0025031289111389237,0.0002038717586800154,4,21,25
org.apache.camel.spring.CamelJMXAgentType,2,1,2,0.5,1,0.5,0,0.0,1,0.5,0.0,0.0,0.001955569461827284,0.0,2,1,3
org.apache.camel.spring.CamelProxyFactoryType,2,1,2,0.5,1,0.5,0,0.0,1,0.5,0.0,0.0,0.001738283966068697,0.0,1,1,2
org.apache.camel.spring.CamelServiceExporterType,2,1,2,0.5,1,0.5,0,0.0,1,0.5,0.0,0.0,0.001738283966068697,0.0,1,1,2
org.apache.camel.spring.CamelTemplateFactoryBean,4,4,12,0.3333333333333333,1,0.25,278,69.5,8,0.6666666666666666,0.0,0.0,0.001955569461827284,9.970272285486277e-07,2,3,5
org.apache.camel.spring.EndpointFactoryBean,6,8,30,0.26666666666666666,1,0.16666666666666666,278,46.333333333333336,22,0.7333333333333333,0.0,0.0,0.0011264080100125155,1.3935407014420153e-06,1,5,6
org.apache.camel.spring.factory.BeanEndpointFactory,2,1,2,0.5,1,0.5,287,143.5,1,0.5,0.0,0.0,0.0,0.0,0,1,1
org.apache.camel.spring.handler.BeanDefinitionParser,2,1,2,0.5,1,0.5,2,1.0,1,0.5,0.0,0.0,0.0022349365278026105,1.175545825519219e-06,3,1,4
org.apache.camel.spring.handler.CamelNamespaceHandler,26,52,650,0.08,1,0.038461538461538464,323,12.423076923076923,598,0.92,0.03166666666666667,0.001217948717948718,0.0012515644555694619,5.4210070438480546e-05,2,25,27
org.apache.camel.spring.handler.LazyLoadingBeanDefinitionParser,2,1,2,0.5,1,0.5,3,1.5,1,0.5,0.0,0.0,0.001112501738283966,3.918486085064063e-07,1,1,2
org.apache.camel.spring.handler.ScriptDefinitionParser,3,2,6,0.3333333333333333,1,0.3333333333333333,4,1.3333333333333333,4,0.6666666666666666,0.0,0.0,0.0011264080100125155,1.175545825519219e-06,1,2,3
org.apache.camel.spring.Main,12,33,132,0.25,1,0.08333333333333333,305,25.416666666666668,99,0.75,0.0,0.0,0.0018773466833541927,0.0002959392663872914,3,11,14
org.apache.camel.spring.remoting.CamelProxyFactoryBean,5,8,20,0.4,1,0.2,286,57.2,12,0.6,0.0,0.0,0.0011264080100125155,1.0471366798507093e-05,1,4,5
org.apache.camel.spring.remoting.CamelServiceExporter,7,13,42,0.30952380952380953,1,0.14285714285714285,278,39.714285714285715,29,0.6904761904761905,0.0,0.0,0.0011264080100125155,1.7688368705176657e-05,1,6,7
org.apache.camel.spring.remoting.SendBeforeInterceptor,6,7,30,0.23333333333333334,1,0.16666666666666666,285,47.5,23,0.7666666666666667,0.0,0.0,0.0,0.0,0,5,5
org.apache.camel.spring.RouteBuilderFinder,6,11,30,0.36666666666666664,1,0.16666666666666666,297,49.5,19,0.6333333333333333,0.0,0.0,0.001738283966068697,1.0136608953382893e-05,1,5,6
org.apache.camel.spring.spi.ApplicationContextRegistry,2,1,2,0.5,1,0.5,0,0.0,1,0.5,0.0,0.0,0.006208157021673918,0.0,1,1,2
org.apache.camel.spring.spi.SpringConverters,4,3,12,0.25,1,0.25,278,69.5,9,0.75,0.0,0.0,0.0,0.0,0,3,3
org.apache.camel.spring.spi.SpringInjector,2,1,2,0.5,1,0.5,0,0.0,1,0.5,0.0,0.0,0.006208157021673918,0.0,1,1,2
org.apache.camel.spring.spi.SpringTransactionPolicy,2,1,2,0.5,1,0.5,278,139.0,1,0.5,0.0,0.0,0.0008343763037129745,2.612324056709375e-07,1,1,2
org.apache.camel.spring.spi.TransactionErrorHandlerBuilder,6,12,30,0.4,1,0.16666666666666666,278,46.333333333333336,18,0.6,0.0,0.0,0.0008343763037129745,0.00020526336275593918,2,6,8
org.apache.camel.spring.spi.TransactionInterceptor,6,10,30,0.3333333333333333,1,0.16666666666666666,280,46.666666666666664,20,0.6666666666666666,0.0,0.0,0.0008343763037129745,6.8573506488621105e-06,1,5,6
org.apache.camel.spring.SpringCamelContext,12,22,132,0.16666666666666666,1,0.08333333333333333,284,23.666666666666668,110,0.8333333333333334,0.0,0.0,0.009485541136947499,0.0006990957702228921,13,12,25
org.apache.camel.spring.SpringRouteBuilder,4,4,12,0.3333333333333333,1,0.25,283,70.75,8,0.6666666666666666,0.0,0.0,0.0006257822277847309,0.00010344803264569125,1,3,4
org.apache.camel.spring.util.SimpleRouteBuilder,2,2,2,1.0,1,0.5,278,139.0,0,0.0,0.0,0.0,0.0012515644555694619,0.00021630043189553623,2,1,3
org.apache.camel.TypeConverter,1,0,0,0,1,1.0,-1,-1.0,0,0,0.0,0.0,0.2668728543265194,0.0,29,0,29
org.apache.camel.util.AsyncProcessorHelper,2,1,2,0.5,1,0.5,278,139.0,1,0.5,0.0,0.0,0.0,0.0,0,1,1
org.apache.camel.util.CamelContextHelper,9,15,72,0.20833333333333334,1,0.1111111111111111,277,30.77777777777778,57,0.7916666666666666,0.0,0.0,0.1870372498502037,0.000533731758896337,18,8,26
org.apache.camel.util.CollectionHelper,1,0,0,0,1,1.0,-1,-1.0,0,0,0.0,0.0,0.11738105617828087,0.0,2,0,2
org.apache.camel.util.CollectionStringBuffer,1,0,0,0,1,1.0,-1,-1.0,0,0,0.0,0.0,0.16392151814660288,0.0,6,0,6
org.apache.camel.util.DefaultTimeoutMap,3,3,6,0.5,1,0.3333333333333333,1,0.3333333333333333,3,0.5,0.0,0.0,0.00794158165332565,1.6457641557269066e-05,1,2,3
org.apache.camel.util.EndpointHelper,3,3,6,0.5,1,0.3333333333333333,278,92.66666666666667,3,0.5,0.0,0.0,0.0006257822277847309,1.9592430425320315e-07,1,2,3
org.apache.camel.util.ExchangeHelper,10,19,90,0.2111111111111111,1,0.1,277,27.7,71,0.7888888888888889,0.0,0.0,0.11766197531250044,0.0022257112561073584,4,9,13
org.apache.camel.util.ExpressionComparator,1,0,0,0,1,1.0,-1,-1.0,0,0,0.0,0.0,0.13924461156836448,0.0,2,0,2
org.apache.camel.util.ExpressionHelper,1,0,0,0,1,1.0,-1,-1.0,0,0,0.0,0.0,0.11692574927869044,0.0,2,0,2
org.apache.camel.util.ExpressionListComparator,2,2,2,1.0,1,0.5,277,138.5,0,0.0,0.0,0.0,0.1165594455588226,5.22464811341875e-07,1,1,2
org.apache.camel.util.FactoryFinder,4,3,12,0.25,1,0.25,2,0.5,9,0.75,0.0,0.0,0.1680280527224038,0.0004396737311746133,5,3,8
org.apache.camel.util.IntrospectionSupport,2,1,2,0.5,1,0.5,0,0.0,1,0.5,0.0,0.0,0.15331756084219814,2.523311267491338e-05,15,1,16
org.apache.camel.util.IOHelper,1,0,0,0,1,1.0,-1,-1.0,0,0,0.0,0.0,0.10346219976032926,0.0,2,0,2
org.apache.camel.util.jndi.CamelInitialContextFactory,2,2,2,1.0,1,0.5,7,3.5,0,0.0,0.0,0.0,0.0006257822277847309,1.9592430425320314e-06,1,1,2
org.apache.camel.util.jndi.JndiContext,6,7,30,0.23333333333333334,1,0.16666666666666666,6,1.0,23,0.7666666666666667,0.0,0.0,0.023832607660984682,0.00012290984686817607,34,6,40
org.apache.camel.util.LRUCache,1,0,0,0,1,1.0,-1,-1.0,0,0,0.0,0.0,0.0009386733416770963,0.0,1,0,1
org.apache.camel.util.NoFactoryAvailableException,1,0,0,0,1,1.0,-1,-1.0,0,0,0.0,0.0,0.16785300373243145,0.0,5,0,5
org.apache.camel.util.ObjectHelper,2,1,2,0.5,1,0.5,0,0.0,1,0.5,0.0,0.0,0.0,0.0,0,1,1
org.apache.camel.util.PackageHelper,1,0,0,0,1,1.0,-1,-1.0,0,0,0.0,0.0,0.008116763601560774,0.0,1,0,1
org.apache.camel.util.ReflectionInjector,2,1,2,0.5,1,0.5,0,0.0,1,0.5,0.0,0.0,0.1686141505117528,7.836972170128126e-07,7,1,8
org.apache.camel.util.ResolverUtil,5,8,20,0.4,1,0.2,3,0.6,12,0.6,0.16666666666666666,0.03333333333333333,0.11714692699865953,0.0019302462455025576,4,4,8
org.apache.camel.util.ServiceHelper,1,0,0,0,1,1.0,-1,-1.0,0,0,0.0,0.0,0.1852769501700134,0.0,24,0,24
org.apache.camel.util.SystemHelper,2,1,2,0.5,1,0.5,1,0.5,1,0.5,0.0,0.0,0.16524678837052062,0.0005296439375943874,1,1,2
org.apache.camel.util.Time,1,1,0,0,1,1.0,-1,-1.0,-1,0,0.0,0.0,0.0028734898214604994,0.0,2,1,3
org.apache.camel.util.TimeoutMap,1,0,0,0,1,1.0,-1,-1.0,0,0,0.0,0.0,0.00883260564254937,0.0,4,0,4
org.apache.camel.util.TimeoutMapEntry,1,1,0,0,1,1.0,-1,-1.0,-1,0,0.0,0.0,0.006357534830626195,0.0,2,1,3
org.apache.camel.util.UnsafeUriCharactersEncoder,1,0,0,0,1,1.0,-1,-1.0,0,0,0.0,0.0,0.0038255366377783545,0.0,3,0,3
org.apache.camel.util.URISupport,2,2,2,1.0,1,0.5,0,0.0,0,0.0,0.0,0.0,0.0038255366377783545,6.6614263446089076e-06,3,1,4
org.apache.camel.util.UuidGenerator,1,0,0,0,1,1.0,-1,-1.0,0,0,0.0,0.0,0.039107862283571056,0.0,9,0,9
org.apache.camel.util.ValueHolder,1,0,0,0,1,1.0,-1,-1.0,0,0,0.0,0.0,0.006856396582684878,0.0,1,0,1
org.apache.camel.util.WebSphereResolverUtil,2,1,2,0.5,1,0.5,4,2.0,1,0.5,0.0,0.0,0.11662305154169986,0.0,1,1,2
org.apache.camel.ValidationException,3,4,6,0.6666666666666666,1,0.3333333333333333,278,92.66666666666667,2,0.3333333333333333,0.0,0.0,0.0027042731986411587,7.379815460203985e-06,3,2,5
org.apache.camel.view.GraphGeneratorSupport,11,32,110,0.2909090909090909,1,0.09090909090909091,280,25.454545454545453,78,0.7090909090909091,0.03888888888888889,0.0035353535353535356,0.0036409147798384346,0.0002869873312369494,5,10,15
org.apache.camel.view.NodeData,10,13,90,0.14444444444444443,1,0.1,278,27.8,77,0.8555555555555555,0.0,0.0,0.003293590672551215,0.000154612174474403,4,9,13
org.apache.camel.view.RouteDotGenerator,6,14,30,0.4666666666666667,1,0.16666666666666666,280,46.666666666666664,16,0.5333333333333333,0.0,0.0,0.0030807740444786756,1.3152525619292218e-05,3,5,8
org.apache.camel.view.XmlGraphGenerator,6,13,30,0.43333333333333335,1,0.16666666666666666,281,46.833333333333336,17,0.5666666666666667,0.0,0.0,0.0006257822277847309,1.198558612804504e-05,1,5,6
