name,Size,Ties,Pairs,Density,WeakComp,nWeakComp,2StepReach,ReachEffic,Broker,nBroker,EgoBetween,nEgoBetween,Closeness_Centrality,Betweenness_Centrality,in_degree,out_degree,degree
org.apache.velocity.runtime.log.JdkLogChute,3,3,6,0.5,1,0.3333333333333333,125,41.666666666666664,3,0.5,0.0,0.0,0.0,0.0,0,2,2
org.apache.velocity.util.introspection.IntrospectorBase,8,18,56,0.32142857142857145,1,0.125,124,15.5,38,0.6785714285714286,0.0,0.0,0.17823936354202696,0.012762996316004914,1,7,8
org.apache.velocity.runtime.parser.node.ASTIfStatement,8,17,56,0.30357142857142855,1,0.125,124,15.5,39,0.6964285714285714,0.11904761904761904,0.01488095238095238,0.18899321474417752,3.443649118376725e-05,4,7,11
org.apache.velocity.runtime.directive.Include,14,27,182,0.14835164835164835,1,0.07142857142857142,126,9.0,155,0.8516483516483516,0.0,0.0,0.0,0.0,0,13,13
org.apache.velocity.app.event.implement.ReportInvalidReferences,8,11,56,0.19642857142857142,1,0.125,126,15.75,45,0.8035714285714286,0.0,0.0,0.002857142857142857,0.00010788570810000588,1,7,8
org.apache.velocity.runtime.parser.node.ASTFloatingPointLiteral,7,17,42,0.40476190476190477,1,0.14285714285714285,124,17.714285714285715,25,0.5952380952380952,0.11666666666666667,0.016666666666666666,0.18899321474417752,2.3843493806652946e-05,4,6,10
org.apache.velocity.runtime.resource.Resource,6,8,30,0.26666666666666666,1,0.16666666666666666,124,20.666666666666668,22,0.7333333333333333,0.1,0.016666666666666666,0.2240878451837356,0.010713071638157648,26,5,31
org.apache.velocity.anakia.AnakiaElement,3,4,6,0.6666666666666666,1,0.3333333333333333,2,0.6666666666666666,2,0.3333333333333333,0.0,0.0,0.004285714285714286,2.4559967253376996e-05,1,2,3
org.apache.velocity.app.event.implement.PrintExceptions,4,4,12,0.3333333333333333,1,0.25,125,31.25,8,0.6666666666666666,0.0,0.0,0.0,0.0,0,3,3
org.apache.velocity.app.event.implement.EscapeXmlReference,2,1,2,0.5,1,0.5,127,63.5,1,0.5,0.0,0.0,0.002857142857142857,0.0,1,1,2
org.apache.velocity.runtime.resource.loader.ClasspathResourceLoader,7,11,42,0.2619047619047619,1,0.14285714285714285,126,18.0,31,0.7380952380952381,0.0,0.0,0.0,0.0,0,6,6
org.apache.velocity.runtime.RuntimeConstants,1,0,0,0,1,1.0,-1,-1.0,0,0,0.0,0.0,0.23726152441807397,0.0,67,0,67
org.apache.velocity.anakia.Escape,1,0,0,0,1,1.0,-1,-1.0,0,0,0.0,0.0,0.0038095238095238095,0.0,1,0,1
org.apache.velocity.runtime.VelocimacroFactory,13,36,156,0.23076923076923078,1,0.07692307692307693,134,10.307692307692308,120,0.7692307692307693,0.0,0.0,0.0701601537475977,0.005669432932814473,1,12,13
org.apache.velocity.runtime.parser.node.ASTAddNode,10,19,90,0.2111111111111111,1,0.1,124,12.4,71,0.7888888888888889,0.1736111111111111,0.017361111111111112,0.18899321474417752,0.00040127348454971503,4,9,13
org.apache.velocity.runtime.directive.Macro,12,26,132,0.19696969696969696,1,0.08333333333333333,124,10.333333333333334,106,0.803030303030303,0.0,0.0,0.18659786347999274,0.0008582302853724105,2,11,13
org.apache.velocity.app.event.implement.InvalidReferenceInfo,2,1,2,0.5,1,0.5,0,0.0,1,0.5,0.0,0.0,0.005714285714285714,4.093327875562833e-06,2,1,3
org.apache.velocity.util.ContextAware,2,1,2,0.5,1,0.5,0,0.0,1,0.5,0.0,0.0,0.10731532250024922,0.0,5,1,6
org.apache.velocity.util.introspection.SecureIntrospectorImpl,4,4,12,0.3333333333333333,1,0.25,126,31.5,8,0.6666666666666666,0.0,0.0,0.0038095238095238095,4.366216400600356e-05,1,3,4
org.apache.velocity.runtime.parser.node.ASTFalse,5,11,20,0.55,1,0.2,124,24.8,9,0.45,0.16666666666666666,0.03333333333333333,0.18899321474417752,1.5627715564712997e-05,4,4,8
org.apache.velocity.runtime.resource.util.StringResourceRepository,2,1,2,0.5,1,0.5,0,0.0,1,0.5,0.0,0.0,0.011428571428571429,1.2279983626688498e-05,4,1,5
org.apache.velocity.runtime.parser.node.ASTModNode,10,19,90,0.2111111111111111,1,0.1,124,12.4,71,0.7888888888888889,0.1736111111111111,0.017361111111111112,0.18899321474417752,0.00040127348454971503,4,9,13
org.apache.velocity.runtime.parser.node.ASTLTNode,10,19,90,0.2111111111111111,1,0.1,124,12.4,71,0.7888888888888889,0.1736111111111111,0.017361111111111112,0.18899321474417752,0.00040127348454971503,4,9,13
org.apache.velocity.app.event.implement.EscapeSqlReference,2,1,2,0.5,1,0.5,127,63.5,1,0.5,0.0,0.0,0.002857142857142857,0.0,1,1,2
org.apache.velocity.runtime.log.SimpleLog4JLogSystem,4,4,12,0.3333333333333333,1,0.25,126,31.5,8,0.6666666666666666,0.0,0.0,0.0,0.0,0,3,3
org.apache.velocity.runtime.parser.node.SimpleNode,12,25,132,0.1893939393939394,1,0.08333333333333333,124,10.333333333333334,107,0.8106060606060606,0.2863636363636364,0.023863636363636365,0.2974256854256854,0.029467404537647613,61,11,72
org.apache.velocity.util.ExceptionUtils,1,0,0,0,1,1.0,-1,-1.0,0,0,0.0,0.0,0.18989430617115582,0.0,8,0,8
org.apache.velocity.runtime.parser.node.ASTExpression,6,13,30,0.43333333333333335,1,0.16666666666666666,124,20.666666666666668,17,0.5666666666666667,0.15000000000000002,0.025000000000000005,0.18923613661402863,1.8607413883583506e-05,5,5,10
org.apache.velocity.runtime.parser.node.ASTLENode,10,19,90,0.2111111111111111,1,0.1,124,12.4,71,0.7888888888888889,0.1736111111111111,0.017361111111111112,0.18899321474417752,0.00040127348454971503,4,9,13
org.apache.velocity.context.InternalEventContext,2,2,2,1.0,1,0.5,124,62.0,0,0.0,0.0,0.0,0.18380238986980563,0.0,3,1,4
org.apache.velocity.runtime.resource.loader.DataSourceResourceLoader,7,11,42,0.2619047619047619,1,0.14285714285714285,126,18.0,31,0.7380952380952381,0.0,0.0,0.002857142857142857,3.1655068904352575e-05,1,6,7
org.apache.velocity.io.VelocityWriter,1,0,0,0,1,1.0,-1,-1.0,0,0,0.0,0.0,0.005142857142857143,0.0,1,0,1
org.apache.velocity.runtime.resource.loader.ResourceLoaderFactory,6,8,30,0.26666666666666666,1,0.16666666666666666,127,21.166666666666668,22,0.7333333333333333,0.0,0.0,0.002857142857142857,0.0,1,5,6
org.apache.velocity.runtime.parser.node.ASTprocess,4,9,12,0.75,1,0.25,124,31.0,3,0.25,0.16666666666666666,0.041666666666666664,0.18899321474417752,1.4607855861612239e-05,4,3,7
org.apache.velocity.runtime.resource.loader.FileResourceLoader,7,11,42,0.2619047619047619,1,0.14285714285714285,128,18.285714285714285,31,0.7380952380952381,0.0,0.0,0.002857142857142857,3.220084595442762e-05,1,6,7
org.apache.velocity.runtime.resource.ResourceCache,3,3,6,0.5,1,0.3333333333333333,124,41.333333333333336,3,0.5,0.0,0.0,0.12724780837140387,0.0,2,2,4
org.apache.velocity.app.event.implement.EscapeJavaScriptReference,2,1,2,0.5,1,0.5,127,63.5,1,0.5,0.0,0.0,0.002857142857142857,0.0,1,1,2
org.apache.velocity.runtime.parser.node.ASTDirective,15,45,210,0.21428571428571427,1,0.06666666666666667,124,8.266666666666667,165,0.7857142857142857,0.09951159951159952,0.006634106634106634,0.19021410114433368,0.001105885012189948,5,14,19
org.apache.velocity.app.event.EventHandlerUtil,21,55,420,0.13095238095238096,1,0.047619047619047616,124,5.904761904761905,365,0.8690476190476191,0.0,0.0,0.14992435263311027,0.0194269713094928,6,20,26
org.apache.velocity.context.AbstractContext,3,2,6,0.3333333333333333,1,0.3333333333333333,124,41.333333333333336,4,0.6666666666666666,0.0,0.0,0.16542215088282503,0.004881437949264394,25,2,27
org.apache.velocity.runtime.parser.TokenMgrError,1,0,0,0,1,1.0,-1,-1.0,0,0,0.0,0.0,0.1884672057502246,0.0,2,0,2
org.apache.velocity.runtime.parser.node.MapGetExecutor,3,3,6,0.5,1,0.3333333333333333,126,42.0,3,0.5,0.0,0.0,0.005714285714285714,0.0,1,2,3
org.apache.velocity.anakia.NodeList,3,3,6,0.5,1,0.3333333333333333,1,0.3333333333333333,3,0.5,0.0,0.0,0.010285714285714285,5.730659025787966e-05,4,3,7
org.apache.velocity.runtime.log.Log4JLogChute,6,8,30,0.26666666666666666,1,0.16666666666666666,125,20.833333333333332,22,0.7333333333333333,0.0,0.0,0.005714285714285714,0.0007946513849092646,2,5,7
org.apache.velocity.util.TemplateNumber,1,0,0,0,1,1.0,-1,-1.0,0,0,0.0,0.0,0.15242261299229762,0.0,12,0,12
org.apache.velocity.runtime.parser.node.ASTGENode,10,19,90,0.2111111111111111,1,0.1,124,12.4,71,0.7888888888888889,0.1736111111111111,0.017361111111111112,0.18899321474417752,0.00040127348454971503,4,9,13
org.apache.velocity.runtime.parser.node.ASTNENode,10,19,90,0.2111111111111111,1,0.1,124,12.4,71,0.7888888888888889,0.1736111111111111,0.017361111111111112,0.18899321474417752,0.00040127348454971503,4,9,13
org.apache.velocity.runtime.parser.Parser,60,208,3540,0.05875706214689266,1,0.016666666666666666,124,2.066666666666667,3332,0.9412429378531073,0.7025618546658874,0.011709364244431456,0.2601161029782938,0.10885036824444226,48,59,107
org.apache.velocity.runtime.log.SystemLogChute,3,3,6,0.5,1,0.3333333333333333,125,41.666666666666664,3,0.5,0.0,0.0,0.053930968360498564,0.0,1,2,3
org.apache.velocity.app.VelocityEngine,13,35,156,0.22435897435897437,1,0.07692307692307693,145,11.153846153846153,121,0.7756410256410257,0.0,0.0,0.06095238095238095,0.013795864223867403,21,12,33
org.apache.velocity.util.introspection.Uberspect,5,4,20,0.2,1,0.2,3,0.6,16,0.8,0.0,0.0,0.24150522648083625,0.004832099132958732,9,4,13
org.apache.velocity.util.ClassUtils,1,0,0,0,1,1.0,-1,-1.0,0,0,0.0,0.0,0.08426065162907269,0.0,8,0,8
org.apache.velocity.runtime.log.VelocityFormatter,1,0,0,0,1,1.0,-1,-1.0,0,0,0.0,0.0,0.0038095238095238095,0.0,1,0,1
org.apache.velocity.util.introspection.VelPropertySet,1,0,0,0,1,1.0,-1,-1.0,0,0,0.0,0.0,0.1903830096206208,0.0,5,0,5
org.apache.velocity.anakia.OutputWrapper,1,0,0,0,1,1.0,-1,-1.0,0,0,0.0,0.0,0.0038095238095238095,0.0,1,0,1
org.apache.velocity.runtime.parser.node.ASTSetDirective,18,67,306,0.21895424836601307,1,0.05555555555555555,124,6.888888888888889,239,0.7810457516339869,0.08149509803921569,0.004527505446623094,0.18899321474417752,0.00560038438545747,4,17,21
org.apache.velocity.app.event.implement.EscapeHtmlReference,2,1,2,0.5,1,0.5,127,63.5,1,0.5,0.0,0.0,0.002857142857142857,0.0,1,1,2
org.apache.velocity.runtime.parser.node.ASTAndNode,8,17,56,0.30357142857142855,1,0.125,124,15.5,39,0.6964285714285714,0.15476190476190477,0.019345238095238096,0.18899321474417752,7.97611859600531e-05,4,7,11
org.apache.velocity.runtime.parser.JJTParserState,2,2,2,1.0,1,0.5,124,62.0,0,0.0,0.0,0.0,0.18659786347999274,3.976375650546752e-06,1,1,2
org.apache.velocity.runtime.parser.ParserVisitor,42,125,1722,0.07259001161440186,1,0.023809523809523808,124,2.9523809523809526,1597,0.9274099883855982,0.9734756097560976,0.023177990708478514,0.22105963105963106,0.023488518989324386,46,41,87
org.apache.velocity.context.Context,1,0,0,0,1,1.0,-1,-1.0,0,0,0.0,0.0,0.25279789335088876,0.0,44,0,44
org.apache.velocity.runtime.parser.node.ASTVariable,4,7,12,0.5833333333333334,1,0.25,125,31.25,5,0.4166666666666667,0.0,0.0,0.0,0.0,0,3,3
org.apache.velocity.exception.VelocityException,2,1,2,0.5,1,0.5,0,0.0,1,0.5,0.0,0.0,0.23790096406660824,0.0011826371427271962,10,1,11
org.apache.velocity.runtime.resource.ResourceCacheImpl,6,10,30,0.3333333333333333,1,0.16666666666666666,124,20.666666666666668,20,0.6666666666666666,0.0,0.0,0.15762924441725298,0.0018501841997544005,2,5,7
org.apache.velocity.runtime.resource.loader.StringResourceLoader,10,22,90,0.24444444444444444,1,0.1,130,13.0,68,0.7555555555555555,0.08333333333333333,0.008333333333333333,0.005714285714285714,0.001101787419838996,2,9,11
org.apache.velocity.exception.TemplateInitException,4,3,12,0.25,1,0.25,4,1.0,9,0.75,0.0,0.0,0.23243460764587526,0.0006114156260448241,19,3,22
org.apache.velocity.runtime.parser.node.ASTMulNode,10,19,90,0.2111111111111111,1,0.1,124,12.4,71,0.7888888888888889,0.1736111111111111,0.017361111111111112,0.18899321474417752,0.00040127348454971503,4,9,13
org.apache.velocity.util.introspection.Introspector,6,9,30,0.3,1,0.16666666666666666,124,20.666666666666668,21,0.7,0.0,0.0,0.24415541340914476,0.01985552501803013,12,5,17
org.apache.velocity.texen.Generator,6,11,30,0.36666666666666664,1,0.16666666666666666,146,24.333333333333332,19,0.6333333333333333,0.0,0.0,0.005714285714285714,0.0012327739118570065,3,6,9
org.apache.velocity.util.ArrayIterator,1,0,0,0,1,1.0,-1,-1.0,0,0,0.0,0.0,0.005714285714285714,0.0,1,0,1
org.apache.velocity.anakia.AnakiaJDOMFactory,2,1,2,0.5,1,0.5,3,1.5,1,0.5,0.0,0.0,0.0038095238095238095,1.637331150225133e-05,1,1,2
org.apache.velocity.context.InternalHousekeepingContext,3,2,6,0.3333333333333333,1,0.3333333333333333,124,41.333333333333336,4,0.6666666666666666,0.0,0.0,0.17823936354202696,0.0012728738532215703,31,2,33
org.apache.velocity.app.tools.VelocityFormatter,4,4,12,0.3333333333333333,1,0.25,2,0.5,8,0.6666666666666666,0.0,0.0,0.0,0.0,0,3,3
org.apache.velocity.anakia.AnakiaTask,15,25,210,0.11904761904761904,1,0.06666666666666667,156,10.4,185,0.8809523809523809,0.07142857142857144,0.004761904761904762,0.002857142857142857,0.0012771182971756038,1,14,15
org.apache.velocity.runtime.parser.node.ASTStringLiteral,15,40,210,0.19047619047619047,1,0.06666666666666667,124,8.266666666666667,170,0.8095238095238095,0.09065934065934067,0.006043956043956045,0.18899321474417752,0.00046799896292628506,4,14,18
org.apache.velocity.context.InternalContextAdapter,1,0,0,0,1,1.0,-1,-1.0,0,0,0.0,0.0,0.23086506713625354,0.0,56,0,56
org.apache.velocity.runtime.parser.node.ASTWord,4,9,12,0.75,1,0.25,124,31.0,3,0.25,0.16666666666666666,0.041666666666666664,0.18899321474417752,1.4607855861612239e-05,4,3,7
org.apache.velocity.runtime.parser.node.ASTText,9,20,72,0.2777777777777778,1,0.1111111111111111,124,13.777777777777779,52,0.7222222222222222,0.16964285714285712,0.018849206349206348,0.18899321474417752,0.0011074617681253787,4,8,12
org.apache.velocity.util.introspection.IntrospectorCacheImpl,5,8,20,0.4,1,0.2,124,24.8,12,0.6,0.0,0.0,0.1404825517993457,0.0,1,4,5
org.apache.velocity.runtime.parser.node.Node,4,5,12,0.4166666666666667,1,0.25,124,31.0,7,0.5833333333333334,0.0,0.0,0.2118355601233299,0.0028304959923871097,14,4,18
org.apache.velocity.runtime.resource.ResourceManager,3,3,6,0.5,1,0.3333333333333333,125,41.666666666666664,3,0.5,0.0,0.0,0.07334603174603174,0.00015571598093088067,3,2,5
org.apache.velocity.runtime.resource.util.StringResourceRepositoryImpl,4,7,12,0.5833333333333334,1,0.25,130,32.5,5,0.4166666666666667,0.0,0.0,0.0038095238095238095,0.0,1,3,4
org.apache.velocity.runtime.parser.node.ASTMap,6,13,30,0.43333333333333335,1,0.16666666666666666,124,20.666666666666668,17,0.5666666666666667,0.15000000000000002,0.025000000000000005,0.18899321474417752,1.8607413883583506e-05,4,5,9
org.apache.velocity.runtime.parser.node.ASTNotNode,6,13,30,0.43333333333333335,1,0.16666666666666666,124,20.666666666666668,17,0.5666666666666667,0.15000000000000002,0.025000000000000005,0.18899321474417752,1.8607413883583506e-05,4,5,9
org.apache.velocity.app.event.InvalidReferenceEventHandler,2,1,2,0.5,1,0.5,0,0.0,1,0.5,0.0,0.0,0.1949616368286445,1.1477856750063054e-05,8,1,9
org.apache.velocity.anakia.XPathCache,1,0,0,0,1,1.0,-1,-1.0,0,0,0.0,0.0,0.011666666666666667,0.0,3,0,3
org.apache.velocity.runtime.parser.node.PropertyExecutor,6,11,30,0.36666666666666664,1,0.16666666666666666,126,21.0,19,0.6333333333333333,0.0,0.0,0.007936507936507936,8.186655751125666e-06,2,5,7
org.apache.velocity.runtime.parser.node.BooleanPropertyExecutor,6,14,30,0.4666666666666667,1,0.16666666666666666,127,21.166666666666668,16,0.5333333333333333,0.0,0.0,0.005714285714285714,0.0,1,5,6
org.apache.velocity.util.introspection.IntrospectorCache,3,3,6,0.5,1,0.3333333333333333,124,41.333333333333336,3,0.5,0.0,0.0,0.14129147244310392,0.0,2,2,4
org.apache.velocity.runtime.visitor.VMReferenceMungeVisitor,4,6,12,0.5,1,0.25,126,31.5,6,0.5,0.0,0.0,0.04598639455782313,0.0007697925397475132,1,3,4
org.apache.velocity.runtime.log.Log4JLogSystem,3,2,6,0.3333333333333333,1,0.3333333333333333,127,42.333333333333336,4,0.6666666666666666,0.0,0.0,0.0,0.0,0,2,2
org.apache.velocity.runtime.parser.node.MathUtils,1,0,0,0,1,1.0,-1,-1.0,0,0,0.0,0.0,0.15165124349334874,0.0,12,0,12
org.apache.velocity.runtime.visitor.NodeViewMode,44,140,1892,0.07399577167019028,1,0.022727272727272728,126,2.8636363636363638,1752,0.9260042283298098,0.0,0.0,0.002857142857142857,0.00025212805984616015,1,43,44
org.apache.velocity.util.RuntimeServicesAware,2,1,2,0.5,1,0.5,124,62.0,1,0.5,0.0,0.0,0.1912022263450835,0.0,10,1,11
org.apache.velocity.runtime.parser.node.ASTIntegerRange,8,17,56,0.30357142857142855,1,0.125,124,15.5,39,0.6964285714285714,0.15476190476190477,0.019345238095238096,0.18899321474417752,7.97611859600531e-05,4,7,11
org.apache.velocity.runtime.directive.VMProxyArg,13,32,156,0.20512820512820512,1,0.07692307692307693,125,9.615384615384615,124,0.7948717948717948,0.0,0.0,0.047298219022356945,0.0003871183621490621,3,13,16
org.apache.velocity.app.event.EventHandlerMethodExecutor,2,1,2,0.5,1,0.5,0,0.0,1,0.5,0.0,0.0,0.12965136753140039,0.0,8,1,9
org.apache.velocity.util.introspection.VelMethod,1,0,0,0,1,1.0,-1,-1.0,0,0,0.0,0.0,0.19011680143755616,0.0,5,0,5
org.apache.velocity.runtime.parser.node.SetExecutor,2,1,2,0.5,1,0.5,125,62.5,1,0.5,0.0,0.0,0.015238095238095238,0.0010233319688907083,5,1,6
org.apache.velocity.runtime.log.RuntimeLoggerLog,4,4,12,0.3333333333333333,1,0.25,124,31.0,8,0.6666666666666666,0.0,0.0,0.17954355400696867,0.0018147086914995227,5,3,8
org.apache.velocity.runtime.parser.node.ASTEQNode,10,19,90,0.2111111111111111,1,0.1,124,12.4,71,0.7888888888888889,0.1736111111111111,0.017361111111111112,0.18899321474417752,0.00040127348454971503,4,9,13
org.apache.velocity.convert.WebMacro,2,1,2,0.5,1,0.5,0,0.0,1,0.5,0.0,0.0,0.0,0.0,0,1,1
org.apache.velocity.runtime.ParserPoolImpl,7,12,42,0.2857142857142857,1,0.14285714285714285,127,18.142857142857142,30,0.7142857142857143,0.0,0.0,0.0,0.0,0,6,6
org.apache.velocity.app.event.implement.IncludeNotFound,6,7,30,0.23333333333333334,1,0.16666666666666666,126,21.0,23,0.7666666666666667,0.0,0.0,0.0,0.0,0,5,5
org.apache.velocity.util.introspection.SecureIntrospectorControl,1,0,0,0,1,1.0,-1,-1.0,0,0,0.0,0.0,0.006428571428571429,0.0,2,0,2
org.apache.velocity.runtime.parser.node.ASTEscape,6,12,30,0.4,1,0.16666666666666666,124,20.666666666666668,18,0.6,0.25,0.041666666666666664,0.18899321474417752,7.031833836397813e-05,4,5,9
org.apache.velocity.util.introspection.VelPropertyGet,1,0,0,0,1,1.0,-1,-1.0,0,0,0.0,0.0,0.1899004164403404,0.0,6,0,6
org.apache.velocity.runtime.parser.node.ASTIncludeStatement,4,7,12,0.5833333333333334,1,0.25,125,31.25,5,0.4166666666666667,0.0,0.0,0.0,0.0,0,3,3
org.apache.velocity.runtime.directive.VelocimacroProxy,17,57,272,0.20955882352941177,1,0.058823529411764705,129,7.588235294117647,215,0.7904411764705882,0.0,0.0,0.056466666666666665,0.0028946411442873636,3,16,19
org.apache.velocity.runtime.parser.node.ASTAssignment,4,9,12,0.75,1,0.25,124,31.0,3,0.25,0.16666666666666666,0.041666666666666664,0.18899321474417752,1.4607855861612239e-05,4,3,7
org.apache.velocity.app.event.EventCartridge,11,14,110,0.12727272727272726,1,0.09090909090909091,124,11.272727272727273,96,0.8727272727272727,0.2888888888888889,0.026262626262626265,0.24375118259224218,0.013502414883840807,14,10,24
org.apache.velocity.exception.MethodInvocationException,3,2,6,0.3333333333333333,1,0.3333333333333333,2,0.6666666666666666,4,0.6666666666666666,0.0,0.0,0.250135940853804,0.0011285451592629142,54,2,56
org.apache.velocity.app.event.NullSetEventHandler,1,0,0,0,1,1.0,-1,-1.0,0,0,0.0,0.0,0.19640211640211638,0.0,9,0,9
org.apache.velocity.runtime.log.Log,3,3,6,0.5,1,0.3333333333333333,124,41.333333333333336,3,0.5,0.0,0.0,0.3599650716032134,0.023294856051303044,75,2,77
org.apache.velocity.util.introspection.ClassMap,5,9,20,0.45,1,0.2,124,24.8,11,0.55,0.0,0.0,0.14405647190383003,0.005722472370036841,6,4,10
org.apache.velocity.runtime.parser.node.ASTStop,9,18,72,0.25,1,0.1111111111111111,124,13.777777777777779,54,0.75,0.14285714285714285,0.015873015873015872,0.18899321474417752,8.912711398303231e-05,4,8,12
org.apache.velocity.util.StringUtils,1,0,0,0,1,1.0,-1,-1.0,0,0,0.0,0.0,0.11726128793486305,0.0,14,0,14
org.apache.velocity.runtime.parser.node.ASTBlock,8,17,56,0.30357142857142855,1,0.125,124,15.5,39,0.6964285714285714,0.11904761904761904,0.01488095238095238,0.18899321474417752,3.443649118376725e-05,4,7,11
org.apache.velocity.runtime.parser.node.ASTElseIfStatement,8,17,56,0.30357142857142855,1,0.125,124,15.5,39,0.6964285714285714,0.11904761904761904,0.01488095238095238,0.18899321474417752,3.443649118376725e-05,4,7,11
org.apache.velocity.runtime.parser.node.NodeUtils,4,4,12,0.3333333333333333,1,0.25,5,1.25,8,0.6666666666666666,0.0,0.0,0.14822925577416596,2.4559967253376996e-05,2,3,5
org.apache.velocity.runtime.directive.Parse,15,44,210,0.20952380952380953,1,0.06666666666666667,126,8.4,166,0.7904761904761904,0.0,0.0,0.0,0.0,0,14,14
org.apache.velocity.runtime.log.LogChute,2,1,2,0.5,1,0.5,124,62.0,1,0.5,0.0,0.0,0.25560019841269843,0.014308909810342477,19,1,20
org.apache.velocity.runtime.log.LogManager,10,21,90,0.23333333333333334,1,0.1,130,13.0,69,0.7666666666666667,0.0,0.0,0.0701601537475977,0.0018463637604038755,1,9,10
org.apache.velocity.runtime.parser.ParserConstants,1,0,0,0,1,1.0,-1,-1.0,0,0,0.0,0.0,0.1884672057502246,0.0,2,0,2
org.apache.velocity.app.FieldMethodizer,2,1,2,0.5,1,0.5,0,0.0,1,0.5,0.0,0.0,0.0038095238095238095,1.2279983626688498e-05,1,1,2
org.apache.velocity.runtime.log.AvalonLogSystem,3,2,6,0.3333333333333333,1,0.3333333333333333,128,42.666666666666664,4,0.6666666666666666,0.0,0.0,0.0,0.0,0,2,2
org.apache.velocity.runtime.log.LogSystem,2,1,2,0.5,1,0.5,125,62.5,1,0.5,0.0,0.0,0.06166353383458647,0.00184472642925365,7,1,8
org.apache.velocity.runtime.RuntimeInstance,29,82,812,0.10098522167487685,1,0.034482758620689655,144,4.9655172413793105,730,0.8990147783251231,0.0,0.0,0.10218600191754555,0.027125864246334598,7,28,35
org.apache.velocity.runtime.resource.loader.JarResourceLoader,7,13,42,0.30952380952380953,1,0.14285714285714285,127,18.142857142857142,29,0.6904761904761905,0.0,0.0,0.0,0.0,0,6,6
org.apache.velocity.context.VMContext,10,19,90,0.2111111111111111,1,0.1,126,12.6,71,0.7888888888888889,0.0,0.0,0.046354285714285716,0.00015622868058398143,2,9,11
org.apache.velocity.texen.util.PropertiesUtil,2,2,2,1.0,1,0.5,147,73.5,0,0.0,0.0,0.0,0.0,0.0,0,1,1
org.apache.velocity.runtime.parser.ParserTreeConstants,1,0,0,0,1,1.0,-1,-1.0,0,0,0.0,0.0,0.1899305809280234,0.0,5,0,5
org.apache.velocity.runtime.parser.node.ASTEscapedDirective,7,16,42,0.38095238095238093,1,0.14285714285714285,124,17.714285714285715,26,0.6190476190476191,0.18333333333333332,0.026190476190476188,0.18899321474417752,7.180682122781917e-05,4,6,10
org.apache.velocity.runtime.parser.ParserTokenManager,5,5,20,0.25,1,0.2,3,0.6,15,0.75,0.0,0.0,0.18706009355883413,0.0,1,4,5
org.apache.velocity.runtime.log.LogChuteSystem,5,6,20,0.3,1,0.2,127,25.4,14,0.7,0.0,0.0,0.05519350215002389,0.0003588484104243417,2,4,6
org.apache.velocity.runtime.parser.node.ASTDivNode,10,19,90,0.2111111111111111,1,0.1,124,12.4,71,0.7888888888888889,0.1736111111111111,0.017361111111111112,0.18899321474417752,0.00040127348454971503,4,9,13
org.apache.velocity.runtime.parser.node.ASTMethod,17,42,272,0.15441176470588236,1,0.058823529411764705,124,7.294117647058823,230,0.8455882352941176,0.13055555555555554,0.007679738562091502,0.19021410114433368,0.008890425903497347,6,16,22
org.apache.velocity.VelocityContext,3,3,6,0.5,1,0.3333333333333333,124,41.333333333333336,3,0.5,0.0,0.0,0.20765262945798912,0.0028440561197417523,45,2,47
org.apache.velocity.Template,14,36,182,0.1978021978021978,1,0.07142857142857142,124,8.857142857142858,146,0.8021978021978022,0.15705128205128205,0.011217948717948718,0.26196746314184033,0.02126007495781453,37,13,50
org.apache.velocity.exception.ParseErrorException,6,7,30,0.23333333333333334,1,0.16666666666666666,5,0.8333333333333334,23,0.7666666666666667,0.0,0.0,0.2596603396603397,0.002629260637740945,31,5,36
org.apache.velocity.runtime.parser.node.SetPropertyExecutor,4,5,12,0.4166666666666667,1,0.25,126,31.5,7,0.5833333333333334,0.0,0.0,0.005714285714285714,0.0,1,3,4
org.apache.velocity.app.event.ReferenceInsertionEventHandler,1,0,0,0,1,1.0,-1,-1.0,0,0,0.0,0.0,0.19894289410460173,0.0,10,0,10
org.apache.velocity.util.introspection.SecureUberspector,9,14,72,0.19444444444444445,1,0.1111111111111111,143,15.88888888888889,58,0.8055555555555556,0.0,0.0,0.002857142857142857,0.00042297721380815933,1,8,9
org.apache.velocity.runtime.log.AvalonLogChute,6,8,30,0.26666666666666666,1,0.16666666666666666,126,21.0,22,0.7333333333333333,0.0,0.0,0.002857142857142857,0.000540319279574294,1,5,6
org.apache.velocity.texen.ant.TexenTask,11,23,110,0.20909090909090908,1,0.09090909090909091,147,13.363636363636363,87,0.7909090909090909,0.0,0.0,0.0,0.0,0,10,10
org.apache.velocity.runtime.log.PrimordialLogSystem,4,4,12,0.3333333333333333,1,0.25,128,32.0,8,0.6666666666666666,0.0,0.0,0.0,0.0,0,3,3
org.apache.velocity.util.introspection.UberspectLoggable,3,2,6,0.3333333333333333,1,0.3333333333333333,125,41.666666666666664,4,0.6666666666666666,0.0,0.0,0.07429824561403509,8.812350154961702e-05,2,2,4
org.apache.velocity.runtime.parser.node.ASTGTNode,10,19,90,0.2111111111111111,1,0.1,124,12.4,71,0.7888888888888889,0.1736111111111111,0.017361111111111112,0.18899321474417752,0.00040127348454971503,4,9,13
org.apache.velocity.app.event.implement.IncludeRelativePath,2,1,2,0.5,1,0.5,0,0.0,1,0.5,0.0,0.0,0.0,0.0,0,1,1
org.apache.velocity.runtime.log.HoldingLogChute,3,3,6,0.5,1,0.3333333333333333,124,41.333333333333336,3,0.5,0.0,0.0,0.23369160997732427,0.010863692181743757,3,2,5
org.apache.velocity.runtime.directive.Foreach,20,63,380,0.16578947368421051,1,0.05,127,6.35,317,0.8342105263157895,0.0,0.0,0.0,0.0,0,19,19
org.apache.velocity.exception.ExtendedParseException,1,0,0,0,1,1.0,-1,-1.0,0,0,0.0,0.0,0.20477187733732238,0.0,5,0,5
org.apache.velocity.runtime.parser.node.ASTIntegerLiteral,7,17,42,0.40476190476190477,1,0.14285714285714285,124,17.714285714285715,25,0.5952380952380952,0.11666666666666667,0.016666666666666666,0.18899321474417752,2.3843493806652946e-05,4,6,10
org.apache.velocity.runtime.Runtime,10,27,90,0.3,1,0.1,146,14.6,63,0.7,0.0,0.0,0.0,0.0,0,9,9
org.apache.velocity.util.introspection.MethodMap,2,1,2,0.5,1,0.5,0,0.0,1,0.5,0.0,0.0,0.1446209486715816,0.0,3,1,4
org.apache.velocity.util.introspection.UberspectImpl,25,67,600,0.11166666666666666,1,0.04,140,5.6,533,0.8883333333333333,0.0,0.0,0.006428571428571429,0.0015029335516441532,2,24,26
org.apache.velocity.runtime.directive.InputBase,7,12,42,0.2857142857142857,1,0.14285714285714285,125,17.857142857142858,30,0.7142857142857143,0.0,0.0,0.005714285714285714,1.2962204939282303e-05,2,6,8
org.apache.velocity.io.UnicodeInputStream,3,2,6,0.3333333333333333,1,0.3333333333333333,1,0.3333333333333333,4,0.6666666666666666,0.0,0.0,0.006428571428571429,3.6839950880065494e-05,2,2,4
org.apache.velocity.runtime.parser.node.ASTElseStatement,5,11,20,0.55,1,0.2,124,24.8,9,0.45,0.16666666666666666,0.03333333333333333,0.18899321474417752,1.5627715564712997e-05,4,4,8
org.apache.velocity.runtime.parser.node.ASTTrue,5,11,20,0.55,1,0.2,124,24.8,9,0.45,0.16666666666666666,0.03333333333333333,0.18899321474417752,1.5627715564712997e-05,4,4,8
org.apache.velocity.util.introspection.IntrospectorCacheListener,2,1,2,0.5,1,0.5,124,62.0,1,0.5,0.0,0.0,0.14210976282404855,0.0,3,1,4
org.apache.velocity.runtime.parser.CharStream,1,0,0,0,1,1.0,-1,-1.0,0,0,0.0,0.0,0.18987796123474512,0.0,3,0,3
org.apache.velocity.runtime.parser.Token,1,1,0,0,1,1.0,-1,-1.0,-1,0,0.0,0.0,0.23715563125399192,0.0,25,1,26
org.apache.velocity.app.event.EventHandler,1,0,0,0,1,1.0,-1,-1.0,0,0,0.0,0.0,0.20117753296008667,0.0,11,0,11
org.apache.velocity.runtime.ParserPool,3,4,6,0.6666666666666666,1,0.3333333333333333,125,41.666666666666664,2,0.3333333333333333,0.0,0.0,0.07174744897959183,0.0,2,2,4
org.apache.velocity.runtime.parser.VelocityCharStream,2,1,2,0.5,1,0.5,0,0.0,1,0.5,0.0,0.0,0.18706009355883413,0.0,1,1,2
org.apache.velocity.runtime.parser.TemplateParseException,4,5,12,0.4166666666666667,1,0.25,2,0.5,7,0.5833333333333334,0.0,0.0,0.18706009355883413,7.339460921122812e-05,1,3,4
org.apache.velocity.runtime.RuntimeLogger,1,0,0,0,1,1.0,-1,-1.0,0,0,0.0,0.0,0.18179401993355482,0.0,7,0,7
org.apache.velocity.runtime.parser.node.ASTIdentifier,16,41,240,0.17083333333333334,1,0.0625,124,7.75,199,0.8291666666666667,0.1253968253968254,0.007837301587301587,0.18899321474417752,0.006009951077463784,4,15,19
org.apache.velocity.runtime.resource.loader.JarHolder,4,4,12,0.3333333333333333,1,0.25,125,31.25,8,0.6666666666666666,0.0,0.0,0.002857142857142857,0.00030017737754127444,1,3,4
org.apache.velocity.runtime.parser.node.ASTObjectArray,6,13,30,0.43333333333333335,1,0.16666666666666666,124,20.666666666666668,17,0.5666666666666667,0.15000000000000002,0.025000000000000005,0.18899321474417752,1.8607413883583506e-05,4,5,9
org.apache.velocity.runtime.VelocimacroManager,4,7,12,0.5833333333333334,1,0.25,131,32.75,5,0.4166666666666667,0.0,0.0,0.05519350215002389,0.000613999181334425,2,3,5
org.apache.velocity.app.event.IncludeEventHandler,1,0,0,0,1,1.0,-1,-1.0,0,0,0.0,0.0,0.19784620991253643,0.0,10,0,10
org.apache.velocity.runtime.RuntimeServices,10,23,90,0.25555555555555554,1,0.1,124,12.4,67,0.7444444444444445,0.548611111111111,0.054861111111111104,0.33084430176565005,0.11253493953081349,66,9,75
org.apache.velocity.runtime.resource.ContentResource,6,14,30,0.4666666666666667,1,0.16666666666666666,124,20.666666666666668,16,0.5333333333333333,0.15000000000000002,0.025000000000000005,0.23443585077343038,0.0021906552971249077,5,5,10
org.apache.velocity.runtime.directive.Directive,9,11,72,0.1527777777777778,1,0.1111111111111111,124,13.777777777777779,61,0.8472222222222222,0.125,0.013888888888888888,0.2551572171329537,0.003278818695257066,13,8,21
org.apache.velocity.servlet.VelocityServlet,13,31,156,0.1987179487179487,1,0.07692307692307693,149,11.461538461538462,125,0.8012820512820513,0.0,0.0,0.005714285714285714,0.0013511490556107834,2,12,14
org.apache.velocity.runtime.log.NullLogSystem,3,2,6,0.3333333333333333,1,0.3333333333333333,127,42.333333333333336,4,0.6666666666666666,0.0,0.0,0.0,0.0,0,2,2
org.apache.velocity.runtime.log.LogDisplayWrapper,3,3,6,0.5,1,0.3333333333333333,125,41.666666666666664,3,0.5,0.0,0.0,0.053930968360498564,4.093327875562833e-06,1,2,3
org.apache.velocity.runtime.directive.Literal,6,12,30,0.4,1,0.16666666666666666,125,20.833333333333332,18,0.6,0.0,0.0,0.0,0.0,0,5,5
org.apache.velocity.util.SimplePool,1,0,0,0,1,1.0,-1,-1.0,0,0,0.0,0.0,0.01020408163265306,0.0,3,0,3
org.apache.velocity.runtime.parser.node.MapSetExecutor,3,3,6,0.5,1,0.3333333333333333,126,42.0,3,0.5,0.0,0.0,0.005714285714285714,0.0,1,2,3
org.apache.velocity.anakia.TreeWalker,2,2,2,1.0,1,0.5,2,1.0,0,0.0,0.0,0.0,0.0038095238095238095,1.637331150225133e-05,1,1,2
org.apache.velocity.anakia.XPathTool,3,4,6,0.6666666666666666,1,0.3333333333333333,2,0.6666666666666666,2,0.3333333333333333,0.0,0.0,0.0038095238095238095,3.274662300450266e-05,1,2,3
org.apache.velocity.util.EnumerationIterator,1,0,0,0,1,1.0,-1,-1.0,0,0,0.0,0.0,0.005714285714285714,0.0,1,0,1
org.apache.velocity.runtime.parser.node.ASTSubtractNode,10,19,90,0.2111111111111111,1,0.1,124,12.4,71,0.7888888888888889,0.1736111111111111,0.017361111111111112,0.18899321474417752,0.00040127348454971503,4,9,13
org.apache.velocity.runtime.resource.loader.ResourceLoader,6,12,30,0.4,1,0.16666666666666666,124,20.666666666666668,18,0.6,0.07500000000000001,0.012500000000000002,0.2073601609657948,0.007354378955564241,14,5,19
org.apache.velocity.util.introspection.Info,1,0,0,0,1,1.0,-1,-1.0,0,0,0.0,0.0,0.22412743506493504,0.0,19,0,19
org.apache.velocity.context.InternalContextBase,6,9,30,0.3,1,0.16666666666666666,124,20.666666666666668,21,0.7,0.0,0.0,0.15881954076128832,0.005783634792330192,2,5,7
org.apache.velocity.runtime.visitor.BaseVisitor,44,206,1892,0.10887949260042283,1,0.022727272727272728,125,2.840909090909091,1686,0.8911205073995772,0.0,0.0,0.040365815200252286,0.0006867817591291519,3,43,46
org.apache.velocity.runtime.parser.node.ASTReference,18,57,306,0.18627450980392157,1,0.05555555555555555,124,6.888888888888889,249,0.8137254901960784,0.09215686274509802,0.005119825708061001,0.19095423383361126,0.007382164528269128,8,17,25
org.apache.velocity.runtime.directive.MacroParseException,4,5,12,0.4166666666666667,1,0.25,2,0.5,7,0.5833333333333334,0.0,0.0,0.18776955029799533,7.82321785187115e-05,2,3,5
org.apache.velocity.app.event.MethodExceptionEventHandler,1,0,0,0,1,1.0,-1,-1.0,0,0,0.0,0.0,0.1969050667642217,0.0,10,0,10
org.apache.velocity.runtime.parser.node.GetExecutor,6,11,30,0.36666666666666664,1,0.16666666666666666,126,21.0,19,0.6333333333333333,0.0,0.0,0.005714285714285714,0.0,1,5,6
org.apache.velocity.runtime.parser.node.ASTOrNode,6,13,30,0.43333333333333335,1,0.16666666666666666,124,20.666666666666668,17,0.5666666666666667,0.15000000000000002,0.025000000000000005,0.18899321474417752,1.8607413883583506e-05,4,5,9
org.apache.velocity.runtime.resource.util.StringResource,1,0,0,0,1,1.0,-1,-1.0,0,0,0.0,0.0,0.01020408163265306,0.0,3,0,3
org.apache.velocity.runtime.log.NullLogChute,3,3,6,0.5,1,0.3333333333333333,125,41.666666666666664,3,0.5,0.0,0.0,0.060124223602484476,0.002691316149724379,21,2,23
org.apache.velocity.exception.ResourceNotFoundException,2,1,2,0.5,1,0.5,1,0.5,1,0.5,0.0,0.0,0.2633434650455927,0.0004572864484857935,37,1,38
org.apache.velocity.context.InternalContextAdapterImpl,7,10,42,0.23809523809523808,1,0.14285714285714285,124,17.714285714285715,32,0.7619047619047619,0.0,0.0,0.19525956801818872,0.0030256983926827776,5,6,11
org.apache.velocity.app.event.implement.EscapeReference,6,7,30,0.23333333333333334,1,0.16666666666666666,126,21.0,23,0.7666666666666667,0.0,0.0,0.014285714285714285,0.0042698255556722735,5,5,10
org.apache.velocity.runtime.directive.DirectiveConstants,1,0,0,0,1,1.0,-1,-1.0,0,0,0.0,0.0,0.1962030571806001,0.0,2,0,2
org.apache.velocity.runtime.resource.ResourceManagerImpl,15,41,210,0.19523809523809524,1,0.06666666666666667,130,8.666666666666666,169,0.8047619047619048,0.0,0.0,0.0,0.0,0,14,14
org.apache.velocity.runtime.parser.ParseException,2,2,2,1.0,1,0.5,0,0.0,0,0.0,0.0,0.0,0.24684246732400825,0.00017054646813140467,14,1,15
org.apache.velocity.runtime.parser.node.AbstractExecutor,2,1,2,0.5,1,0.5,125,62.5,1,0.5,0.0,0.0,0.01653061224489796,0.0010233319688907083,5,1,6
org.apache.velocity.runtime.parser.node.PutExecutor,4,5,12,0.4166666666666667,1,0.25,126,31.5,7,0.5833333333333334,0.0,0.0,0.005714285714285714,0.0,1,3,4
org.apache.velocity.runtime.resource.ResourceFactory,5,7,20,0.35,1,0.2,126,25.2,13,0.65,0.0,0.0,0.002857142857142857,3.342884431709647e-05,1,4,5
org.apache.velocity.runtime.parser.node.ASTParameters,4,7,12,0.5833333333333334,1,0.25,125,31.25,5,0.4166666666666667,0.0,0.0,0.0,0.0,0,3,3
org.apache.velocity.app.Velocity,14,44,182,0.24175824175824176,1,0.07142857142857142,146,10.428571428571429,138,0.7582417582417582,0.0,0.0,0.08642857142857142,0.01645337573996226,30,13,43
org.apache.velocity.runtime.resource.loader.URLResourceLoader,5,9,20,0.45,1,0.2,125,25.0,11,0.55,0.0,0.0,0.0,0.0,0,4,4
org.apache.velocity.runtime.RuntimeSingleton,15,53,210,0.2523809523809524,1,0.06666666666666667,145,9.666666666666666,157,0.7476190476190476,0.0,0.0,0.09981566820276498,0.02195952149615116,21,14,35
org.apache.velocity.context.InternalWrapperContext,3,2,6,0.3333333333333333,1,0.3333333333333333,1,0.3333333333333333,4,0.6666666666666666,0.0,0.0,0.002857142857142857,0.0,1,2,3
org.apache.velocity.util.introspection.IntrospectionCacheData,1,0,0,0,1,1.0,-1,-1.0,0,0,0.0,0.0,0.18542536115569822,0.0,8,0,8
org.apache.velocity.runtime.parser.node.ASTComment,10,23,90,0.25555555555555554,1,0.1,124,12.4,67,0.7444444444444445,0.11805555555555555,0.011805555555555555,0.18875091575091577,8.282328987084044e-05,3,9,12
