name,Size,Ties,Pairs,Density,WeakComp,nWeakComp,2StepReach,ReachEffic,Broker,nBroker,EgoBetween,nEgoBetween,Closeness_Centrality,Betweenness_Centrality,in_degree,out_degree,degree
org.apache.xalan.xsltc.runtime.output.SAXXMLOutput,6,11,30,0.36666666666666664,1,0.16666666666666666,643,107.16666666666667,19,0.6333333333333333,0.0,0.0,0.14544763509364825,0.00037589011154815486,1,5,6
org.apache.xpath.operations.Operation,9,29,72,0.4027777777777778,1,0.1111111111111111,643,71.44444444444444,43,0.5972222222222222,0.14880952380952378,0.01653439153439153,0.24041509848862877,0.003786737577362056,17,8,25
org.apache.xalan.xsltc.runtime.BasisLibrary,16,43,240,0.17916666666666667,1,0.0625,643,40.1875,197,0.8208333333333333,0.1142857142857143,0.0071428571428571435,0.15844999057972065,0.017123944396202254,24,15,39
org.apache.xpath.objects.XString,15,61,210,0.2904761904761905,1,0.06666666666666667,643,42.86666666666667,149,0.7095238095238096,0.4253663003663004,0.02835775335775336,0.3990914640412834,0.08490632856457594,35,14,49
org.apache.xalan.xsltc.StripFilter,2,2,2,1.0,1,0.5,643,321.5,0,0.0,0.0,0.0,0.18611878986605138,6.333667750990586e-07,5,1,6
org.apache.xalan.serialize.Serializer,2,1,2,0.5,1,0.5,643,321.5,1,0.5,0.0,0.0,0.17588123266769873,0.0004438202520304506,11,1,12
org.apache.xalan.templates.ElemExsltFunction,18,99,306,0.3235294117647059,1,0.05555555555555555,643,35.72222222222222,207,0.6764705882352942,0.0,0.0,0.15936606907390166,0.000260906579806862,5,17,22
org.apache.xalan.xsltc.runtime.output.SAXHTMLOutput,4,6,12,0.5,1,0.25,643,160.75,6,0.5,0.0,0.0,0.14544763509364825,0.00035482614222771895,1,3,4
org.apache.xml.dtm.ref.CoroutineParser,2,1,2,0.5,1,0.5,644,322.0,1,0.5,0.0,0.0,0.0,0.0,0,1,1
org.apache.xalan.xsltc.runtime.StringValueHandler,4,6,12,0.5,1,0.25,643,160.75,6,0.5,0.0,0.0,0.14568620420533818,0.0010665896492668147,1,3,4
org.apache.xml.utils.CharKey,1,0,0,0,1,1.0,-1,-1.0,0,0,0.0,0.0,0.1301409518060689,0.0,1,0,1
org.apache.xalan.xsltc.compiler.util.Type,20,157,380,0.4131578947368421,1,0.05,643,32.15,223,0.5868421052631579,0.2873781676413255,0.014368908382066276,0.2859013599694888,0.011983011729439923,112,20,132
org.apache.xalan.transformer.StackGuard,9,29,72,0.4027777777777778,1,0.1111111111111111,643,71.44444444444444,43,0.5972222222222222,0.01845238095238095,0.00205026455026455,0.17453716211237788,0.0004973044181063694,3,8,11
org.apache.xalan.serialize.WriterToUTF8Buffered,4,6,12,0.5,1,0.25,643,160.75,6,0.5,0.0,0.0,0.1504007906819738,1.3843588084307994e-06,1,3,4
org.apache.xpath.functions.FuncCeiling,6,13,30,0.43333333333333335,1,0.16666666666666666,644,107.33333333333333,17,0.5666666666666667,0.0,0.0,0.0,0.0,0,5,5
org.apache.xalan.xsltc.compiler.Number,21,119,420,0.2833333333333333,1,0.047619047619047616,643,30.61904761904762,301,0.7166666666666667,0.0,0.0,0.22787348987305892,0.009853558009467512,1,20,21
org.apache.xalan.xsltc.runtime.TextOutput,9,20,72,0.2777777777777778,1,0.1111111111111111,643,71.44444444444444,52,0.7222222222222222,0.08928571428571427,0.00992063492063492,0.14584568554546445,0.00032490267056534513,6,8,14
org.apache.xalan.processor.ProcessorUnknown,4,6,12,0.5,1,0.25,643,160.75,6,0.5,0.0,0.0,0.15908063730839614,2.613713505320306e-05,1,3,4
org.apache.xml.dtm.ref.ChunkedIntArray,4,4,12,0.3333333333333333,1,0.25,645,161.25,8,0.6666666666666666,0.0,0.0,0.0011248593925759281,2.364569293703152e-06,1,3,4
org.apache.xalan.xsltc.compiler.BinOpExpr,12,52,132,0.3939393939393939,1,0.08333333333333333,644,53.666666666666664,80,0.6060606060606061,0.0,0.0,0.0,0.0,0,11,11
org.apache.xalan.serialize.SerializerToText,4,7,12,0.5833333333333334,1,0.25,643,160.75,5,0.4166666666666667,0.0,0.0,0.14978081365461696,8.703946476986476e-05,1,3,4
org.apache.xml.utils.PrefixResolver,2,1,2,0.5,1,0.5,643,321.5,1,0.5,0.0,0.0,0.2791131991880903,4.692181004890829e-06,33,1,34
org.apache.xalan.extensions.ExtensionHandlerJavaPackage,13,49,156,0.3141025641025641,1,0.07692307692307693,648,49.84615384615385,107,0.6858974358974359,0.0,0.0,0.0,0.0,0,12,12
org.apache.xml.utils.XMLStringFactory,4,7,12,0.5833333333333334,1,0.25,643,160.75,5,0.4166666666666667,0.0,0.0,0.3168371789435952,0.000262696117326722,14,3,17
org.apache.xalan.templates.ElemComment,9,31,72,0.4305555555555556,1,0.1111111111111111,643,71.44444444444444,41,0.5694444444444444,0.0,0.0,0.1591123014479878,1.5191623746403124e-05,1,8,9
org.apache.xpath.res.XPATHErrorResources,2,1,2,0.5,1,0.5,643,321.5,1,0.5,0.0,0.0,0.33629793961913784,7.90889918029114e-06,32,1,33
org.apache.xpath.axes.MatchPatternIterator,12,41,132,0.3106060606060606,1,0.08333333333333333,643,53.583333333333336,91,0.6893939393939394,0.02121212121212121,0.0017676767676767676,0.17202070206040254,6.852590205703618e-05,1,11,12
org.apache.xalan.xsltc.compiler.Constants,1,0,0,0,1,1.0,-1,-1.0,0,0,0.0,0.0,0.2405517382977983,0.0,11,0,11
org.apache.xalan.xsltc.runtime.output.TransletOutputHandlerFactory,15,38,210,0.18095238095238095,1,0.06666666666666667,643,42.86666666666667,172,0.819047619047619,0.0,0.0,0.17154081598169327,0.016007305659078853,4,15,19
org.apache.xalan.serialize.Method,1,0,0,0,1,1.0,-1,-1.0,0,0,0.0,0.0,0.21703083430930828,0.0,8,0,8
org.apache.xml.utils.TreeWalker,8,16,56,0.2857142857142857,1,0.125,643,80.375,40,0.7142857142857143,0.09523809523809523,0.011904761904761904,0.1819253988335664,0.008436338980932686,7,7,14
org.apache.xalan.lib.sql.SQLErrorDocument,4,6,12,0.5,1,0.25,648,162.0,6,0.5,0.0,0.0,0.0011248593925759281,1.8050953090323174e-05,1,3,4
org.apache.xalan.xsltc.compiler.ProcessingInstruction,11,43,110,0.39090909090909093,1,0.09090909090909091,643,58.45454545454545,67,0.6090909090909091,0.0,0.0,0.16939610139323813,0.0043613538976093776,3,10,13
org.apache.xml.utils.StringToIntTable,2,1,2,0.5,1,0.5,643,321.5,1,0.5,0.0,0.0,0.14115843236353356,0.0,2,1,3
org.apache.xpath.operations.Equals,6,15,30,0.5,1,0.16666666666666666,643,107.16666666666667,15,0.5,0.0,0.0,0.1830921215013034,3.547223674065759e-05,1,5,6
org.apache.xalan.xsltc.compiler.LastCall,9,22,72,0.3055555555555556,1,0.1111111111111111,643,71.44444444444444,50,0.6944444444444444,0.04464285714285714,0.00496031746031746,0.15223389877636462,0.0005091569511739645,1,8,9
org.apache.xml.dtm.ref.CoroutineManager,3,3,6,0.5,1,0.3333333333333333,643,214.33333333333334,3,0.5,0.0,0.0,0.1590173468220988,0.0008157764063275875,3,2,5
org.apache.xpath.functions.FuncStringLength,7,19,42,0.4523809523809524,1,0.14285714285714285,645,92.14285714285714,23,0.5476190476190477,0.0,0.0,0.0,0.0,0,6,6
org.apache.xalan.xsltc.dom.NodeSortRecord,4,7,12,0.5833333333333334,1,0.25,644,161.0,5,0.4166666666666667,0.0,0.0,0.0022497187851518562,0.0002492720504531528,3,4,7
org.apache.xalan.xsltc.runtime.HashtableEntry,1,0,0,0,1,1.0,-1,-1.0,0,0,0.0,0.0,0.20380048916113347,0.0,2,0,2
org.apache.xalan.templates.TemplateSubPatternAssociation,11,35,110,0.3181818181818182,1,0.09090909090909091,643,58.45454545454545,75,0.6818181818181818,0.0,0.0,0.15832446077930099,0.00011282493054677687,3,11,14
org.apache.xalan.templates.AVTPartXPath,13,41,156,0.26282051282051283,1,0.07692307692307693,643,49.46153846153846,115,0.7371794871794872,0.0,0.0,0.14811565730492693,6.703730072207573e-05,1,12,13
org.apache.xpath.operations.UnaryOperation,8,24,56,0.42857142857142855,1,0.125,643,80.375,32,0.5714285714285714,0.04365079365079365,0.005456349206349206,0.3867344956336191,0.07641665532197252,6,7,13
org.apache.xalan.xslt.StylesheetRoot,18,69,306,0.22549019607843138,1,0.05555555555555555,643,35.72222222222222,237,0.7745098039215687,0.504595588235294,0.028033088235294115,0.2185293063080073,0.032747809343876666,37,17,54
org.apache.xalan.processor.ProcessorGlobalParamDecl,6,12,30,0.4,1,0.16666666666666666,643,107.16666666666667,18,0.6,0.0,0.0,0.15908063730839614,2.6423688252097865e-05,1,5,6
org.apache.xalan.xsltc.compiler.util.NamedMethodGenerator,4,8,12,0.6666666666666666,1,0.25,643,160.75,4,0.3333333333333333,0.0,0.0,0.15546094952833345,9.020347470688238e-07,1,3,4
org.apache.xpath.axes.DescendantIterator,14,46,182,0.25274725274725274,1,0.07142857142857142,643,45.92857142857143,136,0.7472527472527473,0.027777777777777776,0.001984126984126984,0.17268960952142812,0.0003071541263121654,2,13,15
org.apache.xalan.xpath.XBoolean,4,8,12,0.6666666666666666,1,0.25,643,160.75,4,0.3333333333333333,0.0,0.0,0.16772559850497076,0.00014201283761730712,4,3,7
org.apache.xalan.processor.ProcessorTemplate,6,12,30,0.4,1,0.16666666666666666,643,107.16666666666667,18,0.6,0.0,0.0,0.15908063730839614,2.6423688252097865e-05,1,5,6
org.apache.xpath.functions.FuncSubstringAfter,7,17,42,0.40476190476190477,1,0.14285714285714285,644,92.0,25,0.5952380952380952,0.0,0.0,0.0,0.0,0,6,6
org.apache.xalan.xsltc.compiler.IdPattern,3,4,6,0.6666666666666666,1,0.3333333333333333,643,214.33333333333334,2,0.3333333333333333,0.0,0.0,0.13374271415002353,0.0,1,2,3
org.apache.xalan.extensions.ExpressionContext,5,8,20,0.4,1,0.2,643,128.6,12,0.6,0.0,0.0,0.25417494514298594,0.00027224562563653635,15,4,19
org.apache.xalan.templates.ElemWhen,10,26,90,0.28888888888888886,1,0.1,643,64.3,64,0.7111111111111111,0.0,0.0,0.15917566755768434,4.780053330791673e-05,2,9,11
org.apache.xpath.XPath,22,100,462,0.21645021645021645,1,0.045454545454545456,643,29.227272727272727,362,0.7835497835497836,0.0,0.0,0.22671021057138135,0.012365210944394269,45,21,66
org.apache.xalan.transformer.MsgMgr,6,10,30,0.3333333333333333,1,0.16666666666666666,643,107.16666666666667,20,0.6666666666666666,0.1,0.016666666666666666,0.17427080934700034,0.0005627560536244922,8,5,13
org.apache.xalan.xsltc.dom.DOMImpl,49,178,2352,0.07568027210884354,1,0.02040816326530612,643,13.122448979591837,2174,0.9243197278911565,0.5832594562647755,0.011903254209485214,0.18529907335991902,0.06513157882867057,38,48,86
org.apache.xalan.xsltc.compiler.ArgumentList,3,3,6,0.5,1,0.3333333333333333,644,214.66666666666666,3,0.5,0.0,0.0,0.0,0.0,0,2,2
org.apache.xalan.xslt.XSLProcessorContext,6,13,30,0.43333333333333335,1,0.16666666666666666,645,107.5,17,0.5666666666666667,0.0,0.0,0.0022497187851518562,7.201378535930354e-05,2,5,7
org.apache.xalan.templates.FuncKey,14,48,182,0.26373626373626374,1,0.07142857142857142,643,45.92857142857143,134,0.7362637362637363,0.0,0.0,0.16270714481471416,0.002672466027008431,1,13,14
org.apache.xalan.lib.sql.XConnection,15,41,210,0.19523809523809524,1,0.06666666666666667,655,43.666666666666664,169,0.8047619047619048,0.0,0.0,0.0,0.0,0,14,14
org.apache.xalan.xsltc.compiler.Instruction,9,36,72,0.5,1,0.1111111111111111,643,71.44444444444444,36,0.5,0.13541666666666666,0.015046296296296295,0.23545808614865704,0.0026605993994666664,48,8,56
org.apache.xalan.transformer.NodeSorter,8,24,56,0.42857142857142855,1,0.125,643,80.375,32,0.5714285714285714,0.007936507936507936,0.000992063492063492,0.16280655854881684,0.0010890207639951775,2,7,9
org.apache.xalan.xsltc.trax.SmartTransformerFactoryImpl,5,7,20,0.35,1,0.2,644,128.8,13,0.65,0.0,0.0,0.0,0.0,0,4,4
org.apache.xalan.xsltc.compiler.BooleanExpr,9,26,72,0.3611111111111111,1,0.1111111111111111,643,71.44444444444444,46,0.6388888888888888,0.0,0.0,0.1523499528253651,1.2667335501981173e-07,1,8,9
org.apache.xpath.axes.ContextNodeList,3,3,6,0.5,1,0.3333333333333333,644,214.66666666666666,3,0.5,0.0,0.0,0.003124609423822022,0.0,1,2,3
org.apache.xml.utils.ElemDesc,2,1,2,0.5,1,0.5,644,322.0,1,0.5,0.0,0.0,0.0,0.0,0,1,1
org.apache.xalan.xpath.XObject,8,21,56,0.375,1,0.125,643,80.375,35,0.625,0.30952380952380953,0.03869047619047619,0.42656360857774317,0.03460182625435409,103,8,111
org.apache.xalan.xsltc.Translet,4,6,12,0.5,1,0.25,643,160.75,6,0.5,0.0,0.0,0.18616213378544264,0.001731200461217061,14,3,17
org.apache.xalan.xsltc.compiler.util.ObjectType,10,42,90,0.4666666666666667,1,0.1,643,64.3,48,0.5333333333333333,0.08333333333333333,0.008333333333333333,0.22051867654474225,2.6292044640204326e-05,6,9,15
org.apache.xalan.trace.TraceListenerEx,2,1,2,0.5,1,0.5,643,321.5,1,0.5,0.0,0.0,0.16807825956154135,0.0,1,1,2
org.apache.xalan.xpath.xml.XMLParserLiaisonDefault,2,1,2,0.5,1,0.5,643,321.5,1,0.5,0.0,0.0,0.16744453340483675,1.614783673276362e-05,2,1,3
org.apache.xpath.functions.FuncPosition,11,34,110,0.3090909090909091,1,0.09090909090909091,643,58.45454545454545,76,0.6909090909090909,0.0,0.0,0.1588593407143662,2.244685193989035e-05,1,10,11
org.apache.xalan.xsltc.cmdline.getopt.IllegalArgumentException,3,3,6,0.5,1,0.3333333333333333,645,215.0,3,0.5,0.0,0.0,0.0014998125234345708,6.333667750990586e-07,1,2,3
org.apache.xalan.templates.ElemCopy,11,39,110,0.35454545454545455,1,0.09090909090909091,643,58.45454545454545,71,0.6454545454545455,0.0,0.0,0.1591123014479878,2.442018340408421e-05,1,10,11
org.apache.xalan.xsltc.dom.StepIterator,4,8,12,0.6666666666666666,1,0.25,643,160.75,4,0.3333333333333333,0.16666666666666666,0.041666666666666664,0.1358104319528866,9.289379368119523e-06,2,3,5
org.apache.xalan.xsltc.compiler.StepPattern,17,66,272,0.2426470588235294,1,0.058823529411764705,643,37.8235294117647,206,0.7573529411764706,0.01597222222222222,0.0009395424836601306,0.2188883358364432,0.031108373275480196,16,17,33
org.apache.xalan.extensions.ExtensionHandlerExsltFunction,17,93,272,0.34191176470588236,1,0.058823529411764705,644,37.88235294117647,179,0.6580882352941176,0.0,0.0,0.0,0.0,0,16,16
org.apache.xalan.xsltc.compiler.NumberCall,8,18,56,0.32142857142857145,1,0.125,644,80.5,38,0.6785714285714286,0.0,0.0,0.0,0.0,0,7,7
org.apache.xalan.processor.ProcessorNamespaceAlias,6,12,30,0.4,1,0.16666666666666666,643,107.16666666666667,18,0.6,0.0,0.0,0.15908063730839614,7.057966353390315e-05,1,5,6
org.apache.xalan.xsltc.compiler.util.MultiHashtable,1,0,0,0,1,1.0,-1,-1.0,0,0,0.0,0.0,0.1710670026195487,0.0,2,0,2
org.apache.xpath.objects.LessThanOrEqualComparator,3,4,6,0.6666666666666666,1,0.3333333333333333,643,214.33333333333334,2,0.3333333333333333,0.0,0.0,0.22911441744760408,0.0,1,2,3
org.apache.xml.utils.ListingErrorHandler,7,12,42,0.2857142857142857,1,0.14285714285714285,644,92.0,30,0.7142857142857143,0.0,0.0,0.0,0.0,0,6,6
org.apache.xalan.serialize.WriterToUTF8,2,1,2,0.5,1,0.5,643,321.5,1,0.5,0.0,0.0,0.1504007906819738,0.0,1,1,2
org.apache.xpath.functions.FuncRound,6,13,30,0.43333333333333335,1,0.16666666666666666,644,107.33333333333333,17,0.5666666666666667,0.0,0.0,0.0,0.0,0,5,5
org.apache.xalan.transformer.XalanProperties,1,0,0,0,1,1.0,-1,-1.0,0,0,0.0,0.0,0.1711400769478783,0.0,2,0,2
org.apache.xalan.xsltc.runtime.Operators,1,0,0,0,1,1.0,-1,-1.0,0,0,0.0,0.0,0.16872559281321672,0.0,4,0,4
org.apache.xalan.trace.TraceListenerEx2,2,1,2,0.5,1,0.5,643,321.5,1,0.5,0.0,0.0,0.16814896980956892,0.0,2,1,3
org.apache.xalan.xsltc.dom.AnyNodeCounter,5,11,20,0.55,1,0.2,646,129.2,9,0.45,0.08333333333333333,0.016666666666666666,0.0011248593925759281,2.5334671003962344e-06,1,4,5
org.apache.xalan.xpath.xml.XMLParserLiaison,2,1,2,0.5,1,0.5,643,321.5,1,0.5,0.0,0.0,0.16772559850497076,0.000833349318304324,4,1,5
org.apache.xpath.WhitespaceStrippingElementMatcher,2,1,2,0.5,1,0.5,643,321.5,1,0.5,0.0,0.0,0.19082840832530215,0.0,1,1,2
org.apache.xalan.processor.TransformerFactoryImpl,17,55,272,0.20220588235294118,1,0.058823529411764705,643,37.8235294117647,217,0.7977941176470589,0.125,0.007352941176470588,0.20822615328853625,0.015984748517570306,12,16,28
org.apache.xalan.xsltc.runtime.output.StreamXMLOutput,7,15,42,0.35714285714285715,1,0.14285714285714285,643,91.85714285714286,27,0.6428571428571429,0.0,0.0,0.14563312123787403,0.0003754678670314222,2,6,8
org.apache.xalan.xsltc.runtime.TransletLoader,3,4,6,0.6666666666666666,1,0.3333333333333333,643,214.33333333333334,2,0.3333333333333333,0.0,0.0,0.1348254684558426,2.5334671003962344e-06,4,2,6
org.apache.xpath.ExpressionOwner,2,1,2,0.5,1,0.5,643,321.5,1,0.5,0.0,0.0,0.31471661514751603,0.0010716242881010228,38,1,39
org.apache.xml.dtm.ref.sax2dtm.SAX2DTM,24,76,552,0.13768115942028986,1,0.041666666666666664,643,26.791666666666668,476,0.8623188405797102,0.016798418972332016,0.0006999341238471674,0.21477168255633816,0.05843363205636876,3,23,26
org.apache.xpath.operations.Div,6,16,30,0.5333333333333333,1,0.16666666666666666,643,107.16666666666667,14,0.4666666666666667,0.0,0.0,0.18317603173113903,2.677711759637579e-05,2,5,7
org.apache.xalan.xsltc.compiler.Sort,28,166,756,0.21957671957671956,1,0.03571428571428571,643,22.964285714285715,590,0.7804232804232805,0.031123197789864464,0.001111542778209445,0.13401176906532952,0.0033039792615879673,2,27,29
org.apache.xalan.serialize.SerializerToXML,19,47,342,0.13742690058479531,1,0.05263157894736842,643,33.8421052631579,295,0.8625730994152047,0.0,0.0,0.17847291861457706,0.009049485564146646,8,19,27
org.apache.xpath.axes.HasPositionalPredChecker,18,46,306,0.1503267973856209,1,0.05555555555555555,643,35.72222222222222,260,0.8496732026143791,0.0,0.0,0.19069184219338994,0.0036530414086333733,1,17,18
org.apache.xalan.xsltc.compiler.util.NodeCounterGenerator,5,10,20,0.5,1,0.2,643,128.6,10,0.5,0.0,0.0,0.18389238612254213,3.770443811428401e-05,1,4,5
org.apache.xpath.functions.WrongNumberArgsException,2,1,2,0.5,1,0.5,643,321.5,1,0.5,0.0,0.0,0.20860652465414684,5.371045804139418e-06,12,1,13
org.apache.xalan.xsltc.compiler.TopLevelElement,10,35,90,0.3888888888888889,1,0.1,643,64.3,55,0.6111111111111112,0.0,0.0,0.2218036077898698,0.00010290301419101895,16,9,25
org.apache.xalan.xsltc.compiler.XslAttribute,22,146,462,0.31601731601731603,1,0.045454545454545456,643,29.227272727272727,316,0.683982683982684,0.0,0.0,0.17947467500554348,0.006305352387605039,2,21,23
org.apache.xalan.serialize.WriterToASCI,2,1,2,0.5,1,0.5,643,321.5,1,0.5,0.0,0.0,0.1504007906819738,0.0,1,1,2
org.apache.xalan.processor.ProcessorLRE,18,64,306,0.20915032679738563,1,0.05555555555555555,643,35.72222222222222,242,0.7908496732026143,0.0,0.0,0.15908063730839614,4.381016972645921e-05,1,17,18
org.apache.xalan.xsltc.trax.SAX2TO,6,8,30,0.26666666666666666,1,0.16666666666666666,643,107.16666666666667,22,0.7333333333333333,0.0,0.0,0.16864561233643263,0.0020968662700946166,2,5,7
org.apache.xalan.xsltc.runtime.output.StreamOutput,5,9,20,0.45,1,0.2,643,128.6,11,0.55,0.0,0.0,0.14619242912850963,0.0015885190589914932,6,5,11
org.apache.xpath.Expression,14,52,182,0.2857142857142857,1,0.07142857142857142,643,45.92857142857143,130,0.7142857142857143,0.20512820512820512,0.014652014652014652,0.3131140628573015,0.005738471911659901,32,13,45
org.apache.xpath.functions.FuncSubstring,10,29,90,0.32222222222222224,1,0.1,644,64.4,61,0.6777777777777778,0.0,0.0,0.0,0.0,0,9,9
org.apache.xalan.xsltc.compiler.AttributeValueTemplate,12,46,132,0.3484848484848485,1,0.08333333333333333,643,53.583333333333336,86,0.6515151515151515,0.05909090909090909,0.004924242424242424,0.19698871426187547,0.0022094454201261574,4,11,15
org.apache.xalan.xsltc.compiler.util.NodeSortRecordFactGenerator,4,7,12,0.5833333333333334,1,0.25,643,160.75,5,0.4166666666666667,0.0,0.0,0.11752134702656435,9.500501626485879e-07,1,3,4
org.apache.xalan.xslt.XSLTProcessor,15,36,210,0.17142857142857143,1,0.06666666666666667,643,42.86666666666667,174,0.8285714285714286,0.05494505494505495,0.0036630036630036634,0.17783764237479213,0.0008767373553593292,3,14,17
org.apache.xml.dtm.ref.DTMNodeList,4,5,12,0.4166666666666667,1,0.25,643,160.75,7,0.5833333333333334,0.0,0.0,0.30256631433561343,0.0006862108500400758,6,3,9
org.apache.xml.utils.NamespaceSupport2,4,6,12,0.5,1,0.25,643,160.75,6,0.5,0.3333333333333333,0.08333333333333333,0.17088076153798432,0.002947080281163521,4,3,7
org.apache.xalan.extensions.ExtensionHandlerJava,3,3,6,0.5,1,0.3333333333333333,644,214.66666666666666,3,0.5,0.0,0.0,0.0022497187851518562,1.2667335501981172e-06,2,2,4
org.apache.xalan.xsltc.trax.Util,6,11,30,0.36666666666666664,1,0.16666666666666666,643,107.16666666666667,19,0.6333333333333333,0.0,0.0,0.15105446002923104,3.382939421667431e-05,2,5,7
org.apache.xpath.axes.OneStepIteratorForward,9,21,72,0.2916666666666667,1,0.1111111111111111,643,71.44444444444444,51,0.7083333333333334,0.04464285714285714,0.00496031746031746,0.25304849714298533,0.008846175764974313,4,8,12
org.apache.xpath.objects.XNull,6,15,30,0.5,1,0.16666666666666666,643,107.16666666666667,15,0.5,0.0,0.0,0.16116536340215537,5.1356560257621526e-05,2,5,7
org.apache.xalan.templates.ElemOtherwise,4,6,12,0.5,1,0.25,643,160.75,6,0.5,0.0,0.0,0.1591123014479878,3.8897226073496214e-07,1,3,4
org.apache.xpath.XPathVisitable,2,1,2,0.5,1,0.5,643,321.5,1,0.5,0.0,0.0,0.24748613079711784,5.571616932696797e-06,13,1,14
org.apache.xalan.transformer.KeyIterator,10,20,90,0.2222222222222222,1,0.1,643,64.3,70,0.7777777777777778,0.0,0.0,0.1277169200311057,0.00017657420827241793,2,9,11
org.apache.xpath.operations.Neg,6,16,30,0.5333333333333333,1,0.16666666666666666,643,107.16666666666667,14,0.4666666666666667,0.0,0.0,0.1830921215013034,1.84976200036954e-05,1,5,6
org.apache.xml.dtm.ref.DTMNodeIterator,6,7,30,0.23333333333333334,1,0.16666666666666666,643,107.16666666666667,23,0.7666666666666667,0.0,0.0,0.24926105471614923,0.000973576650687525,7,5,12
org.apache.xpath.functions.FuncFloor,6,13,30,0.43333333333333335,1,0.16666666666666666,644,107.33333333333333,17,0.5666666666666667,0.0,0.0,0.0,0.0,0,5,5
org.apache.xalan.lib.ExsltCommon,8,13,56,0.23214285714285715,1,0.125,649,81.125,43,0.7678571428571429,0.0,0.0,0.0,0.0,0,7,7
org.apache.xpath.VariableStack,12,52,132,0.3939393939393939,1,0.08333333333333333,643,53.583333333333336,80,0.6060606060606061,0.16599567099567097,0.01383297258297258,0.25996104145518395,0.09545224526127583,20,11,31
org.apache.xpath.axes.OneStepIterator,11,31,110,0.2818181818181818,1,0.09090909090909091,643,58.45454545454545,79,0.7181818181818181,0.05925925925925927,0.005387205387205388,0.23170440651440308,0.0015320302410922807,3,10,13
org.apache.xalan.xsltc.trax.TransformerHandlerImpl,8,22,56,0.39285714285714285,1,0.125,643,80.375,34,0.6071428571428571,0.0,0.0,0.15096887676575838,6.966602264217558e-05,1,7,8
org.apache.xalan.processor.ProcessorText,6,11,30,0.36666666666666664,1,0.16666666666666666,643,107.16666666666667,19,0.6333333333333333,0.0,0.0,0.15908063730839614,2.613713505320306e-05,1,5,6
org.apache.xalan.xsltc.runtime.ErrorMessages,3,3,6,0.5,1,0.3333333333333333,644,214.66666666666666,3,0.5,0.0,0.0,0.0011248593925759281,0.0,1,2,3
org.apache.xml.utils.res.XResources_ja_JP_HA,2,2,2,1.0,1,0.5,644,322.0,0,0.0,0.0,0.0,0.0,0.0,0,1,1
org.apache.xalan.templates.ElemUnknown,4,5,12,0.4166666666666667,1,0.25,643,160.75,7,0.5833333333333334,0.0,0.0,0.1591123014479878,1.1977343524837283e-05,1,3,4
org.apache.xalan.xsltc.compiler.PositionCall,9,24,72,0.3333333333333333,1,0.1111111111111111,643,71.44444444444444,48,0.6666666666666666,0.03571428571428571,0.003968253968253968,0.15223389877636462,0.0005089458289155982,1,8,9
org.apache.xalan.templates.ElemVariablePsuedo,8,23,56,0.4107142857142857,1,0.125,643,80.375,33,0.5892857142857143,0.0,0.0,0.1561594456875739,0.0011496804748580126,1,7,8
org.apache.xalan.templates.XSLTVisitor,7,18,42,0.42857142857142855,1,0.14285714285714285,643,91.85714285714286,24,0.5714285714285714,0.6333333333333333,0.09047619047619047,0.20181272468434502,0.006178790638413037,19,6,25
org.apache.xalan.xsltc.compiler.DocumentCall,12,46,132,0.3484848484848485,1,0.08333333333333333,644,53.666666666666664,86,0.6515151515151515,0.0,0.0,0.0,0.0,0,11,11
org.apache.xalan.xsltc.dom.Axis,1,0,0,0,1,1.0,-1,-1.0,0,0,0.0,0.0,0.21220281786810544,0.0,16,0,16
org.apache.xalan.xsltc.compiler.GenerateIdCall,5,7,20,0.35,1,0.2,644,128.8,13,0.65,0.0,0.0,0.0,0.0,0,4,4
org.apache.xalan.trace.TracerEvent,7,16,42,0.38095238095238093,1,0.14285714285714285,643,91.85714285714286,26,0.6190476190476191,0.0,0.0,0.16839692489460517,0.001094314634847002,4,6,10
org.apache.xalan.processor.ProcessorKey,11,32,110,0.2909090909090909,1,0.09090909090909091,643,58.45454545454545,78,0.7090909090909091,0.0,0.0,0.15908063730839614,9.027432620339485e-05,1,10,11
org.apache.xpath.objects.XRTreeFragSelectWrapper,10,32,90,0.35555555555555557,1,0.1,643,64.3,58,0.6444444444444445,0.0,0.0,0.1868583923503251,2.255739886164907e-05,1,9,10
org.apache.xalan.transformer.KeyRefIterator,17,52,272,0.19117647058823528,1,0.058823529411764705,643,37.8235294117647,220,0.8088235294117647,0.0,0.0,0.1276149748522814,0.00016715584091986797,1,16,17
org.apache.xalan.processor.ProcessorPreserveSpace,8,19,56,0.3392857142857143,1,0.125,643,80.375,37,0.6607142857142857,0.0,0.0,0.15914397819524004,0.0006080440179704837,2,7,9
org.apache.xpath.operations.Plus,6,16,30,0.5333333333333333,1,0.16666666666666666,643,107.16666666666667,14,0.4666666666666667,0.0,0.0,0.18317603173113903,2.677711759637579e-05,2,5,7
org.apache.xalan.transformer.TreeWalker2Result,7,15,42,0.35714285714285715,1,0.14285714285714285,643,91.85714285714286,27,0.6428571428571429,0.0,0.0,0.1363199526730373,0.0,1,6,7
org.apache.xalan.xsltc.compiler.IntExpr,8,22,56,0.39285714285714285,1,0.125,644,80.5,34,0.6071428571428571,0.0,0.0,0.0,0.0,0,7,7
org.apache.xalan.processor.ProcessorExsltFunction,16,58,240,0.24166666666666667,1,0.0625,643,40.1875,182,0.7583333333333333,0.0,0.0,0.15908063730839614,2.7003325563236037e-05,1,15,16
org.apache.xalan.templates.ElemChoose,12,44,132,0.3333333333333333,1,0.08333333333333333,643,53.583333333333336,88,0.6666666666666666,0.0,0.0,0.1591123014479878,1.9062820695398208e-05,1,11,12
org.apache.xpath.compiler.Keywords,4,5,12,0.4166666666666667,1,0.25,643,160.75,7,0.5833333333333334,0.16666666666666666,0.041666666666666664,0.16681556812910905,1.8597515599932034e-05,5,3,8
org.apache.xpath.functions.FuncExtFunctionAvailable,10,17,90,0.18888888888888888,1,0.1,644,64.4,73,0.8111111111111111,0.0,0.0,0.0,0.0,0,9,9
org.apache.xalan.xsltc.compiler.TransletOutput,14,61,182,0.33516483516483514,1,0.07142857142857142,644,46.0,121,0.6648351648351648,0.0,0.0,0.0,0.0,0,13,13
org.apache.xalan.lib.Extensions,17,54,272,0.19852941176470587,1,0.058823529411764705,648,38.11764705882353,218,0.8014705882352942,0.0,0.0,0.0022497187851518562,0.0008243822415339492,2,16,18
org.apache.xalan.xsltc.trax.TransformerImpl,18,59,306,0.19281045751633988,1,0.05555555555555555,643,35.72222222222222,247,0.8071895424836601,0.051470588235294115,0.0028594771241830064,0.20475927317486953,0.08991151698572895,51,17,68
org.apache.xalan.xsltc.runtime.output.StreamTextOutput,4,7,12,0.5833333333333334,1,0.25,643,160.75,5,0.4166666666666667,0.0,0.0,0.14544763509364825,1.4074817224423523e-07,1,3,4
org.apache.xpath.patterns.StepPattern,17,56,272,0.20588235294117646,1,0.058823529411764705,643,37.8235294117647,216,0.7941176470588235,0.21180555555555552,0.012459150326797383,0.2408497145148209,0.011304180564436857,11,16,27
org.apache.xpath.functions.FunctionDef1Arg,10,26,90,0.28888888888888886,1,0.1,644,64.4,64,0.7111111111111111,0.0,0.0,0.010123734533183352,4.994097021656077e-05,9,9,18
org.apache.xalan.templates.ElemSort,11,32,110,0.2909090909090909,1,0.09090909090909091,643,58.45454545454545,78,0.7090909090909091,0.0,0.0,0.17442291129711776,6.633395362333472e-05,3,10,13
org.apache.xalan.templates.ElemExtensionDecl,15,57,210,0.2714285714285714,1,0.06666666666666667,643,42.86666666666667,153,0.7285714285714285,0.0,0.0,0.15978017239150324,4.739432250318766e-05,2,14,16
org.apache.xalan.processor.ProcessorAttributeSet,6,12,30,0.4,1,0.16666666666666666,643,107.16666666666667,18,0.6,0.0,0.0,0.15908063730839614,7.216308047165085e-05,1,5,6
org.apache.xalan.templates.WhiteSpaceInfo,7,24,42,0.5714285714285714,1,0.14285714285714285,643,91.85714285714286,18,0.42857142857142855,0.041666666666666664,0.005952380952380952,0.20397555561997718,0.0002663434478504851,6,6,12
org.apache.xalan.xsltc.cmdline.getopt.GetOpt,6,9,30,0.3,1,0.16666666666666666,649,108.16666666666667,21,0.7,0.0,0.0,0.0011248593925759281,5.066934200792469e-06,1,5,6
org.apache.xalan.xpath.XRTreeFrag,6,19,30,0.6333333333333333,1,0.16666666666666666,644,107.33333333333333,11,0.36666666666666664,0.0,0.0,0.0,0.0,0,5,5
org.apache.xalan.xsltc.compiler.AlternativePattern,10,32,90,0.35555555555555557,1,0.1,643,64.3,58,0.6444444444444445,0.0,0.0,0.15543072185002735,1.460549085110721e-06,1,9,10
org.apache.xalan.xsltc.compiler.Attribute,5,6,20,0.3,1,0.2,644,128.8,14,0.7,0.0,0.0,0.0,0.0,0,4,4
org.apache.xml.utils.XMLString,2,2,2,1.0,1,0.5,643,321.5,0,0.0,0.0,0.0,0.33210644057943106,0.006103130641993795,39,2,41
org.apache.xml.utils.NodeConsumer,2,1,2,0.5,1,0.5,643,321.5,1,0.5,0.0,0.0,0.1682551468058705,2.6871516855305648e-06,3,1,4
org.apache.xalan.xsltc.compiler.Otherwise,10,32,90,0.35555555555555557,1,0.1,643,64.3,58,0.6444444444444445,0.0,0.0,0.13036206824440488,9.78839561516727e-07,1,9,10
org.apache.xpath.functions.FuncNamespace,7,21,42,0.5,1,0.14285714285714285,645,92.14285714285714,21,0.5,0.0,0.0,0.0,0.0,0,6,6
org.apache.xpath.compiler.FunctionTable,7,15,42,0.35714285714285715,1,0.14285714285714285,643,91.85714285714286,27,0.6428571428571429,0.13333333333333333,0.019047619047619046,0.19336724781680956,0.0013639527798675881,5,6,11
org.apache.xml.utils.res.XResourceBundle,2,2,2,1.0,1,0.5,643,321.5,0,0.0,0.0,0.0,0.14163362907063975,0.00978931687593105,15,2,17
org.apache.xalan.xsltc.compiler.WithParam,14,60,182,0.32967032967032966,1,0.07142857142857142,643,45.92857142857143,122,0.6703296703296703,0.0,0.0,0.1558853748975606,1.4297463189721225e-06,1,13,14
org.apache.xalan.lib.PipeDocument,13,41,156,0.26282051282051283,1,0.07692307692307693,646,49.69230769230769,115,0.7371794871794872,0.0,0.0,0.0,0.0,0,12,12
org.apache.xalan.xsltc.compiler.Variable,16,95,240,0.3958333333333333,1,0.0625,643,40.1875,145,0.6041666666666666,0.08476190476190477,0.005297619047619048,0.22285480972252317,0.00016511037507605048,10,15,25
org.apache.xpath.objects.XNodeSet,23,78,506,0.1541501976284585,1,0.043478260869565216,643,27.956521739130434,428,0.8458498023715415,0.6038961038961039,0.026256352343308868,0.3016529065942229,0.01817543409762422,24,22,46
org.apache.xpath.objects.Comparator,2,2,2,1.0,1,0.5,643,321.5,0,0.0,0.0,0.0,0.23070135713555284,0.0,7,1,8
org.apache.xalan.templates.ElemNumber,29,136,812,0.16748768472906403,1,0.034482758620689655,643,22.17241379310345,676,0.8325123152709359,0.10802469135802467,0.0037249893571732647,0.162906093840369,0.005790521058671376,4,28,32
org.apache.xpath.compiler.OpCodes,1,0,0,0,1,1.0,-1,-1.0,0,0,0.0,0.0,0.2044597704184655,0.0,9,0,9
org.apache.xalan.xsltc.compiler.ApplyTemplates,20,132,380,0.3473684210526316,1,0.05,643,32.15,248,0.6526315789473685,0.008869395711500973,0.00044346978557504863,0.15597662487311037,0.0022082418462708183,2,19,21
org.apache.xml.dtm.ref.DTMSafeStringPool,3,3,6,0.5,1,0.3333333333333333,643,214.33333333333334,3,0.5,0.0,0.0,0.15876468768116994,0.0,1,2,3
org.apache.xalan.templates.ElemIf,15,58,210,0.2761904761904762,1,0.06666666666666667,643,42.86666666666667,152,0.7238095238095238,0.0,0.0,0.15908063730839614,2.3739258677523186e-05,1,14,15
org.apache.xalan.xsltc.dom.DOMAdapter,10,26,90,0.28888888888888886,1,0.1,643,64.3,64,0.7111111111111111,0.0,0.0,0.15658769881972393,0.001801892282769673,4,9,13
org.apache.xml.utils.NameSpace,2,1,2,0.5,1,0.5,643,321.5,1,0.5,0.0,0.0,0.19454373387069618,0.0,1,1,2
org.apache.xpath.operations.Bool,6,15,30,0.5,1,0.16666666666666666,643,107.16666666666667,15,0.5,0.0,0.0,0.1830921215013034,3.547223674065759e-05,1,5,6
org.apache.xalan.xsltc.compiler.ConcatCall,9,25,72,0.3472222222222222,1,0.1111111111111111,644,71.55555555555556,47,0.6527777777777778,0.0,0.0,0.0,0.0,0,8,8
org.apache.xalan.lib.Redirect,11,35,110,0.3181818181818182,1,0.09090909090909091,646,58.72727272727273,75,0.6818181818181818,0.0,0.0,0.0,0.0,0,10,10
org.apache.xalan.xsltc.compiler.Whitespace,13,43,156,0.27564102564102566,1,0.07692307692307693,643,49.46153846153846,113,0.7243589743589743,0.08333333333333334,0.006410256410256411,0.18568645818227425,0.001568976116238962,2,12,14
org.apache.xpath.DOMOrder,1,0,0,0,1,1.0,-1,-1.0,0,0,0.0,0.0,0.15233419016539282,0.0,1,0,1
org.apache.xalan.trace.PrintTraceListener,19,76,342,0.2222222222222222,1,0.05263157894736842,644,33.89473684210526,266,0.7777777777777778,0.0,0.0,0.0022497187851518562,0.00026921569293230675,2,18,20
org.apache.xalan.xsltc.compiler.VariableBase,13,60,156,0.38461538461538464,1,0.07692307692307693,643,49.46153846153846,96,0.6153846153846154,0.13888888888888892,0.010683760683760686,0.22587742370011038,0.00027860650381392367,16,13,29
org.apache.xalan.xsltc.compiler.SourceLoader,2,1,2,0.5,1,0.5,643,321.5,1,0.5,0.0,0.0,0.197621805308947,7.646350069659688e-06,6,1,7
org.apache.xpath.operations.Lte,5,11,20,0.55,1,0.2,643,128.6,9,0.45,0.0,0.0,0.18313406700451104,1.9356352672609055e-05,1,4,5
org.apache.xalan.xsltc.compiler.FilterParentPath,14,71,182,0.3901098901098901,1,0.07142857142857142,643,45.92857142857143,111,0.6098901098901099,0.0,0.0,0.15600706527609107,3.7137551198293607e-06,2,13,15
org.apache.xalan.xsltc.compiler.LocationPathPattern,10,39,90,0.43333333333333335,1,0.1,643,64.3,51,0.5666666666666667,0.0,0.0,0.17595866222203185,0.0008555342272589017,6,10,16
org.apache.xalan.xsltc.trax.TemplatesHandlerImpl,11,42,110,0.38181818181818183,1,0.09090909090909091,643,58.45454545454545,68,0.6181818181818182,0.05555555555555556,0.005050505050505051,0.15094037055790988,0.0002868499707263949,1,10,11
org.apache.xalan.templates.ElemTemplate,18,96,306,0.3137254901960784,1,0.05555555555555555,643,35.72222222222222,210,0.6862745098039216,0.07138480392156862,0.0039658224400871455,0.20591968121450044,0.003908968631071527,22,17,39
org.apache.xalan.xsltc.compiler.XslElement,15,78,210,0.37142857142857144,1,0.06666666666666667,643,42.86666666666667,132,0.6285714285714286,0.0,0.0,0.1834703241851482,0.0005471949612504171,1,14,15
org.apache.xml.dtm.ref.IncrementalSAXSource,1,0,0,0,1,1.0,-1,-1.0,0,0,0.0,0.0,0.17990072749662467,0.0,6,0,6
org.apache.xalan.xsltc.compiler.util.ResultTreeType,16,116,240,0.48333333333333334,1,0.0625,643,40.1875,124,0.5166666666666667,0.02142857142857143,0.0013392857142857143,0.22033632923778684,4.8970840400895515e-05,9,15,24
org.apache.xalan.xsltc.compiler.IdKeyPattern,12,42,132,0.3181818181818182,1,0.08333333333333333,643,53.583333333333336,90,0.6818181818181818,0.08181818181818182,0.006818181818181818,0.15567287292593782,0.002045540507743371,3,11,14
org.apache.xml.utils.res.XResources_ka,2,2,2,1.0,1,0.5,644,322.0,0,0.0,0.0,0.0,0.0,0.0,0,1,1
org.apache.xalan.templates.ElemAttribute,14,63,182,0.34615384615384615,1,0.07142857142857142,643,45.92857142857143,119,0.6538461538461539,0.0,0.0,0.16846790357738475,0.0001377230392660088,2,13,15
org.apache.xml.utils.StringVector,2,1,2,0.5,1,0.5,643,321.5,1,0.5,0.0,0.0,0.2278085501495271,4.002652600998632e-05,8,1,9
org.apache.xalan.xsltc.dom.DupFilterIterator,5,9,20,0.45,1,0.2,643,128.6,11,0.55,0.0,0.0,0.15512909033081518,8.085982495431315e-05,1,4,5
org.apache.xalan.serialize.EncodingInfo,2,1,2,0.5,1,0.5,643,321.5,1,0.5,0.0,0.0,0.15074112813024526,0.0,1,1,2
org.apache.xalan.xsltc.compiler.RelationalExpr,23,170,506,0.3359683794466403,1,0.043478260869565216,644,28.0,336,0.6640316205533597,0.0,0.0,0.0,0.0,0,22,22
org.apache.xalan.xsltc.DOM,6,8,30,0.26666666666666666,1,0.16666666666666666,643,107.16666666666667,22,0.7333333333333333,0.2,0.03333333333333333,0.22100641483956057,0.005410585844503681,25,5,30
org.apache.xalan.xsltc.DOMCache,3,3,6,0.5,1,0.3333333333333333,643,214.33333333333334,3,0.5,0.0,0.0,0.17161447026077517,9.576505639497765e-05,4,2,6
org.apache.xpath.axes.NodeSequence,9,25,72,0.3472222222222222,1,0.1111111111111111,643,71.44444444444444,47,0.6527777777777778,0.0,0.0,0.23776924523339996,0.0002086977019114323,9,8,17
org.apache.xalan.xsltc.runtime.DefaultSAXOutputHandler,4,7,12,0.5833333333333334,1,0.25,643,160.75,5,0.4166666666666667,0.0,0.0,0.14584568554546445,0.00014336709359206548,6,3,9
org.apache.xalan.templates.ElemLiteralResult,15,49,210,0.23333333333333334,1,0.06666666666666667,643,42.86666666666667,161,0.7666666666666667,0.18681318681318682,0.012454212454212455,0.16762008858768937,0.0007385094294323011,7,14,21
org.apache.xml.utils.SAXSourceLocator,2,1,2,0.5,1,0.5,643,321.5,1,0.5,0.0,0.0,0.26338721663087006,0.00020279925480920093,9,1,10
org.apache.xalan.xsltc.compiler.FunctionAvailableCall,14,54,182,0.2967032967032967,1,0.07142857142857142,644,46.0,128,0.7032967032967034,0.0,0.0,0.0,0.0,0,13,13
org.apache.xalan.templates.ElemExtensionScript,4,6,12,0.5,1,0.25,643,160.75,6,0.5,0.0,0.0,0.15949325667890873,3.8897226073496214e-07,2,3,5
org.apache.xpath.axes.WalkingIterator,13,48,156,0.3076923076923077,1,0.07692307692307693,643,49.46153846153846,108,0.6923076923076923,0.03977272727272727,0.0030594405594405595,0.19650447455130057,0.0009514944419495138,8,12,20
org.apache.xalan.xsltc.compiler.Template,16,84,240,0.35,1,0.0625,643,40.1875,156,0.65,0.07501133786848074,0.0046882086167800464,0.22291695551441457,0.0009480607824126059,11,16,27
org.apache.xalan.trace.SelectionEvent,6,11,30,0.36666666666666664,1,0.16666666666666666,643,107.16666666666667,19,0.6333333333333333,0.0,0.0,0.1684324067582576,0.00046753681130141944,4,5,9
org.apache.xml.utils.synthetic.SynthesisException,2,1,2,0.5,1,0.5,643,321.5,1,0.5,0.0,0.0,0.1494168602756431,0.0,5,1,6
org.apache.xalan.xsltc.dom.Filter,1,0,0,0,1,1.0,-1,-1.0,0,0,0.0,0.0,0.15537673846615596,0.0,2,0,2
org.apache.xpath.axes.WalkingIteratorSorted,7,22,42,0.5238095238095238,1,0.14285714285714285,643,91.85714285714286,20,0.47619047619047616,0.01111111111111111,0.001587301587301587,0.17202070206040254,3.166833875495293e-07,1,6,7
org.apache.xalan.templates.NamespaceAlias,5,14,20,0.7,1,0.2,643,128.6,6,0.3,0.041666666666666664,0.008333333333333333,0.20059729045788974,4.501243559914641e-05,5,4,9
org.apache.xalan.xsltc.compiler.util.ErrorMsg,4,10,12,0.8333333333333334,1,0.25,643,160.75,2,0.16666666666666666,0.0,0.0,0.29110713855596887,0.007694248425551829,69,3,72
org.apache.xalan.transformer.TrAXFilter,5,10,20,0.5,1,0.2,643,128.6,10,0.5,0.0,0.0,0.1708077355715151,0.0,1,4,5
org.apache.xalan.xsltc.dom.DocumentCache,9,23,72,0.3194444444444444,1,0.1111111111111111,645,71.66666666666667,49,0.6805555555555556,0.0625,0.006944444444444444,0.003374578177727784,0.00027813246317183324,3,8,11
org.apache.xml.dtm.DTMAxisIterator,1,1,0,0,1,1.0,-1,-1.0,-1,0,0.0,0.0,0.26462280061755816,0.0,26,1,27
org.apache.xalan.lib.sql.QueryParameter,2,1,2,0.5,1,0.5,644,322.0,1,0.5,0.0,0.0,0.0011248593925759281,0.0,1,1,2
org.apache.xalan.xsltc.compiler.If,13,59,156,0.3782051282051282,1,0.07692307692307693,643,49.46153846153846,97,0.6217948717948718,0.0,0.0,0.1509973937428581,1.866242540661915e-05,1,12,13
org.apache.xalan.processor.StopParseException,1,0,0,0,1,1.0,-1,-1.0,0,0,0.0,0.0,0.1713230361919962,0.0,2,0,2
org.apache.xml.utils.res.XResources_he,2,2,2,1.0,1,0.5,644,322.0,0,0.0,0.0,0.0,0.0,0.0,0,1,1
org.apache.xalan.processor.StylesheetPIHandler,4,4,12,0.3333333333333333,1,0.25,643,160.75,8,0.6666666666666666,0.0,0.0,0.1709538499732016,0.0,1,3,4
org.apache.xalan.xsltc.compiler.CastExpr,16,72,240,0.3,1,0.0625,643,40.1875,168,0.7,0.0,0.0,0.20709331670328773,0.0071255732848418355,33,15,48
org.apache.xml.utils.res.XResources_hy,2,2,2,1.0,1,0.5,644,322.0,0,0.0,0.0,0.0,0.0,0.0,0,1,1
org.apache.xalan.templates.ElemValueOf,19,93,342,0.2719298245614035,1,0.05263157894736842,643,33.8421052631579,249,0.7280701754385965,0.03474945533769064,0.0018289187019837178,0.19037394676701372,0.00019513100796651476,4,18,22
org.apache.xalan.xsltc.runtime.Parameter,2,1,2,0.5,1,0.5,643,321.5,1,0.5,0.0,0.0,0.14571276020318824,0.0,2,1,3
org.apache.xalan.xsltc.compiler.FlowList,1,1,0,0,1,1.0,-1,-1.0,-1,0,0.0,0.0,0.26638226072804727,0.0,27,1,28
org.apache.xalan.templates.Constants,1,0,0,0,1,1.0,-1,-1.0,0,0,0.0,0.0,0.20932022995558155,0.0,51,0,51
org.apache.xalan.templates.ElemFallback,7,19,42,0.4523809523809524,1,0.14285714285714285,643,91.85714285714286,23,0.5476190476190477,0.0,0.0,0.15987604049493814,3.968652209787948e-05,3,6,9
org.apache.xpath.objects.LessThanComparator,3,4,6,0.6666666666666666,1,0.3333333333333333,643,214.33333333333334,2,0.3333333333333333,0.0,0.0,0.22911441744760408,0.0,1,2,3
org.apache.xalan.templates.ElemEmpty,2,2,2,1.0,1,0.5,644,322.0,0,0.0,0.0,0.0,0.0,0.0,0,1,1
org.apache.xalan.xpath.xml.FormatterToXML,2,3,2,1.5,1,0.5,643,321.5,-1,-0.5,0.0,0.0,0.17799603706851275,0.000375168151895969,4,2,6
org.apache.xalan.res.XSLTErrorResources,2,1,2,0.5,1,0.5,643,321.5,1,0.5,0.0,0.0,0.29541027438089085,0.0016384669156234413,75,1,76
org.apache.xalan.xsltc.compiler.UnsupportedElement,13,59,156,0.3782051282051282,1,0.07692307692307693,643,49.46153846153846,97,0.6217948717948718,0.14141414141414144,0.01087801087801088,0.21876852831819668,0.001071631747908099,1,12,13
org.apache.xalan.xsltc.compiler.Closure,3,5,6,0.8333333333333334,1,0.3333333333333333,643,214.33333333333334,1,0.16666666666666666,0.0,0.0,0.20560190392867558,1.65621847306194e-05,7,3,10
org.apache.xalan.templates.ElemText,5,9,20,0.45,1,0.2,643,128.6,11,0.55,0.0,0.0,0.15923908415830493,4.466947125216455e-05,3,4,7
org.apache.xalan.xsltc.compiler.BooleanCall,8,18,56,0.32142857142857145,1,0.125,644,80.5,38,0.6785714285714286,0.0,0.0,0.0,0.0,0,7,7
org.apache.xpath.XPathProcessorException,3,3,6,0.5,1,0.3333333333333333,643,214.33333333333334,3,0.5,0.0,0.0,0.16598426131118993,2.0584420190719403e-06,3,2,5
org.apache.xalan.transformer.TransformerIdentityImpl,14,38,182,0.2087912087912088,1,0.07142857142857142,643,45.92857142857143,144,0.7912087912087912,0.0,0.0,0.17084424075116278,0.00016912861993871332,1,13,14
org.apache.xpath.operations.Minus,6,16,30,0.5333333333333333,1,0.16666666666666666,643,107.16666666666667,14,0.4666666666666667,0.0,0.0,0.18317603173113903,2.677711759637579e-05,2,5,7
org.apache.xalan.xsltc.compiler.util.MatchGenerator,5,13,20,0.65,1,0.2,643,128.6,7,0.35,0.0,0.0,0.18389238612254213,0.0,1,4,5
org.apache.xpath.compiler.OpMap,6,9,30,0.3,1,0.16666666666666666,643,107.16666666666667,21,0.7,0.0,0.0,0.20931662803736334,6.306529669321352e-05,12,5,17
org.apache.xalan.xsltc.compiler.util.Util,4,6,12,0.5,1,0.25,643,160.75,6,0.5,0.0,0.0,0.2301699402460958,0.00031000095307365786,43,3,46
org.apache.xalan.xsltc.compiler.FilteredAbsoluteLocationPath,11,48,110,0.43636363636363634,1,0.09090909090909091,644,58.54545454545455,62,0.5636363636363636,0.0,0.0,0.0,0.0,0,10,10
org.apache.xpath.functions.FuncCurrent,10,40,90,0.4444444444444444,1,0.1,643,64.3,50,0.5555555555555556,0.0,0.0,0.134214271738531,3.387656527481441e-05,1,9,10
org.apache.xalan.templates.ElemCopyOf,22,108,462,0.23376623376623376,1,0.045454545454545456,643,29.227272727272727,354,0.7662337662337663,0.0,0.0,0.15908063730839614,0.001185248315871021,1,21,22
org.apache.xalan.xsltc.compiler.UseAttributeSets,12,54,132,0.4090909090909091,1,0.08333333333333333,643,53.583333333333336,78,0.5909090909090909,0.004545454545454545,0.0003787878787878788,0.18525613035334662,3.399008878652667e-05,5,11,16
org.apache.xpath.functions.Function2Args,7,12,42,0.2857142857142857,1,0.14285714285714285,643,91.85714285714286,30,0.7142857142857143,0.13333333333333333,0.019047619047619046,0.15334360300684646,0.0027242302324540727,8,6,14
org.apache.xpath.objects.XBoolean,6,16,30,0.5333333333333333,1,0.16666666666666666,643,107.16666666666667,14,0.4666666666666667,0.041666666666666664,0.006944444444444444,0.23435362136461174,0.0012495199338713174,24,5,29
org.apache.xpath.axes.UnionPathIterator,21,93,420,0.22142857142857142,1,0.047619047619047616,643,30.61904761904762,327,0.7785714285714286,0.14122807017543856,0.006725146198830407,0.23854974708286802,0.017652328788285203,4,20,24
org.apache.xalan.xsltc.compiler.TestSeq,11,46,110,0.41818181818181815,1,0.09090909090909091,643,58.45454545454545,64,0.5818181818181818,0.014814814814814815,0.0013468013468013469,0.15537030174435193,9.224032002434702e-07,1,10,11
org.apache.xml.dtm.ref.ExpandedNameTable,6,10,30,0.3333333333333333,1,0.16666666666666666,643,107.16666666666667,20,0.6666666666666666,0.0,0.0,0.1904192954918272,0.0029325547547403544,12,5,17
org.apache.xalan.processor.ProcessorDecimalFormat,6,12,30,0.4,1,0.16666666666666666,643,107.16666666666667,18,0.6,0.0,0.0,0.15908063730839614,7.216308047165085e-05,1,5,6
org.apache.xalan.xsltc.dom.SortingIterator,6,11,30,0.36666666666666664,1,0.16666666666666666,646,107.66666666666667,19,0.6333333333333333,0.0,0.0,0.0,0.0,0,5,5
org.apache.xalan.xsltc.runtime.ErrorMessages_no,4,6,12,0.5,1,0.25,645,161.25,6,0.5,0.0,0.0,0.0,0.0,0,3,3
org.apache.xml.utils.res.XResources_el,2,2,2,1.0,1,0.5,644,322.0,0,0.0,0.0,0.0,0.0,0.0,0,1,1
org.apache.xml.dtm.DTMDOMException,2,1,2,0.5,1,0.5,643,321.5,1,0.5,0.0,0.0,0.20752341704950433,0.00026415918570024314,3,1,4
org.apache.xalan.xsltc.dom.ReverseIterator,3,4,6,0.6666666666666666,1,0.3333333333333333,644,214.66666666666666,2,0.3333333333333333,0.0,0.0,0.0,0.0,0,2,2
org.apache.xpath.XPathException,4,6,12,0.5,1,0.25,643,160.75,6,0.5,0.0,0.0,0.29838753358517756,0.00040741875448381065,4,3,7
org.apache.xalan.xsltc.trax.XSLTCSource,6,10,30,0.3333333333333333,1,0.16666666666666666,643,107.16666666666667,20,0.6666666666666666,0.0,0.0,0.16857448386222915,0.0,1,5,6
org.apache.xalan.templates.XUnresolvedVariable,11,47,110,0.42727272727272725,1,0.09090909090909091,643,58.45454545454545,63,0.5727272727272728,0.0022222222222222222,0.00020202020202020202,0.17370278193713398,1.3534403150174862e-06,1,10,11
org.apache.xml.utils.MutableAttrListImpl,3,3,6,0.5,1,0.3333333333333333,643,214.33333333333334,3,0.5,0.0,0.0,0.16323875892887293,0.0008779693535426548,2,2,4
org.apache.xalan.serialize.ElemDesc,3,3,6,0.5,1,0.3333333333333333,643,214.33333333333334,3,0.5,0.0,0.0,0.14992126828107477,0.00031055553169706947,1,2,3
org.apache.xalan.transformer.Counter,5,11,20,0.55,1,0.2,643,128.6,9,0.45,0.0,0.0,0.14705301737945006,0.0,1,4,5
org.apache.xalan.xsltc.compiler.NotCall,6,10,30,0.3333333333333333,1,0.16666666666666666,644,107.33333333333333,20,0.6666666666666666,0.0,0.0,0.0011248593925759281,1.4356313568911995e-05,1,5,6
org.apache.xalan.templates.ElemUse,9,34,72,0.4722222222222222,1,0.1111111111111111,643,71.44444444444444,38,0.5277777777777778,0.008928571428571428,0.000992063492063492,0.16875241766406812,5.232333972516658e-05,4,8,12
org.apache.xpath.functions.Function3Args,7,12,42,0.2857142857142857,1,0.14285714285714285,643,91.85714285714286,30,0.7142857142857143,0.13333333333333333,0.019047619047619046,0.1317370142509378,0.001460503044283604,5,6,11
org.apache.xpath.objects.XObjectFactory,15,54,210,0.2571428571428571,1,0.06666666666666667,643,42.86666666666667,156,0.7428571428571429,0.18956043956043958,0.01263736263736264,0.2974991449477822,0.005700077615353565,1,14,15
org.apache.xalan.templates.TemplateList,22,102,462,0.22077922077922077,1,0.045454545454545456,643,29.227272727272727,360,0.7792207792207793,0.11765873015873016,0.005348124098124098,0.1898765326543208,0.006140845293389118,3,21,24
org.apache.xml.dtm.DTMConfigurationException,3,3,6,0.5,1,0.3333333333333333,643,214.33333333333334,3,0.5,0.0,0.0,0.21506058716026114,0.0007762092767551639,1,2,3
org.apache.xpath.functions.FuncLast,9,28,72,0.3888888888888889,1,0.1111111111111111,643,71.44444444444444,44,0.6111111111111112,0.0,0.0,0.1588593407143662,2.0863435002142705e-05,1,8,9
org.apache.xpath.axes.UnionChildIterator,5,8,20,0.4,1,0.2,643,128.6,12,0.6,0.0,0.0,0.19073734251364607,2.9769400123241766e-05,1,4,5
org.apache.xalan.transformer.QueuedEvents,3,2,6,0.3333333333333333,1,0.3333333333333333,643,214.33333333333334,4,0.6666666666666666,0.0,0.0,0.17400526827920998,0.00016463528404450225,3,2,5
org.apache.xalan.xpath.XNodeSet,11,30,110,0.2727272727272727,1,0.09090909090909091,643,58.45454545454545,80,0.7272727272727273,0.0425925925925926,0.0038720538720538726,0.24157757705490804,0.009623763825232902,7,10,17
org.apache.xpath.functions.FuncNormalizeSpace,8,27,56,0.48214285714285715,1,0.125,645,80.625,29,0.5178571428571429,0.0,0.0,0.0,0.0,0,7,7
org.apache.xalan.xsltc.runtime.output.StreamHTMLOutput,6,12,30,0.4,1,0.16666666666666666,643,107.16666666666667,18,0.6,0.0,0.0,0.14563312123787403,0.0003549467835182141,2,5,7
org.apache.xalan.xsltc.dom.NthIterator,3,4,6,0.6666666666666666,1,0.3333333333333333,644,214.66666666666666,2,0.3333333333333333,0.0,0.0,0.0,0.0,0,2,2
org.apache.xalan.templates.StylesheetComposed,4,10,12,0.8333333333333334,1,0.25,643,160.75,2,0.16666666666666666,0.08333333333333333,0.020833333333333332,0.20591968121450044,8.698528362999001e-05,11,4,15
org.apache.xalan.serialize.Encodings,4,5,12,0.4166666666666667,1,0.25,643,160.75,7,0.5833333333333334,0.0,0.0,0.17895236231804132,0.0010679504281866487,4,3,7
org.apache.xpath.operations.And,6,15,30,0.5,1,0.16666666666666666,643,107.16666666666667,15,0.5,0.0,0.0,0.1830921215013034,3.547223674065759e-05,1,5,6
org.apache.xalan.templates.ElemApplyImport,10,33,90,0.36666666666666664,1,0.1,643,64.3,57,0.6333333333333333,0.0,0.0,0.1591123014479878,1.625655439606074e-05,1,9,10
org.apache.xpath.XPathContext,25,85,600,0.14166666666666666,1,0.04,643,25.72,515,0.8583333333333333,0.18730590062111804,0.007492236024844722,0.3424936600148632,0.17760271376827227,154,24,178
org.apache.xalan.lib.sql.ConnectionPoolManager,5,8,20,0.4,1,0.2,645,129.0,12,0.6,0.0,0.0,0.0022497187851518562,2.7868138104358582e-06,2,4,6
org.apache.xalan.xsltc.dom.ExtendedSAX,1,0,0,0,1,1.0,-1,-1.0,0,0,0.0,0.0,0.1335908369906579,0.0,1,0,1
org.apache.xalan.processor.XSLTSchema,59,174,3422,0.05084745762711865,1,0.01694915254237288,643,10.898305084745763,3248,0.9491525423728814,0.16223028836458966,0.0027496659044845707,0.19105645374634098,0.053363275147379936,3,58,61
org.apache.xalan.xsltc.compiler.util.ErrorMessages_no,4,6,12,0.5,1,0.25,645,161.25,6,0.5,0.0,0.0,0.0,0.0,0,3,3
org.apache.xalan.xsltc.compiler.AncestorPattern,14,56,182,0.3076923076923077,1,0.07142857142857142,643,45.92857142857143,126,0.6923076923076923,0.0,0.0,0.17291373620477843,1.6889780669308228e-06,2,13,15
org.apache.xpath.patterns.ContextMatchStepPattern,10,30,90,0.3333333333333333,1,0.1,643,64.3,60,0.6666666666666666,0.034722222222222224,0.0034722222222222225,0.17202070206040254,1.0504127836012809e-05,1,9,10
org.apache.xalan.xsltc.compiler.util.TypeCheckError,4,9,12,0.75,1,0.25,643,160.75,3,0.25,0.0,0.0,0.2828663136853116,0.0007609310420130522,87,3,90
org.apache.xalan.xsltc.compiler.NameCall,5,7,20,0.35,1,0.2,645,129.0,13,0.65,0.0,0.0,0.0,0.0,0,4,4
org.apache.xalan.xsltc.dom.NodeSortRecordFactory,9,26,72,0.3611111111111111,1,0.1111111111111111,645,71.66666666666667,46,0.6388888888888888,0.0,0.0,0.0011248593925759281,0.000261939385955134,1,8,9
org.apache.xpath.objects.XRTreeFrag,17,63,272,0.23161764705882354,1,0.058823529411764705,643,37.8235294117647,209,0.7683823529411765,0.0,0.0,0.18778017441265932,0.001369100281924445,6,16,22
org.apache.xml.dtm.ref.DTMDefaultBaseIterators,34,81,1122,0.07219251336898395,1,0.029411764705882353,643,18.91176470588235,1041,0.9278074866310161,0.0,0.0,0.17712834089844687,0.050153506637465796,3,33,36
org.apache.xalan.xsltc.compiler.StringLengthCall,6,13,30,0.43333333333333335,1,0.16666666666666666,644,107.33333333333333,17,0.5666666666666667,0.0,0.0,0.0,0.0,0,5,5
org.apache.xalan.xsltc.runtime.AttributeList,3,3,6,0.5,1,0.3333333333333333,643,214.33333333333334,3,0.5,0.0,0.0,0.2350426940531287,0.00010823279687419853,4,2,6
org.apache.xalan.processor.XSLTAttributeDef,14,38,182,0.2087912087912088,1,0.07142857142857142,643,45.92857142857143,144,0.7912087912087912,0.0,0.0,0.15962064745900373,0.0013444676489527479,4,13,17
org.apache.xalan.xsltc.compiler.LiteralExpr,8,22,56,0.39285714285714285,1,0.125,643,80.375,34,0.6071428571428571,0.0,0.0,0.16526363499580127,4.392545446995855e-05,6,7,13
org.apache.xalan.xsltc.compiler.Text,8,25,56,0.44642857142857145,1,0.125,643,80.375,31,0.5535714285714286,0.08333333333333333,0.010416666666666666,0.24223642499233047,0.004559340609062715,8,7,15
org.apache.xml.utils.BoolStack,1,0,0,0,1,1.0,-1,-1.0,0,0,0.0,0.0,0.18314922063313513,0.0,6,0,6
org.apache.xml.utils.PrefixForUriEnumerator,2,2,2,1.0,1,0.5,643,321.5,0,0.0,0.0,0.0,0.14481525407150195,0.0,1,1,2
org.apache.xpath.functions.FuncDoclocation,7,21,42,0.5,1,0.14285714285714285,645,92.14285714285714,21,0.5,0.0,0.0,0.0,0.0,0,6,6
org.apache.xalan.processor.ProcessorStripSpace,8,22,56,0.39285714285714285,1,0.125,643,80.375,34,0.6071428571428571,0.0,0.0,0.15908063730839614,0.0005628324313968517,1,7,8
org.apache.xalan.xsltc.compiler.XSLTC,12,54,132,0.4090909090909091,1,0.08333333333333333,643,53.583333333333336,78,0.5909090909090909,0.019696969696969695,0.0016414141414141414,0.2350426940531287,0.004475732078675445,19,11,30
org.apache.xalan.xslt.XSLTResultTarget,5,9,20,0.45,1,0.2,643,128.6,11,0.55,0.0,0.0,0.1777980877390326,7.493539774371843e-07,2,4,6
org.apache.xml.utils.synthetic.reflection.Constructor,4,7,12,0.5833333333333334,1,0.25,643,160.75,5,0.4166666666666667,0.3333333333333333,0.08333333333333333,0.16136055762508894,0.001531236230413567,3,3,6
org.apache.xalan.xsltc.trax.DOM2SAX,3,2,6,0.3333333333333333,1,0.3333333333333333,643,214.33333333333334,4,0.6666666666666666,0.0,0.0,0.1837655637872852,2.2966434813732298e-05,3,2,5
org.apache.xalan.xsltc.compiler.RoundCall,5,7,20,0.35,1,0.2,644,128.8,13,0.65,0.0,0.0,0.0,0.0,0,4,4
org.apache.xalan.transformer.ResultNameSpace,2,1,2,0.5,1,0.5,644,322.0,1,0.5,0.0,0.0,0.0,0.0,0,1,1
org.apache.xpath.operations.Gte,5,11,20,0.55,1,0.2,643,128.6,9,0.45,0.0,0.0,0.18313406700451104,1.9356352672609055e-05,1,4,5
org.apache.xml.dtm.ref.DTMNodeProxy,11,20,110,0.18181818181818182,1,0.09090909090909091,643,58.45454545454545,90,0.8181818181818182,0.0,0.0,0.18978637285723898,0.010549973711243407,5,10,15
org.apache.xalan.xsltc.compiler.Stylesheet,28,240,756,0.31746031746031744,1,0.03571428571428571,643,22.964285714285715,516,0.6825396825396826,0.2723652890319556,0.009727331751141271,0.2305682729952958,0.018380319675245626,24,27,51
org.apache.xpath.operations.Mod,6,16,30,0.5333333333333333,1,0.16666666666666666,643,107.16666666666667,14,0.4666666666666667,0.0,0.0,0.18317603173113903,2.677711759637579e-05,2,5,7
org.apache.xalan.xsltc.compiler.Message,8,25,56,0.44642857142857145,1,0.125,644,80.5,31,0.5535714285714286,0.0,0.0,0.0,0.0,0,7,7
org.apache.xalan.xpath.xdom.XercesLiaison,8,12,56,0.21428571428571427,1,0.125,644,80.5,44,0.7857142857142857,0.0,0.0,0.0,0.0,0,7,7
org.apache.xpath.compiler.PsuedoNames,1,0,0,0,1,1.0,-1,-1.0,0,0,0.0,0.0,0.19813992093718255,0.0,3,0,3
org.apache.xalan.transformer.TransformerHandlerImpl,11,40,110,0.36363636363636365,1,0.09090909090909091,643,58.45454545454545,70,0.6363636363636364,0.06666666666666667,0.006060606060606061,0.18138874573966204,0.010773348513354812,2,10,12
org.apache.xalan.extensions.XSLProcessorContext,22,86,462,0.18614718614718614,1,0.045454545454545456,644,29.272727272727273,376,0.8138528138528138,0.0,0.0,0.008998875140607425,0.001830074335348511,8,21,29
org.apache.xpath.XPathVisitor,14,47,182,0.25824175824175827,1,0.07142857142857142,643,45.92857142857143,135,0.7417582417582418,0.6891025641025641,0.04922161172161172,0.31372849390686447,0.10035377645990276,29,13,42
org.apache.xalan.xsltc.trax.TemplatesImpl,7,16,42,0.38095238095238093,1,0.14285714285714285,643,91.85714285714286,26,0.6190476190476191,0.08333333333333333,0.011904761904761904,0.15096887676575838,0.0011381280725902122,2,6,8
org.apache.xalan.xsltc.compiler.Key,20,114,380,0.3,1,0.05,643,32.15,266,0.7,0.0,0.0,0.18555715006376292,0.00029155105538934716,1,19,20
org.apache.xalan.xsltc.runtime.AbstractTranslet,18,56,306,0.1830065359477124,1,0.05555555555555555,643,35.72222222222222,250,0.8169934640522876,0.051470588235294115,0.0028594771241830064,0.17187275907862623,0.01192779095273804,14,17,31
org.apache.xpath.functions.FuncGenerateId,7,21,42,0.5,1,0.14285714285714285,645,92.14285714285714,21,0.5,0.0,0.0,0.0,0.0,0,6,6
org.apache.xml.dtm.DTMAxisTraverser,1,0,0,0,1,1.0,-1,-1.0,0,0,0.0,0.0,0.26471022143044803,0.0,25,0,25
org.apache.xpath.axes.AttributeIterator,5,8,20,0.4,1,0.2,643,128.6,12,0.6,0.0,0.0,0.17205772760970528,6.667018685253248e-08,1,4,5
org.apache.xalan.xsltc.compiler.CopyOf,16,94,240,0.39166666666666666,1,0.0625,643,40.1875,146,0.6083333333333333,0.0,0.0,0.1509973937428581,2.0562525731916328e-05,1,15,16
org.apache.xalan.xsltc.compiler.Output,9,28,72,0.3888888888888889,1,0.1111111111111111,643,71.44444444444444,44,0.6111111111111112,0.03571428571428571,0.003968253968253968,0.22076227629789855,2.2147373511421367e-05,2,8,10
org.apache.xpath.SourceTree,2,1,2,0.5,1,0.5,643,321.5,1,0.5,0.0,0.0,0.20222114912084257,0.0,1,1,2
org.apache.xalan.xsltc.compiler.util.CompareGenerator,6,16,30,0.5333333333333333,1,0.16666666666666666,643,107.16666666666667,14,0.4666666666666667,0.0,0.0,0.13156356196094318,3.416342494669592e-05,3,5,8
org.apache.xpath.axes.ChildIterator,6,12,30,0.4,1,0.16666666666666666,643,107.16666666666667,18,0.6,0.0,0.0,0.17205772760970528,7.930151056881684e-06,1,5,6
org.apache.xml.dtm.DTMIterator,3,6,6,1.0,1,0.3333333333333333,643,214.33333333333334,0,0.0,0.0,0.0,0.33018595723861655,0.00038483182159152726,49,3,52
org.apache.xalan.xpath.XPathSupportDefault,3,2,6,0.3333333333333333,1,0.3333333333333333,644,214.66666666666666,4,0.6666666666666666,0.0,0.0,0.0,0.0,0,2,2
org.apache.xpath.Arg,6,15,30,0.5,1,0.16666666666666666,643,107.16666666666667,15,0.5,0.0,0.0,0.17385389353516545,1.3534403150174862e-06,1,5,6
org.apache.xalan.xsltc.compiler.RealExpr,8,22,56,0.39285714285714285,1,0.125,644,80.5,34,0.6071428571428571,0.0,0.0,0.0,0.0,0,7,7
org.apache.xalan.trace.GenerateEvent,3,2,6,0.3333333333333333,1,0.3333333333333333,643,214.33333333333334,4,0.6666666666666666,0.0,0.0,0.1697558297886368,0.000211398268904672,4,2,6
org.apache.xml.dtm.ref.DTMNamedNodeMap,5,6,20,0.3,1,0.2,643,128.6,14,0.7,0.0,0.0,0.15832446077930099,0.0010665896492668147,1,4,5
org.apache.xml.utils.NSInfo,2,1,2,0.5,1,0.5,643,321.5,1,0.5,0.0,0.0,0.1781944276582012,0.0,1,1,2
org.apache.xalan.xsltc.compiler.FunctionCall,24,111,552,0.20108695652173914,1,0.041666666666666664,643,26.791666666666668,441,0.7989130434782609,0.0,0.0,0.15631212406622813,0.006030239739190652,25,23,48
org.apache.xalan.xpath.XString,7,22,42,0.5238095238095238,1,0.14285714285714285,643,91.85714285714286,20,0.47619047619047616,0.0,0.0,0.16747961501669614,0.00010629944286306993,3,6,9
org.apache.xpath.axes.SelfIteratorNoPredicate,5,9,20,0.45,1,0.2,643,128.6,11,0.55,0.0,0.0,0.1951135471014622,0.0014305341656771953,3,4,7
org.apache.xml.utils.SerializableLocatorImpl,2,1,2,0.5,1,0.5,644,322.0,1,0.5,0.0,0.0,0.0,0.0,0,1,1
org.apache.xalan.processor.ProcessorImport,4,6,12,0.5,1,0.25,643,160.75,6,0.5,0.0,0.0,0.15908063730839614,2.520144312092271e-06,1,3,4
org.apache.xalan.xsltc.dom.BitArray,2,3,2,1.5,1,0.5,0,0.0,-1,-0.5,0.0,0.0,0.15589063040271717,6.333667750990586e-07,5,2,7
org.apache.xalan.templates.ElemMessage,10,34,90,0.37777777777777777,1,0.1,643,64.3,56,0.6222222222222222,0.0,0.0,0.1591123014479878,1.4950484742127193e-05,1,9,10
org.apache.xpath.objects.EqualComparator,3,4,6,0.6666666666666666,1,0.3333333333333333,643,214.33333333333334,2,0.3333333333333333,0.0,0.0,0.22911441744760408,0.0,1,2,3
org.apache.xpath.functions.FuncBoolean,6,12,30,0.4,1,0.16666666666666666,644,107.33333333333333,18,0.6,0.0,0.0,0.0,0.0,0,5,5
org.apache.xml.dtm.ref.DTMAxisIteratorBase,3,3,6,0.5,1,0.3333333333333333,643,214.33333333333334,3,0.5,0.0,0.0,0.1517714453151112,0.0016390476528271804,2,2,4
org.apache.xml.dtm.ref.CustomStringPool,3,3,6,0.5,1,0.3333333333333333,644,214.66666666666666,3,0.5,0.0,0.0,0.0,0.0,0,2,2
org.apache.xpath.SourceTreeManager,7,14,42,0.3333333333333333,1,0.14285714285714285,643,91.85714285714286,28,0.6666666666666666,0.06666666666666667,0.009523809523809523,0.2567052673329129,0.0028411319593629526,4,6,10
org.apache.xalan.xsltc.compiler.IllegalCharException,2,1,2,0.5,1,0.5,644,322.0,1,0.5,0.0,0.0,0.0,0.0,0,1,1
org.apache.xalan.xsltc.compiler.FilterExpr,13,69,156,0.4423076923076923,1,0.07692307692307693,643,49.46153846153846,87,0.5576923076923077,0.001893939393939394,0.0001456876456876457,0.15597662487311037,1.5271317296064203e-06,2,12,14
org.apache.xalan.templates.AVT,17,66,272,0.2426470588235294,1,0.058823529411764705,643,37.8235294117647,206,0.7573529411764706,0.23368055555555556,0.013745915032679738,0.17545658526661342,0.005094875437209733,11,16,27
org.apache.xpath.functions.FuncFalse,6,15,30,0.5,1,0.16666666666666666,644,107.33333333333333,15,0.5,0.0,0.0,0.0,0.0,0,5,5
org.apache.xalan.xsltc.compiler.LiteralElement,16,98,240,0.4083333333333333,1,0.0625,643,40.1875,142,0.5916666666666667,0.21904761904761907,0.013690476190476192,0.22735500639211906,0.0036157878215185946,5,15,20
org.apache.xpath.NodeSetDTM,10,29,90,0.32222222222222224,1,0.1,643,64.3,61,0.6777777777777778,0.0,0.0,0.30816507419995787,0.0007986902216854111,13,10,23
org.apache.xpath.compiler.Lexer,10,29,90,0.32222222222222224,1,0.1,643,64.3,61,0.6777777777777778,0.013888888888888888,0.0013888888888888887,0.15898572046036014,1.754220679156983e-05,1,9,10
org.apache.xalan.xsltc.runtime.output.SAXOutput,5,8,20,0.4,1,0.2,643,128.6,12,0.6,0.0,0.0,0.12658435510288055,0.00017765938041528593,3,4,7
org.apache.xalan.xsltc.trax.TrAXFilter,1,0,0,0,1,1.0,-1,-1.0,0,0,0.0,0.0,0.15127012276193436,0.0,2,0,2
org.apache.xml.utils.QName,8,14,56,0.25,1,0.125,643,80.375,42,0.75,0.0,0.0,0.24438404233405403,0.002310711675815514,47,7,54
org.apache.xpath.operations.Variable,23,112,506,0.22134387351778656,1,0.043478260869565216,643,27.956521739130434,394,0.7786561264822134,0.10670995670995671,0.004639563335215509,0.23933538996248224,0.056313215181065406,7,22,29
org.apache.xml.utils.Context2,2,2,2,1.0,1,0.5,643,321.5,0,0.0,0.0,0.0,0.14497283323806504,0.0,2,2,4
org.apache.xalan.xsltc.compiler.AbsoluteLocationPath,11,48,110,0.43636363636363634,1,0.09090909090909091,643,58.45454545454545,62,0.5636363636363636,0.0,0.0,0.15229190369112033,4.0716435542082336e-07,1,10,11
org.apache.xml.utils.DOMBuilder,6,9,30,0.3,1,0.16666666666666666,643,107.16666666666667,21,0.7,0.0,0.0,0.17396739988567805,2.461332076552131e-05,2,5,7
org.apache.xalan.xsltc.compiler.util.TestGenerator,5,13,20,0.65,1,0.2,643,128.6,7,0.35,0.0,0.0,0.1523789939906006,1.5652677736017977e-05,2,4,6
org.apache.xml.utils.WrongParserException,2,1,2,0.5,1,0.5,644,322.0,1,0.5,0.0,0.0,0.0,0.0,0,1,1
org.apache.xalan.xsltc.compiler.AbsolutePathPattern,15,66,210,0.3142857142857143,1,0.06666666666666667,643,42.86666666666667,144,0.6857142857142857,0.0,0.0,0.21047398696016079,0.003665603358924583,1,14,15
org.apache.xalan.templates.AVTPart,6,10,30,0.3333333333333333,1,0.16666666666666666,643,107.16666666666667,20,0.6666666666666666,0.0,0.0,0.14825300490999457,2.5334671003962344e-06,3,5,8
org.apache.xalan.xsltc.runtime.Attributes,4,5,12,0.4166666666666667,1,0.25,643,160.75,7,0.5833333333333334,0.0,0.0,0.2367131188850135,0.0008185131623388899,7,3,10
org.apache.xpath.axes.FilterExprIteratorSimple,15,42,210,0.2,1,0.06666666666666667,643,42.86666666666667,168,0.8,0.06593406593406594,0.004395604395604396,0.17047988962991908,0.002008237849663259,4,14,18
org.apache.xml.dtm.ref.DTMManagerDefault,25,106,600,0.17666666666666667,1,0.04,643,25.72,494,0.8233333333333334,0.06431159420289854,0.0025724637681159416,0.20795530761568437,0.03131492334798718,6,24,30
org.apache.xpath.objects.XStringForFSB,13,51,156,0.3269230769230769,1,0.07692307692307693,643,49.46153846153846,105,0.6730769230769231,0.02777777777777778,0.002136752136752137,0.23197336113601005,6.371250905631761e-05,1,12,13
org.apache.xpath.objects.GreaterThanComparator,3,4,6,0.6666666666666666,1,0.3333333333333333,643,214.33333333333334,2,0.3333333333333333,0.0,0.0,0.22911441744760408,0.0,1,2,3
org.apache.xpath.functions.Function,11,36,110,0.32727272727272727,1,0.09090909090909091,643,58.45454545454545,74,0.6727272727272727,0.1537037037037037,0.013973063973063972,0.2501972464709517,0.00540315454470981,16,10,26
org.apache.xalan.xsltc.TransletOutputHandler,3,3,6,0.5,1,0.3333333333333333,643,214.33333333333334,3,0.5,0.0,0.0,0.19974517802965785,8.364513074861781e-05,16,2,18
org.apache.xalan.transformer.CountersTable,6,17,30,0.5666666666666667,1,0.16666666666666666,643,107.16666666666667,13,0.43333333333333335,0.05,0.008333333333333333,0.17396739988567805,0.0022423627431355244,3,5,8
org.apache.xalan.xsltc.compiler.CallTemplate,13,64,156,0.41025641025641024,1,0.07692307692307693,644,49.53846153846154,92,0.5897435897435898,0.0,0.0,0.0,0.0,0,12,12
org.apache.xalan.xsltc.NodeIterator,1,1,0,0,1,1.0,-1,-1.0,-1,0,0.0,0.0,0.32833599715206885,0.0,60,1,61
org.apache.xalan.xsltc.compiler.NameBase,8,18,56,0.32142857142857145,1,0.125,644,80.5,38,0.6785714285714286,0.0,0.0,0.003374578177727784,0.00020008056425379264,3,7,10
org.apache.xalan.xsltc.compiler.util.BooleanType,11,66,110,0.6,1,0.09090909090909091,643,58.45454545454545,44,0.4,0.0,0.0,0.2646078128019499,0.0009528611197482205,17,10,27
org.apache.xml.utils.synthetic.reflection.Method,6,15,30,0.5,1,0.16666666666666666,643,107.16666666666667,15,0.5,0.1,0.016666666666666666,0.14916592694060285,0.00042363276843680243,3,5,8
org.apache.xalan.templates.RedundentExprEliminator,35,174,1190,0.146218487394958,1,0.02857142857142857,643,18.37142857142857,1016,0.853781512605042,0.13854723707664882,0.003958492487904252,0.1868583923503251,0.009893239672805178,2,34,36
org.apache.xml.utils.synthetic.TestDriver,7,20,42,0.47619047619047616,1,0.14285714285714285,645,92.14285714285714,22,0.5238095238095238,0.16666666666666666,0.023809523809523808,0.0011248593925759281,0.0008170431398777856,1,6,7
org.apache.xalan.templates.ElemExtensionCall,20,98,380,0.2578947368421053,1,0.05,643,32.15,282,0.7421052631578947,0.121588693957115,0.00607943469785575,0.16692006733654013,0.0014479894246068224,7,19,26
org.apache.xml.utils.res.XResources_zh_TW,2,2,2,1.0,1,0.5,644,322.0,0,0.0,0.0,0.0,0.0,0.0,0,1,1
org.apache.xalan.processor.ProcessorStylesheetDoc,2,1,2,0.5,1,0.5,643,321.5,1,0.5,0.0,0.0,0.1591123014479878,4.320592511915687e-05,1,1,2
org.apache.xalan.templates.ElemTemplateElement,25,109,600,0.18166666666666667,1,0.04,643,25.72,491,0.8183333333333334,0.255102657004831,0.01020410628019324,0.23869220736777863,0.06050532228247345,65,25,90
org.apache.xml.utils.IntStack,2,1,2,0.5,1,0.5,0,0.0,1,0.5,0.0,0.0,0.25956522198573573,0.0005108264358720796,5,1,6
org.apache.xalan.lib.sql.ConnectionPool,2,1,2,0.5,1,0.5,644,322.0,1,0.5,0.0,0.0,0.004686914135733034,0.00013567026773106522,4,1,5
org.apache.xpath.NodeSet,8,15,56,0.26785714285714285,1,0.125,645,80.625,41,0.7321428571428571,0.0,0.0,0.0044994375703037125,0.0009620192231541191,5,8,13
org.apache.xalan.xsltc.compiler.Parser,25,166,600,0.27666666666666667,1,0.04,643,25.72,434,0.7233333333333334,0.324000747642052,0.01296002990568208,0.2842746096993921,0.03805998357683962,86,24,110
org.apache.xalan.xsltc.compiler.Mode,22,126,462,0.2727272727272727,1,0.045454545454545456,643,29.227272727272727,336,0.7272727272727273,0.17378968253968258,0.007899531024531026,0.18577276376358137,0.006709012631301901,4,21,25
org.apache.xml.utils.IntVector,1,0,0,0,1,1.0,-1,-1.0,0,0,0.0,0.0,0.20878027756278322,0.0,4,0,4
org.apache.xalan.lib.ExsltMath,4,5,12,0.4166666666666667,1,0.25,646,161.5,7,0.5833333333333334,0.0,0.0,0.0,0.0,0,3,3
org.apache.xalan.xsltc.compiler.util.ErrorMessages,3,3,6,0.5,1,0.3333333333333333,644,214.66666666666666,3,0.5,0.0,0.0,0.0011248593925759281,0.0,1,2,3
org.apache.xalan.xsltc.compiler.KeyCall,13,48,156,0.3076923076923077,1,0.07692307692307693,643,49.46153846153846,108,0.6923076923076923,0.0,0.0,0.15229190369112033,9.351963618428946e-05,1,12,13
org.apache.xpath.objects.XObject,20,80,380,0.21052631578947367,1,0.05,643,32.15,300,0.7894736842105263,0.6201267056530214,0.031006335282651072,0.43326840242530656,0.10344220021124352,123,19,142
org.apache.xml.utils.SystemIDResolver,4,7,12,0.5833333333333334,1,0.25,643,160.75,5,0.4166666666666667,0.0,0.0,0.23373690130838906,0.0021339182264379117,12,3,15
org.apache.xml.dtm.ref.DTMStringPool,3,2,6,0.3333333333333333,1,0.3333333333333333,643,214.33333333333334,4,0.6666666666666666,0.0,0.0,0.18180127415844682,3.563582675402663e-05,5,2,7
org.apache.xpath.functions.FuncNot,6,12,30,0.4,1,0.16666666666666666,644,107.33333333333333,18,0.6,0.0,0.0,0.0,0.0,0,5,5
org.apache.xalan.templates.XMLNSDecl,2,1,2,0.5,1,0.5,643,321.5,1,0.5,0.0,0.0,0.19105645374634098,2.485601325220057e-07,2,1,3
org.apache.xpath.functions.FuncSystemProperty,11,39,110,0.35454545454545455,1,0.09090909090909091,644,58.54545454545455,71,0.6454545454545455,0.0,0.0,0.0,0.0,0,10,10
org.apache.xalan.xsltc.cmdline.Compile,6,10,30,0.3333333333333333,1,0.16666666666666666,650,108.33333333333333,20,0.6666666666666666,0.0,0.0,0.0,0.0,0,5,5
org.apache.xalan.transformer.XSLInfiniteLoopException,2,1,2,0.5,1,0.5,644,322.0,1,0.5,0.0,0.0,0.0,0.0,0,1,1
org.apache.xalan.xsltc.compiler.ContainsCall,11,34,110,0.3090909090909091,1,0.09090909090909091,644,58.54545454545455,76,0.6909090909090909,0.0,0.0,0.0,0.0,0,10,10
org.apache.xalan.xsltc.dom.NodeIteratorBase,3,4,6,0.6666666666666666,1,0.3333333333333333,643,214.33333333333334,2,0.3333333333333333,0.0,0.0,0.15748230939217703,0.002650851076047927,29,2,31
org.apache.xalan.processor.XSLTElementDef,8,22,56,0.39285714285714285,1,0.125,643,80.375,34,0.6071428571428571,0.10317460317460315,0.012896825396825394,0.16790174385101675,0.0008141596568168678,7,8,15
org.apache.xalan.xsltc.compiler.Pattern,7,15,42,0.35714285714285715,1,0.14285714285714285,643,91.85714285714286,27,0.6428571428571429,0.0,0.0,0.22248266141794898,1.0669268923751822e-05,11,6,17
org.apache.xalan.transformer.NumeratorFormatter,6,9,30,0.3,1,0.16666666666666666,645,107.5,21,0.7,0.0,0.0,0.0,0.0,0,5,5
org.apache.xalan.xpath.XNumber,4,8,12,0.6666666666666666,1,0.25,643,160.75,4,0.3333333333333333,0.0,0.0,0.21052941861329752,6.0553505703118176e-05,4,3,7
org.apache.xalan.xsltc.compiler.StringCall,9,22,72,0.3055555555555556,1,0.1111111111111111,644,71.55555555555556,50,0.6944444444444444,0.0,0.0,0.0,0.0,0,8,8
org.apache.xalan.extensions.MethodResolver,17,54,272,0.19852941176470587,1,0.058823529411764705,646,38.0,218,0.8014705882352942,0.0,0.0,0.0022497187851518562,3.309693270323192e-05,2,16,18
org.apache.xalan.serialize.CharInfo,5,7,20,0.35,1,0.2,643,128.6,13,0.65,0.0,0.0,0.15045740682753447,0.0010719973951132558,3,4,7
org.apache.xalan.templates.StylesheetRoot,31,189,930,0.2032258064516129,1,0.03225806451612903,643,20.741935483870968,741,0.7967741935483871,0.3153895274584929,0.010173855724467513,0.23699383411642178,0.07898563551963445,49,30,79
org.apache.xalan.templates.XUnresolvedVariableSimple,7,26,42,0.6190476190476191,1,0.14285714285714285,643,91.85714285714286,16,0.38095238095238093,0.0,0.0,0.1341467028821431,3.0107999033758317e-06,1,6,7
org.apache.xalan.templates.AbsPathChecker,8,20,56,0.35714285714285715,1,0.125,643,80.375,36,0.6428571428571429,0.0,0.0,0.15618995749798567,0.0010789911256206613,1,7,8
org.apache.xml.utils.synthetic.JavaUtils,2,1,2,0.5,1,0.5,644,322.0,1,0.5,0.0,0.0,0.0,0.0,0,1,1
org.apache.xalan.Version,3,3,6,0.5,1,0.3333333333333333,645,215.0,3,0.5,0.0,0.0,0.0,0.0,0,2,2
org.apache.xpath.objects.XMLStringFactoryImpl,8,28,56,0.5,1,0.125,643,80.375,28,0.5,0.3214285714285714,0.040178571428571425,0.30698164457553406,0.002182813446156277,4,7,11
org.apache.xpath.operations.VariableSafeAbsRef,9,30,72,0.4166666666666667,1,0.1111111111111111,643,71.44444444444444,42,0.5833333333333334,0.0,0.0,0.15618995749798567,1.7479937973529196e-05,1,8,9
org.apache.xalan.templates.ElemAttributeSet,14,65,182,0.35714285714285715,1,0.07142857142857142,643,45.92857142857143,117,0.6428571428571429,0.08606532356532356,0.006147523111808826,0.2039235210394619,0.002830584987263503,5,13,18
org.apache.xalan.templates.ElemForEach,25,126,600,0.21,1,0.04,643,25.72,474,0.79,0.08277907177363698,0.0033111628709454792,0.1962632463723768,0.004438758048746726,6,24,30
org.apache.xalan.extensions.ExtensionHandlerJavaClass,11,35,110,0.3181818181818182,1,0.09090909090909091,648,58.90909090909091,75,0.6818181818181818,0.0,0.0,0.0,0.0,0,10,10
org.apache.xml.dtm.DTM,5,7,20,0.35,1,0.2,643,128.6,13,0.65,0.0,0.0,0.35591282389790324,0.008640438551298047,126,4,130
org.apache.xalan.xsltc.dom.KeyIndex,4,7,12,0.5833333333333334,1,0.25,643,160.75,5,0.4166666666666667,0.0,0.0,0.1539341811043117,1.5517485989926935e-05,3,4,7
org.apache.xalan.extensions.ExtensionHandler,7,18,42,0.42857142857142855,1,0.14285714285714285,643,91.85714285714286,24,0.5714285714285714,0.0,0.0,0.1629392993221954,0.002211957398593752,7,6,13
org.apache.xml.dtm.ref.NodeLocator,2,1,2,0.5,1,0.5,643,321.5,1,0.5,0.0,0.0,0.17530267598129182,0.0,1,1,2
org.apache.xml.dtm.DTMFilter,1,0,0,0,1,1.0,-1,-1.0,0,0,0.0,0.0,0.2672707939526238,0.0,16,0,16
org.apache.xalan.xslt.Stylesheet,5,11,20,0.55,1,0.2,643,128.6,9,0.45,0.3333333333333333,0.06666666666666667,0.24933880301768266,0.0973200838727918,23,4,27
org.apache.xalan.transformer.NodeSortKey,7,12,42,0.2857142857142857,1,0.14285714285714285,643,91.85714285714286,30,0.7142857142857143,0.15,0.02142857142857143,0.17385389353516545,0.001268955491443078,3,6,9
org.apache.xpath.axes.PathComponent,1,0,0,0,1,1.0,-1,-1.0,0,0,0.0,0.0,0.20306078060566807,0.0,5,0,5
org.apache.xalan.lib.ExsltSets,6,12,30,0.4,1,0.16666666666666666,649,108.16666666666667,18,0.6,0.0,0.0,0.0,0.0,0,5,5
org.apache.xalan.templates.FuncDocument,16,51,240,0.2125,1,0.0625,643,40.1875,189,0.7875,0.0,0.0,0.15185794119959928,0.0016160218873823868,1,15,16
org.apache.xml.dtm.DTMException,4,6,12,0.5,1,0.25,643,160.75,6,0.5,0.0,0.0,0.18351244317600796,0.00020942366493025867,8,3,11
org.apache.xalan.extensions.ExtensionsTable,10,23,90,0.25555555555555554,1,0.1,643,64.3,67,0.7444444444444445,0.0,0.0,0.17404315316235372,0.0007157349279368082,2,9,11
org.apache.xml.utils.StringToStringTable,2,1,2,0.5,1,0.5,644,322.0,1,0.5,0.0,0.0,0.0011248593925759281,0.0,1,1,2
org.apache.xalan.xsltc.compiler.UnparsedEntityUriCall,10,30,90,0.3333333333333333,1,0.1,644,64.4,60,0.6666666666666666,0.0,0.0,0.0,0.0,0,9,9
org.apache.xalan.xsltc.runtime.output.SAXTextOutput,4,6,12,0.5,1,0.25,643,160.75,6,0.5,0.0,0.0,0.14544763509364825,0.00035482614222771895,1,3,4
org.apache.xalan.xsltc.compiler.Copy,11,46,110,0.41818181818181815,1,0.09090909090909091,644,58.54545454545455,64,0.5818181818181818,0.0,0.0,0.0,0.0,0,10,10
org.apache.xalan.xsltc.compiler.util.RtMethodGenerator,5,13,20,0.65,1,0.2,644,128.8,7,0.35,0.0,0.0,0.0,0.0,0,4,4
org.apache.xalan.xsltc.dom.StripWhitespaceFilter,2,1,2,0.5,1,0.5,644,322.0,1,0.5,0.0,0.0,0.0,0.0,0,1,1
org.apache.xalan.xsltc.compiler.UnaryOpExpr,11,46,110,0.41818181818181815,1,0.09090909090909091,644,58.54545454545455,64,0.5818181818181818,0.0,0.0,0.0,0.0,0,10,10
org.apache.xalan.xslt.XSLTInputSource,3,2,6,0.3333333333333333,1,0.3333333333333333,643,214.33333333333334,4,0.6666666666666666,0.0,0.0,0.1780356798384612,7.493539774371843e-07,3,2,5
org.apache.xalan.xsltc.compiler.DecimalFormatting,10,31,90,0.34444444444444444,1,0.1,643,64.3,59,0.6555555555555556,0.15277777777777776,0.015277777777777776,0.22039707815679369,1.453246192801941e-05,2,9,11
org.apache.xalan.xsltc.dom.AbsoluteIterator,5,11,20,0.55,1,0.2,643,128.6,9,0.45,0.08333333333333333,0.016666666666666666,0.13578736240439793,8.022645817921407e-06,1,4,5
org.apache.xalan.xsltc.compiler.NamespaceUriCall,5,7,20,0.35,1,0.2,645,129.0,13,0.65,0.0,0.0,0.0,0.0,0,4,4
org.apache.xalan.xslt.StylesheetSpec,2,1,2,0.5,1,0.5,643,321.5,1,0.5,0.0,0.0,0.16733937669556012,0.0,2,1,3
org.apache.xalan.templates.ElemElement,17,64,272,0.23529411764705882,1,0.058823529411764705,643,37.8235294117647,208,0.7647058823529411,0.0,0.0,0.15927081141157415,0.00010300350240096321,3,16,19
org.apache.xpath.functions.FuncString,6,16,30,0.5333333333333333,1,0.16666666666666666,645,107.5,14,0.4666666666666667,0.0,0.0,0.0,0.0,0,5,5
org.apache.xalan.transformer.SerializerSwitcher,8,17,56,0.30357142857142855,1,0.125,643,80.375,39,0.6964285714285714,0.0,0.0,0.16317211726366415,0.0002813961377596773,2,7,9
org.apache.xalan.lib.sql.ObjectArray,3,2,6,0.3333333333333333,1,0.3333333333333333,645,215.0,4,0.6666666666666666,0.0,0.0,0.0029996250468691415,0.0001407372019318577,2,2,4
org.apache.xalan.serialize.SerializerToHTML,11,30,110,0.2727272727272727,1,0.09090909090909091,643,58.45454545454545,80,0.7272727272727273,0.0,0.0,0.1777980877390326,0.0029136860580857168,2,10,12
org.apache.xalan.xslt.EnvironmentCheck,5,7,20,0.35,1,0.2,644,128.8,13,0.65,0.0,0.0,0.0020247469066366703,3.62866381567169e-05,1,4,5
org.apache.xalan.xsltc.dom.DOMBuilder,1,0,0,0,1,1.0,-1,-1.0,0,0,0.0,0.0,0.18535226469349206,0.0,7,0,7
org.apache.xml.dtm.ref.DTMDefaultBase,16,52,240,0.21666666666666667,1,0.0625,643,40.1875,188,0.7833333333333333,0.00873015873015873,0.0005456349206349206,0.17438486092379812,0.03441236734031317,45,15,60
org.apache.xpath.axes.FilterExprIterator,10,21,90,0.23333333333333334,1,0.1,645,64.5,69,0.7666666666666667,0.09722222222222221,0.00972222222222222,0.0011248593925759281,0.0003653449978383288,1,9,10
org.apache.xalan.templates.FuncFormatNumb,15,46,210,0.21904761904761905,1,0.06666666666666667,643,42.86666666666667,164,0.780952380952381,0.0,0.0,0.1518290982857912,0.0021863919893519595,1,14,15
org.apache.xalan.lib.sql.SQLDocument,7,11,42,0.2619047619047619,1,0.14285714285714285,649,92.71428571428571,31,0.7380952380952381,0.0,0.0,0.0011248593925759281,2.1217786965818466e-05,1,6,7
org.w3c.dom.xpath.XPathNSResolver,2,1,2,0.5,1,0.5,644,322.0,1,0.5,0.0,0.0,0.0011248593925759281,0.0,1,1,2
org.apache.xalan.client.XSLTProcessorApplet,5,8,20,0.4,1,0.2,645,129.0,12,0.6,0.25,0.05,0.0011248593925759281,0.0008170431398777856,1,4,5
org.apache.xalan.xslt.Process,13,37,156,0.23717948717948717,1,0.07692307692307693,646,49.69230769230769,119,0.7628205128205128,0.0,0.0,0.0,0.0,0,12,12
org.apache.xalan.xslt.StylesheetHandler,5,11,20,0.55,1,0.2,643,128.6,9,0.45,0.0,0.0,0.15003382178579028,0.0024566277885708435,22,4,26
org.apache.xpath.DOMHelper,11,24,110,0.21818181818181817,1,0.09090909090909091,643,58.45454545454545,86,0.7818181818181819,0.0,0.0,0.21912834497661476,0.006985408998153783,7,10,17
org.apache.xalan.xslt.XSLProcessorException,4,6,12,0.5,1,0.25,643,160.75,6,0.5,0.0,0.0,0.1976706732133261,8.8960935355217e-05,1,3,4
org.apache.xalan.xsltc.compiler.util.NodeSortRecordGenerator,5,10,20,0.5,1,0.2,643,128.6,10,0.5,0.0,0.0,0.11752134702656435,9.500501626485879e-07,1,4,5
org.apache.xalan.xsltc.compiler.CurrentCall,5,7,20,0.35,1,0.2,644,128.8,13,0.65,0.0,0.0,0.0,0.0,0,4,4
org.apache.xalan.xsltc.compiler.CeilingCall,5,7,20,0.35,1,0.2,644,128.8,13,0.65,0.0,0.0,0.0,0.0,0,4,4
org.apache.xalan.xsltc.compiler.When,13,59,156,0.3782051282051282,1,0.07692307692307693,643,49.46153846153846,97,0.6217948717948718,0.0,0.0,0.13036206824440488,1.9923292209568925e-05,1,12,13
org.apache.xpath.functions.FuncTrue,6,15,30,0.5,1,0.16666666666666666,644,107.33333333333333,15,0.5,0.0,0.0,0.0,0.0,0,5,5
org.apache.xpath.functions.FuncLocalPart,7,21,42,0.5,1,0.14285714285714285,645,92.14285714285714,21,0.5,0.0,0.0,0.0,0.0,0,6,6
org.apache.xpath.functions.FuncCount,7,17,42,0.40476190476190477,1,0.14285714285714285,644,92.0,25,0.5952380952380952,0.0,0.0,0.0,0.0,0,6,6
org.apache.xalan.lib.ExsltDatetime,10,37,90,0.4111111111111111,1,0.1,644,64.4,53,0.5888888888888889,0.0,0.0,0.0,0.0,0,9,9
org.apache.xalan.templates.ElemTextLiteral,8,28,56,0.5,1,0.125,643,80.375,28,0.5,0.005952380952380952,0.000744047619047619,0.19416570378301937,0.0007827627074279623,6,7,13
org.apache.xalan.xsltc.dom.MatchingIterator,4,7,12,0.5833333333333334,1,0.25,644,161.0,5,0.4166666666666667,0.0,0.0,0.0,0.0,0,3,3
org.apache.xalan.processor.ProcessorInclude,11,33,110,0.3,1,0.09090909090909091,643,58.45454545454545,77,0.7,0.0,0.0,0.15914397819524004,0.0003405195769575767,2,10,12
org.apache.xalan.xsltc.compiler.ParentLocationPath,12,45,132,0.3409090909090909,1,0.08333333333333333,643,53.583333333333336,87,0.6590909090909091,0.00303030303030303,0.00025252525252525247,0.15597662487311037,1.6985745332202025e-06,2,11,13
org.apache.xalan.xsltc.dom.MultiDOM,13,38,156,0.24358974358974358,1,0.07692307692307693,643,49.46153846153846,118,0.7564102564102564,0.09848484848484848,0.007575757575757575,0.13594901402630793,0.002907008728156085,4,12,16
org.apache.xalan.serialize.SerializerFactory,4,5,12,0.4166666666666667,1,0.25,643,160.75,7,0.5833333333333334,0.0,0.0,0.17438486092379812,4.644689684059763e-06,8,3,11
org.apache.xalan.serialize.DOMSerializer,2,1,2,0.5,1,0.5,643,321.5,1,0.5,0.0,0.0,0.15503882902922628,0.0008252618277927617,4,1,5
org.apache.xalan.templates.ElemVariable,27,163,702,0.23219373219373218,1,0.037037037037037035,643,23.814814814814813,539,0.7678062678062678,0.33418131868131873,0.012377085877085879,0.2325131478983975,0.05825749053037537,21,27,48
org.apache.xalan.transformer.DecimalToRoman,2,1,2,0.5,1,0.5,643,321.5,1,0.5,0.0,0.0,0.1392648436367057,0.0,2,1,3
org.apache.xalan.xsltc.compiler.Comment,8,25,56,0.44642857142857145,1,0.125,643,80.375,31,0.5535714285714286,0.0,0.0,0.16918099523273877,0.0025712728989616277,2,7,9
org.apache.xalan.xsltc.compiler.Fallback,9,32,72,0.4444444444444444,1,0.1111111111111111,643,71.44444444444444,40,0.5555555555555556,0.0,0.0,0.17783764237479213,3.166833875495293e-07,1,8,9
org.apache.xml.utils.res.XResources_ja_JP_HI,2,2,2,1.0,1,0.5,644,322.0,0,0.0,0.0,0.0,0.0,0.0,0,1,1
org.apache.xpath.XPathAPI,9,22,72,0.3055555555555556,1,0.1111111111111111,643,71.44444444444444,50,0.6944444444444444,0.0,0.0,0.16744453340483675,0.0006969924990879383,2,8,10
org.apache.xalan.xsltc.compiler.SymbolTable,14,61,182,0.33516483516483514,1,0.07142857142857142,643,45.92857142857143,121,0.6648351648351648,0.23237179487179485,0.016597985347985348,0.2833676719158776,0.035503488425004524,87,13,100
org.apache.xpath.compiler.FuncLoader,3,2,6,0.3333333333333333,1,0.3333333333333333,643,214.33333333333334,4,0.6666666666666666,0.0,0.0,0.18427390559582543,0.0,2,2,4
org.apache.xalan.res.XSLMessages,4,5,12,0.4166666666666667,1,0.25,643,160.75,7,0.5833333333333334,0.0,0.0,0.36269519168543135,0.0023176147677660816,90,3,93
org.apache.xalan.xsltc.runtime.TransletOutputBase,5,8,20,0.4,1,0.2,643,128.6,12,0.6,0.0,0.0,0.12644419526648065,5.066934200792469e-06,1,4,5
org.apache.xml.dtm.ref.IncrementalSAXSource_Filter,9,17,72,0.2361111111111111,1,0.1111111111111111,643,71.44444444444444,55,0.7638888888888888,0.0,0.0,0.1903286196368311,0.01954209489268927,5,8,13
org.apache.xalan.templates.ElemWithParam,22,120,462,0.2597402597402597,1,0.045454545454545456,643,29.227272727272727,342,0.7402597402597403,0.0,0.0,0.15920736954285813,7.417682399017743e-05,3,21,24
org.apache.xalan.xsltc.compiler.LogicalExpr,13,55,156,0.3525641025641026,1,0.07692307692307693,645,49.61538461538461,101,0.6474358974358975,0.0,0.0,0.0,0.0,0,12,12
org.apache.xalan.xsltc.runtime.SAXAdapter,9,18,72,0.25,1,0.1111111111111111,643,71.44444444444444,54,0.75,0.0,0.0,0.1550989915550428,0.001156399642388527,1,8,9
org.apache.xpath.functions.FunctionOneArg,7,14,42,0.3333333333333333,1,0.14285714285714285,643,91.85714285714286,28,0.6666666666666666,0.0,0.0,0.13496204667815137,0.0010889974285750296,15,6,21
org.apache.xpath.compiler.Compiler,47,170,2162,0.0786308973172988,1,0.02127659574468085,643,13.680851063829786,1992,0.9213691026827012,0.10919484702093397,0.0023232946174666803,0.22671021057138135,0.038386572734199195,25,46,71
org.apache.xalan.xsltc.util.IntegerArray,1,0,0,0,1,1.0,-1,-1.0,0,0,0.0,0.0,0.1340377785664045,0.0,4,0,4
org.apache.xml.utils.synthetic.Class,7,15,42,0.35714285714285715,1,0.14285714285714285,643,91.85714285714286,27,0.6428571428571429,0.36666666666666664,0.052380952380952375,0.17685402709617049,0.007658977382869013,21,7,28
org.apache.xalan.xpath.xml.FormatterToDOM,3,4,6,0.6666666666666666,1,0.3333333333333333,644,214.66666666666666,2,0.3333333333333333,0.0,0.0,0.0,0.0,0,2,2
org.apache.xml.utils.StringToStringTableVector,3,3,6,0.5,1,0.3333333333333333,645,215.0,3,0.5,0.0,0.0,0.0,0.0,0,2,2
org.apache.xml.dtm.ref.IncrementalSAXSource_Xerces,8,18,56,0.32142857142857145,1,0.125,643,80.375,38,0.6785714285714286,0.0,0.0,0.17073477199374001,0.00012832366422969326,1,7,8
org.apache.xalan.xsltc.compiler.ParameterRef,11,44,110,0.4,1,0.09090909090909091,644,58.54545454545455,66,0.6,0.0,0.0,0.0011248593925759281,8.444890334654114e-07,1,10,11
org.apache.xalan.xsltc.compiler.ApplyImports,13,65,156,0.4166666666666667,1,0.07692307692307693,643,49.46153846153846,91,0.5833333333333334,0.0,0.0,0.155915779690792,3.234422358928579e-05,1,12,13
org.apache.xpath.functions.FunctionMultiArgs,8,14,56,0.25,1,0.125,645,80.625,42,0.75,0.11904761904761904,0.01488095238095238,0.0022497187851518562,0.0002783116413662552,2,7,9
org.apache.xml.dtm.Axis,1,0,0,0,1,1.0,-1,-1.0,0,0,0.0,0.0,0.25822682573959593,0.0,20,0,20
org.apache.xpath.functions.FuncConcat,8,20,56,0.35714285714285715,1,0.125,646,80.75,36,0.6428571428571429,0.0,0.0,0.0,0.0,0,7,7
org.apache.xalan.xpath.xml.FormatterToHTML,4,7,12,0.5833333333333334,1,0.25,643,160.75,5,0.4166666666666667,0.0,0.0,0.17771903123047814,0.0,1,3,4
org.apache.xpath.functions.FuncId,12,39,132,0.29545454545454547,1,0.08333333333333333,644,53.666666666666664,93,0.7045454545454546,0.0,0.0,0.0,0.0,0,11,11
org.apache.xml.dtm.ref.sax2dtm.SAX2RTFDTM,10,23,90,0.25555555555555554,1,0.1,643,64.3,67,0.7444444444444445,0.0,0.0,0.26072413648880977,0.04608308400668675,2,9,11
org.apache.xalan.processor.XSLProcessorVersion,2,1,2,0.5,1,0.5,644,322.0,1,0.5,0.0,0.0,0.0022497187851518562,0.0,2,1,3
org.apache.xalan.templates.Stylesheet,25,137,600,0.22833333333333333,1,0.04,643,25.72,463,0.7716666666666666,0.1976147342995169,0.007904589371980675,0.24702725663618377,0.025599331838660113,36,24,60
org.apache.xalan.xsltc.dom.LoadDocument,11,31,110,0.2818181818181818,1,0.09090909090909091,646,58.72727272727273,79,0.7181818181818181,0.0,0.0,0.0,0.0,0,10,10
org.apache.xalan.xsltc.compiler.AttributeValue,6,15,30,0.5,1,0.16666666666666666,643,107.16666666666667,15,0.5,0.30000000000000004,0.05000000000000001,0.184614365467596,0.0015105282186132524,8,6,14
org.apache.xalan.xsltc.dom.FilteredStepIterator,4,8,12,0.6666666666666666,1,0.25,644,161.0,4,0.3333333333333333,0.0,0.0,0.0,0.0,0,3,3
org.apache.xalan.xsltc.compiler.LiteralAttribute,12,48,132,0.36363636363636365,1,0.08333333333333333,643,53.583333333333336,84,0.6363636363636364,0.0,0.0,0.18359673919951552,0.00022756739328054894,2,11,13
org.apache.xalan.processor.ProcessorOutputElem,9,24,72,0.3333333333333333,1,0.1111111111111111,643,71.44444444444444,48,0.6666666666666666,0.0,0.0,0.15908063730839614,7.653926718226476e-05,1,8,9
org.apache.xalan.xsltc.compiler.UnionPathExpr,12,53,132,0.4015151515151515,1,0.08333333333333333,643,53.583333333333336,79,0.5984848484848485,0.013636363636363636,0.0011363636363636363,0.15597662487311037,8.672006703502766e-07,2,11,13
org.apache.xalan.transformer.KeyManager,10,29,90,0.32222222222222224,1,0.1,643,64.3,61,0.6777777777777778,0.0,0.0,0.17423282529962744,0.003633943607958644,2,9,11
org.apache.xalan.xsltc.compiler.Param,16,103,240,0.42916666666666664,1,0.0625,643,40.1875,137,0.5708333333333333,0.0880952380952381,0.005505952380952381,0.22273062203251343,0.002643284278787344,8,15,23
org.apache.xml.utils.synthetic.reflection.Field,5,9,20,0.45,1,0.2,643,128.6,11,0.55,0.08333333333333333,0.016666666666666666,0.14908246968942385,0.00017070989838207526,1,4,5
org.apache.xml.utils.UnImplNode,8,11,56,0.19642857142857142,1,0.125,643,80.375,45,0.8035714285714286,0.0,0.0,0.19225113094629406,0.002751193835306713,3,7,10
org.apache.xpath.XPathFactory,3,3,6,0.5,1,0.3333333333333333,643,214.33333333333334,3,0.5,0.0,0.0,0.16762008858768937,9.473518607300872e-06,3,2,5
org.apache.xalan.processor.ProcessorGlobalVariableDecl,6,13,30,0.43333333333333335,1,0.16666666666666666,643,107.16666666666667,17,0.5666666666666667,0.0,0.0,0.15908063730839614,2.6423688252097865e-05,1,5,6
org.apache.xalan.xsltc.compiler.util.FilterGenerator,5,10,20,0.5,1,0.2,643,128.6,10,0.5,0.0,0.0,0.15240804622968362,2.058095930392797e-05,2,4,6
org.apache.xpath.axes.WalkerFactory,32,152,992,0.1532258064516129,1,0.03125,643,20.09375,840,0.8467741935483871,0.2880249499604338,0.009000779686263557,0.21008678120228402,0.012952015871669432,16,31,47
org.apache.xpath.axes.SubContextList,2,2,2,1.0,1,0.5,643,321.5,0,0.0,0.0,0.0,0.25328903753950904,0.0,5,1,6
org.apache.xalan.xpath.xml.TreeWalker,5,8,20,0.4,1,0.2,644,128.8,12,0.6,0.0,0.0,0.0,0.0,0,4,4
org.apache.xalan.xsltc.compiler.SyntaxTreeNode,21,145,420,0.34523809523809523,1,0.047619047619047616,643,30.61904761904762,275,0.6547619047619048,0.18537907268170423,0.008827574889604964,0.27033486725555994,0.018387965630501768,17,21,38
org.apache.xalan.xsltc.compiler.util.RealType,14,88,182,0.4835164835164835,1,0.07142857142857142,643,45.92857142857143,94,0.5164835164835165,0.046474358974358976,0.0033195970695970695,0.22304135113691145,0.000733295761943987,14,13,27
org.apache.xpath.operations.Or,6,15,30,0.5,1,0.16666666666666666,643,107.16666666666667,15,0.5,0.0,0.0,0.1830921215013034,3.547223674065759e-05,1,5,6
org.apache.xalan.xsltc.TransletException,2,1,2,0.5,1,0.5,643,321.5,1,0.5,0.0,0.0,0.18755987857219397,0.0,24,1,25
org.apache.xalan.xsltc.runtime.Hashtable,4,4,12,0.3333333333333333,1,0.25,643,160.75,8,0.6666666666666666,0.0,0.0,0.2581977398174065,0.0037584669155216084,25,3,28
org.apache.xpath.compiler.XPathParser,14,46,182,0.25274725274725274,1,0.07142857142857142,643,45.92857142857143,136,0.7472527472527473,0.0202991452991453,0.00144993894993895,0.19096517020417839,0.0027172611665244976,4,13,17
org.w3c.dom.xpath.XPathEvaluator,6,10,30,0.3333333333333333,1,0.16666666666666666,647,107.83333333333333,20,0.6666666666666666,0.0,0.0,0.0,0.0,0,5,5
org.apache.xalan.transformer.ResultTreeHandler,24,95,552,0.1721014492753623,1,0.041666666666666664,643,26.791666666666668,457,0.8278985507246377,0.21408102766798418,0.008920042819499341,0.19655279136333678,0.010019670950650702,19,23,42
org.apache.xml.dtm.ref.dom2dtm.DOM2DTMdefaultNamespaceDeclarationNode,4,4,12,0.3333333333333333,1,0.25,643,160.75,8,0.6666666666666666,0.0,0.0,0.1716881878167291,6.861473396906467e-06,2,3,5
org.apache.xml.utils.XMLCharacterRecognizer,2,1,2,0.5,1,0.5,643,321.5,1,0.5,0.0,0.0,0.2977207458006297,2.5848913047343803e-06,8,1,9
org.apache.xml.dtm.ref.DTMTreeWalker,4,5,12,0.4166666666666667,1,0.25,643,160.75,7,0.5833333333333334,0.0,0.0,0.1776400449943757,0.0005654804176801649,3,3,6
org.apache.xalan.xsltc.dom.MultipleNodeCounter,8,19,56,0.3392857142857143,1,0.125,646,80.75,37,0.6607142857142857,0.055555555555555546,0.006944444444444443,0.0011248593925759281,0.0002677030236085355,1,7,8
org.apache.xalan.transformer.ClonerToResultTree,6,14,30,0.4666666666666667,1,0.16666666666666666,643,107.16666666666667,16,0.5333333333333333,0.07500000000000001,0.012500000000000002,0.17396739988567805,0.0004858559005181693,4,5,9
org.w3c.dom.xpath.XPathResult,3,2,6,0.3333333333333333,1,0.3333333333333333,644,214.66666666666666,4,0.6666666666666666,0.0,0.0,0.0022497187851518562,0.0008145096727773894,2,2,4
org.apache.xml.utils.PrefixResolverDefault,4,4,12,0.3333333333333333,1,0.25,643,160.75,8,0.6666666666666666,0.0,0.0,0.16779601227428434,5.648142375755899e-06,3,3,6
org.apache.xalan.xsltc.compiler.Step,25,144,600,0.24,1,0.04,643,25.72,456,0.76,0.07533212560386472,0.003013285024154589,0.18646610741187092,0.015874898818985527,6,24,30
org.apache.xalan.xsltc.compiler.UnresolvedRef,17,110,272,0.40441176470588236,1,0.058823529411764705,645,37.94117647058823,162,0.5955882352941176,0.0,0.0,0.0,0.0,0,16,16
org.apache.xpath.operations.Lt,5,11,20,0.55,1,0.2,643,128.6,9,0.45,0.0,0.0,0.18313406700451104,1.9356352672609055e-05,1,4,5
org.apache.xpath.objects.NotEqualComparator,3,4,6,0.6666666666666666,1,0.3333333333333333,643,214.33333333333334,2,0.3333333333333333,0.0,0.0,0.22911441744760408,0.0,1,2,3
org.apache.xalan.transformer.TransformerImpl,59,358,3422,0.10461718293395675,1,0.01694915254237288,643,10.898305084745763,3064,0.8953828170660433,0.4560866605331214,0.007730282381917312,0.212601117679439,0.0662168039805393,69,58,127
org.apache.xml.utils.AttList,3,3,6,0.5,1,0.3333333333333333,643,214.33333333333334,3,0.5,0.0,0.0,0.1528159438873429,3.8475686029683406e-05,1,2,3
org.apache.xalan.xslt.XSLTProcessorFactory,6,12,30,0.4,1,0.16666666666666666,643,107.16666666666667,18,0.6,0.0,0.0,0.17767952933422776,0.00017517506764795618,1,5,6
org.apache.xml.utils.ObjectPool,6,11,30,0.36666666666666664,1,0.16666666666666666,643,107.16666666666667,19,0.6333333333333333,0.0,0.0,0.17561076504277037,0.0022002625528695845,2,5,7
org.apache.xalan.lib.NodeInfo,5,8,20,0.4,1,0.2,644,128.8,12,0.6,0.0,0.0,0.0,0.0,0,4,4
org.apache.xalan.xsltc.compiler.Expression,15,75,210,0.35714285714285715,1,0.06666666666666667,643,42.86666666666667,135,0.6428571428571429,0.10073260073260075,0.006715506715506717,0.34725464920707677,0.06350932851161165,89,14,103
org.apache.xalan.xsltc.dom.SingleNodeCounter,7,20,42,0.47619047619047616,1,0.14285714285714285,646,92.28571428571429,22,0.5238095238095238,0.0,0.0,0.0011248593925759281,0.0,1,6,7
org.apache.xpath.CachedXPathAPI,9,23,72,0.3194444444444444,1,0.1111111111111111,644,71.55555555555556,49,0.6805555555555556,0.0,0.0,0.0,0.0,1,9,10
org.apache.xalan.xsltc.compiler.ForEach,18,119,306,0.3888888888888889,1,0.05555555555555555,643,35.72222222222222,187,0.6111111111111112,0.006740196078431371,0.00037445533769063174,0.15597662487311037,0.0021642828783125945,2,17,19
org.apache.xpath.DOM2Helper,6,7,30,0.23333333333333334,1,0.16666666666666666,643,107.16666666666667,23,0.7666666666666667,0.0,0.0,0.1810190675893774,0.0032614431486776467,9,5,14
org.apache.xpath.axes.ReverseAxesWalker,7,21,42,0.5,1,0.14285714285714285,643,91.85714285714286,21,0.5,0.0,0.0,0.17205772760970528,9.498236497295581e-06,1,6,7
org.apache.xalan.xsltc.compiler.FormatNumberCall,14,65,182,0.35714285714285715,1,0.07142857142857142,644,46.0,117,0.6428571428571429,0.0,0.0,0.0,0.0,0,13,13
org.apache.xpath.functions.FuncQname,7,21,42,0.5,1,0.14285714285714285,645,92.14285714285714,21,0.5,0.0,0.0,0.0,0.0,0,6,6
org.apache.xpath.axes.IteratorPool,3,3,6,0.5,1,0.3333333333333333,643,214.33333333333334,3,0.5,0.0,0.0,0.20206779637883993,1.3414260461504557e-06,2,2,4
org.apache.xalan.xsltc.compiler.RelativeLocationPath,2,1,2,0.5,1,0.5,643,321.5,1,0.5,0.0,0.0,0.15606798174047065,1.1515759547255611e-07,3,1,4
org.apache.xpath.ExtensionsProvider,2,1,2,0.5,1,0.5,643,321.5,1,0.5,0.0,0.0,0.1770891011242115,7.495706562734948e-07,4,1,5
org.apache.xalan.xsltc.compiler.util.StringStack,2,1,2,0.5,1,0.5,644,322.0,1,0.5,0.0,0.0,0.0,0.0,0,1,1
org.apache.xalan.xsltc.compiler.NamespaceAlias,8,22,56,0.39285714285714285,1,0.125,643,80.375,34,0.6071428571428571,0.0,0.0,0.20937145166964136,0.00347680527500664,3,7,10
org.apache.xml.utils.XMLChar,2,1,2,0.5,1,0.5,643,321.5,1,0.5,0.0,0.0,0.1948282238544213,0.0,2,1,3
org.apache.xalan.extensions.ExtensionHandlerGeneral,18,67,306,0.21895424836601307,1,0.05555555555555555,645,35.833333333333336,239,0.7810457516339869,0.0,0.0,0.0,0.0,0,17,17
org.apache.xalan.xsltc.runtime.output.StreamUnknownOutput,9,25,72,0.3472222222222222,1,0.1111111111111111,643,71.44444444444444,47,0.6527777777777778,0.0,0.0,0.14544763509364825,0.0010877943667594963,1,8,9
org.apache.xalan.templates.DecimalFormatProperties,8,22,56,0.39285714285714285,1,0.125,643,80.375,34,0.6071428571428571,0.03571428571428571,0.004464285714285714,0.19870251117939117,4.726636776165618e-05,3,7,10
org.apache.xalan.transformer.TransformSnapshotImpl,14,43,182,0.23626373626373626,1,0.07142857142857142,643,45.92857142857143,139,0.7637362637362637,0.005341880341880341,0.0003815628815628815,0.17370278193713398,0.0006416665028867441,1,13,14
org.apache.xml.utils.DefaultErrorHandler,5,5,20,0.25,1,0.2,643,128.6,15,0.75,0.0,0.0,0.2675301882445417,7.807402923183773e-05,11,4,15
org.apache.xalan.xsltc.compiler.util.NodeType,16,115,240,0.4791666666666667,1,0.0625,643,40.1875,125,0.5208333333333334,0.004761904761904762,0.00029761904761904765,0.22057952606917514,5.9453899685918947e-05,14,15,29
org.apache.xpath.objects.XStringForChars,6,12,30,0.4,1,0.16666666666666666,643,107.16666666666667,18,0.6,0.0,0.0,0.23204069738017144,1.9001003252971758e-06,1,5,6
org.apache.xalan.xsltc.compiler.util.ClassGenerator,8,27,56,0.48214285714285715,1,0.125,643,80.375,29,0.5178571428571429,0.11111111111111109,0.013888888888888886,0.2874434385022261,0.03907621194304853,119,7,126
org.apache.xalan.xsltc.util.JavaCupRedirect,2,1,2,0.5,1,0.5,644,322.0,1,0.5,0.0,0.0,0.0,0.0,0,1,1
org.apache.xalan.xsltc.compiler.KeyPattern,3,3,6,0.5,1,0.3333333333333333,644,214.66666666666666,3,0.5,0.0,0.0,0.0,0.0,0,2,2
org.apache.xpath.axes.ChildTestIterator,7,15,42,0.35714285714285715,1,0.14285714285714285,643,91.85714285714286,27,0.6428571428571429,0.03333333333333333,0.0047619047619047615,0.20232351366102017,0.0011997803658739905,7,6,13
org.apache.xalan.xsltc.dom.SingletonIterator,3,4,6,0.6666666666666666,1,0.3333333333333333,643,214.33333333333334,2,0.3333333333333333,0.0,0.0,0.15717267056128406,9.92274614321858e-06,4,2,6
org.apache.xpath.objects.XNumber,9,24,72,0.3333333333333333,1,0.1111111111111111,643,71.44444444444444,48,0.6666666666666666,0.2857142857142857,0.031746031746031744,0.2996177670444868,0.012112616594535624,32,8,40
org.apache.xpath.axes.RTFIterator,3,3,6,0.5,1,0.3333333333333333,643,214.33333333333334,3,0.5,0.0,0.0,0.157018307302041,0.00040364668458308967,2,2,4
org.apache.xalan.processor.WhitespaceInfoPaths,4,8,12,0.6666666666666666,1,0.25,643,160.75,4,0.3333333333333333,0.0,0.0,0.13638972913746641,1.2667335501981172e-06,2,3,5
org.apache.xalan.xsltc.compiler.util.IntType,14,88,182,0.4835164835164835,1,0.07142857142857142,643,45.92857142857143,94,0.5164835164835165,0.016025641025641024,0.0011446886446886445,0.2207013259179157,0.0003156457472488241,8,13,21
org.apache.xalan.xsltc.compiler.util.NodeSetType,15,113,210,0.5380952380952381,1,0.06666666666666667,643,42.86666666666667,97,0.46190476190476193,0.0,0.0,0.2636478240351882,0.0016653739342347602,15,14,29
org.apache.xalan.xpath.xml.FormatterToText,3,4,6,0.6666666666666666,1,0.3333333333333333,643,214.33333333333334,2,0.3333333333333333,0.0,0.0,0.17771903123047814,0.0010665896492668147,1,2,3
org.apache.xml.utils.res.XResources_ja_JP_A,2,2,2,1.0,1,0.5,644,322.0,0,0.0,0.0,0.0,0.0,0.0,0,1,1
org.apache.xml.utils.res.XResources_ja_JP_I,2,2,2,1.0,1,0.5,644,322.0,0,0.0,0.0,0.0,0.0,0.0,0,1,1
org.apache.xpath.functions.FuncContains,6,12,30,0.4,1,0.16666666666666666,644,107.33333333333333,18,0.6,0.0,0.0,0.0,0.0,0,5,5
org.apache.xalan.xsltc.compiler.util.MethodType,3,4,6,0.6666666666666666,1,0.3333333333333333,643,214.33333333333334,2,0.3333333333333333,0.0,0.0,0.26399610385557815,8.687748275398505e-07,8,2,10
org.apache.xml.utils.FastStringBuffer,3,4,6,0.6666666666666666,1,0.3333333333333333,643,214.33333333333334,2,0.3333333333333333,0.0,0.0,0.3165862188018577,0.0005758522936312276,20,3,23
org.apache.xpath.functions.FuncSubstringBefore,6,13,30,0.43333333333333335,1,0.16666666666666666,644,107.33333333333333,17,0.5666666666666667,0.0,0.0,0.0,0.0,0,5,5
org.apache.xalan.templates.OutputProperties,14,48,182,0.26373626373626374,1,0.07142857142857142,643,45.92857142857143,134,0.7362637362637363,0.09722222222222221,0.006944444444444443,0.20560190392867558,0.00808361709826736,17,14,31
org.apache.xpath.operations.Number,6,16,30,0.5333333333333333,1,0.16666666666666666,643,107.16666666666667,14,0.4666666666666667,0.0,0.0,0.18317603173113903,2.7048560499989672e-05,2,5,7
org.apache.xml.utils.URI,5,9,20,0.45,1,0.2,643,128.6,11,0.55,0.0,0.0,0.18773607385502364,4.961373071609292e-06,2,5,7
org.apache.xpath.operations.Mult,6,16,30,0.5333333333333333,1,0.16666666666666666,643,107.16666666666667,14,0.4666666666666667,0.0,0.0,0.18317603173113903,2.677711759637579e-05,2,5,7
org.apache.xpath.axes.BasicTestIterator,11,35,110,0.3181818181818182,1,0.09090909090909091,643,58.45454545454545,75,0.6818181818181818,0.05,0.004545454545454546,0.16692006733654013,0.0005230401882595539,2,10,12
org.apache.xalan.xsltc.compiler.ValueOf,12,49,132,0.3712121212121212,1,0.08333333333333333,643,53.583333333333336,83,0.6287878787878788,0.0,0.0,0.1558853748975606,1.0678224474869459e-06,1,11,12
org.apache.xalan.xpath.XPathSupport,1,0,0,0,1,1.0,-1,-1.0,0,0,0.0,0.0,0.29589285091209977,0.0,5,0,5
org.apache.xml.utils.Hashtree2Node,2,1,2,0.5,1,0.5,644,322.0,1,0.5,0.0,0.0,0.0020247469066366703,5.700300975891528e-06,1,1,2
org.apache.xalan.processor.ProcessorStylesheetElement,8,23,56,0.4107142857142857,1,0.125,643,80.375,33,0.5892857142857143,0.045634920634920625,0.005704365079365078,0.16772559850497076,0.00012066587915660537,2,7,9
org.apache.xalan.xsltc.dom.DTDMonitor,6,12,30,0.4,1,0.16666666666666666,643,107.16666666666667,18,0.6,0.1,0.016666666666666666,0.1716881878167291,0.00038956923556355996,10,5,15
org.apache.xalan.xsltc.dom.CurrentNodeListFilter,2,1,2,0.5,1,0.5,644,322.0,1,0.5,0.0,0.0,0.0011248593925759281,0.0,1,1,2
org.apache.xalan.xsltc.compiler.util.SlotAllocator,3,4,6,0.6666666666666666,1,0.3333333333333333,643,214.33333333333334,2,0.3333333333333333,0.0,0.0,0.2208232603521245,2.7476053910249637e-06,1,2,3
org.apache.xalan.xpath.XBooleanStatic,4,6,12,0.5,1,0.25,644,161.0,6,0.5,0.0,0.0,0.0,0.0,0,3,3
org.apache.xalan.trace.TraceManager,15,50,210,0.23809523809523808,1,0.06666666666666667,643,42.86666666666667,160,0.7619047619047619,0.2994505494505495,0.019963369963369965,0.20413181881376166,0.007423145350359929,28,14,42
org.apache.xalan.xsltc.compiler.util.AttributeSetMethodGenerator,5,8,20,0.4,1,0.2,643,128.6,12,0.6,0.0,0.0,0.17899243226034273,4.976453232921175e-07,1,4,5
org.apache.xml.utils.res.XResources_cy,2,2,2,1.0,1,0.5,644,322.0,0,0.0,0.0,0.0,0.0,0.0,0,1,1
org.apache.xalan.xsltc.compiler.QName,3,2,6,0.3333333333333333,1,0.3333333333333333,643,214.33333333333334,4,0.6666666666666666,0.0,0.0,0.25996104145518395,0.0008705958115560483,82,2,84
org.apache.xalan.processor.XSLTElementProcessor,11,32,110,0.2909090909090909,1,0.09090909090909091,643,58.45454545454545,78,0.7090909090909091,0.11111111111111112,0.010101010101010102,0.15226289570946488,0.0013536196727086292,13,10,23
org.apache.xalan.templates.ElemPI,15,67,210,0.319047619047619,1,0.06666666666666667,643,42.86666666666667,143,0.680952380952381,0.0,0.0,0.15908063730839614,2.4358355395560345e-05,1,14,15
org.apache.xml.dtm.ref.DTMDefaultBaseTraversers,30,81,870,0.09310344827586207,1,0.03333333333333333,643,21.433333333333334,789,0.906896551724138,0.0,0.0,0.1495846187265514,0.023179050910469467,2,29,31
org.apache.xalan.xsltc.compiler.Import,15,80,210,0.38095238095238093,1,0.06666666666666667,644,42.93333333333333,130,0.6190476190476191,0.0,0.0,0.0,0.0,0,14,14
org.apache.xml.utils.NodeVector,2,2,2,1.0,1,0.5,643,321.5,0,0.0,0.0,0.0,0.25778142614469224,6.936874203465879e-07,8,2,10
org.apache.xml.dtm.DTMWSFilter,2,1,2,0.5,1,0.5,643,321.5,1,0.5,0.0,0.0,0.2726399053460746,3.5626808945440172e-06,12,1,13
org.apache.xalan.templates.XSLTVisitable,2,1,2,0.5,1,0.5,643,321.5,1,0.5,0.0,0.0,0.19123928288868197,0.0002012787520764781,3,1,4
org.apache.xalan.xsltc.trax.DOM2TO,4,4,12,0.3333333333333333,1,0.25,643,160.75,8,0.6666666666666666,0.0,0.0,0.16861004059790985,4.321323367720963e-06,1,3,4
org.apache.xalan.xpath.XNull,7,20,42,0.47619047619047616,1,0.14285714285714285,643,91.85714285714286,22,0.5238095238095238,0.0,0.0,0.1673043538038281,0.00038383133165823034,2,6,8
org.apache.xalan.trace.TraceListener,4,3,12,0.25,1,0.25,643,160.75,9,0.75,0.0,0.0,0.17669765748777425,0.00045322627760788464,3,3,6
org.apache.xml.utils.res.XResources_en,2,2,2,1.0,1,0.5,644,322.0,0,0.0,0.0,0.0,0.0,0.0,0,1,1
org.apache.xalan.xsltc.compiler.VariableRefBase,10,34,90,0.37777777777777777,1,0.1,643,64.3,56,0.6222222222222222,0.19444444444444442,0.01944444444444444,0.2567877296738486,0.002087069523957746,10,9,19
org.apache.xalan.templates.ElemCallTemplate,21,145,420,0.34523809523809523,1,0.047619047619047616,643,30.61904761904762,275,0.6547619047619048,0.0,0.0,0.15914397819524004,2.83321122833975e-05,2,20,22
org.apache.xpath.operations.Gt,5,11,20,0.55,1,0.2,643,128.6,9,0.45,0.0,0.0,0.18313406700451104,1.9356352672609055e-05,1,4,5
org.apache.xalan.xsltc.cmdline.Transform,14,36,182,0.1978021978021978,1,0.07142857142857142,644,46.0,146,0.8021978021978022,0.0,0.0,0.0,0.0,0,13,13
org.apache.xalan.templates.VarNameCollector,6,12,30,0.4,1,0.16666666666666666,643,107.16666666666667,18,0.6,0.0,0.0,0.15618995749798567,1.6370561335335477e-06,1,5,6
org.apache.xalan.xsltc.runtime.output.OutputBase,7,13,42,0.30952380952380953,1,0.14285714285714285,643,91.85714285714286,29,0.6904761904761905,0.0,0.0,0.12741157195962555,0.0005202474690663667,2,6,8
org.apache.xalan.xsltc.compiler.StartsWithCall,10,29,90,0.32222222222222224,1,0.1,644,64.4,61,0.6777777777777778,0.0,0.0,0.0,0.0,0,9,9
org.apache.xalan.xsltc.compiler.AttributeSet,16,78,240,0.325,1,0.0625,643,40.1875,162,0.675,0.23174603174603176,0.014484126984126985,0.22045786058320205,0.008473058486852517,3,15,18
org.apache.xalan.extensions.ExpressionVisitor,8,14,56,0.25,1,0.125,643,80.375,42,0.75,0.0,0.0,0.15180026632637497,0.00015816484830076684,1,7,8
org.apache.xalan.xsltc.compiler.CompilerException,2,1,2,0.5,1,0.5,643,321.5,1,0.5,0.0,0.0,0.221189873401962,0.0,2,1,3
org.apache.xalan.xsltc.compiler.Choose,15,76,210,0.3619047619047619,1,0.06666666666666667,643,42.86666666666667,134,0.638095238095238,0.0,0.0,0.1510259214953128,0.002655960260216891,1,14,15
org.apache.xalan.transformer.TransformState,5,9,20,0.45,1,0.2,643,128.6,11,0.55,0.0,0.0,0.16297251834346393,0.0008187723253642136,2,4,6
org.apache.xalan.xsltc.compiler.ProcessingInstructionPattern,12,41,132,0.3106060606060606,1,0.08333333333333333,644,53.666666666666664,91,0.6893939393939394,0.0,0.0,0.0,0.0,0,11,11
org.apache.xml.utils.synthetic.reflection.EntryPoint,6,15,30,0.5,1,0.16666666666666666,643,107.16666666666667,15,0.5,0.0,0.0,0.13808606019600805,0.0004059881028384966,3,5,8
org.apache.xpath.operations.NotEquals,5,11,20,0.55,1,0.2,643,128.6,9,0.45,0.0,0.0,0.18313406700451104,1.9356352672609055e-05,1,4,5
org.apache.xalan.xpath.xml.ProblemListener,3,2,6,0.3333333333333333,1,0.3333333333333333,643,214.33333333333334,4,0.6666666666666666,0.0,0.0,0.1675498223589794,0.0,3,2,5
org.apache.xpath.functions.FuncExtFunction,12,43,132,0.32575757575757575,1,0.08333333333333333,643,53.583333333333336,89,0.6742424242424242,0.0,0.0,0.18431639439121297,0.001145349773285593,3,11,14
org.apache.xpath.functions.FuncSum,9,25,72,0.3472222222222222,1,0.1111111111111111,644,71.55555555555556,47,0.6527777777777778,0.0,0.0,0.0,0.0,0,8,8
org.apache.xalan.xpath.xml.ProblemListenerDefault,5,6,20,0.3,1,0.2,643,128.6,14,0.7,0.0,0.0,0.167269345569092,0.0,1,4,5
org.apache.xalan.xsltc.compiler.FloorCall,5,7,20,0.35,1,0.2,644,128.8,13,0.65,0.0,0.0,0.0,0.0,0,4,4
org.apache.xalan.templates.KeyDeclaration,10,37,90,0.4111111111111111,1,0.1,643,64.3,53,0.5888888888888889,0.03819444444444444,0.003819444444444444,0.19899930357846418,0.0011593485500011914,5,9,14
org.apache.xml.utils.res.XResources_zh_CN,2,2,2,1.0,1,0.5,644,322.0,0,0.0,0.0,0.0,0.0,0.0,0,1,1
org.apache.xalan.xslt.XSLTEngineImpl,45,223,1980,0.11262626262626263,1,0.022222222222222223,643,14.28888888888889,1757,0.8873737373737374,0.11772186147186146,0.002616041366041366,0.20278543949129646,0.07620119993280354,6,44,50
org.apache.xpath.functions.FuncTranslate,6,13,30,0.43333333333333335,1,0.16666666666666666,644,107.33333333333333,17,0.5666666666666667,0.0,0.0,0.0,0.0,0,5,5
org.apache.xalan.xsltc.compiler.util.NumberType,2,2,2,1.0,1,0.5,643,321.5,0,0.0,0.0,0.0,0.18242359709600425,0.0,4,1,5
org.apache.xalan.processor.ProcessorCharacters,7,11,42,0.2619047619047619,1,0.14285714285714285,643,91.85714285714286,31,0.7380952380952381,0.0,0.0,0.15914397819524004,0.00010046604042577889,2,6,8
org.apache.xalan.extensions.ExtensionNamespacesManager,5,7,20,0.35,1,0.2,643,128.6,13,0.65,0.0,0.0,0.19051005778710453,0.0017684405814933101,5,4,9
org.apache.xalan.extensions.ExtensionNamespaceSupport,3,3,6,0.5,1,0.3333333333333333,643,214.33333333333334,3,0.5,0.0,0.0,0.16247565090948998,7.515952397842161e-06,4,2,6
org.apache.xalan.processor.ProcessorExsltFuncResult,8,17,56,0.30357142857142855,1,0.125,643,80.375,39,0.6964285714285714,0.0,0.0,0.15908063730839614,2.613713505320306e-05,1,7,8
org.apache.xalan.processor.ProcessorTemplateElem,6,15,30,0.5,1,0.16666666666666666,643,107.16666666666667,15,0.5,0.0,0.0,0.1595887806896967,0.00012657953809977487,9,5,14
org.apache.xalan.lib.sql.DefaultConnectionPool,6,9,30,0.3,1,0.16666666666666666,646,107.66666666666667,21,0.7,0.0,0.0,0.0022497187851518562,5.320280910832092e-06,2,5,7
org.apache.xalan.templates.ElemExsltFuncResult,10,40,90,0.4444444444444444,1,0.1,643,64.3,50,0.5555555555555556,0.0,0.0,0.15930255131022134,0.00015210869492741105,4,9,13
org.apache.xml.utils.WrappedRuntimeException,2,1,2,0.5,1,0.5,643,321.5,1,0.5,0.0,0.0,0.3310062950205759,0.003730700973945015,36,1,37
org.apache.xalan.templates.ElemParam,14,70,182,0.38461538461538464,1,0.07142857142857142,643,45.92857142857143,112,0.6153846153846154,0.0,0.0,0.196891675486377,0.0007092748388900909,9,14,23
org.apache.xpath.patterns.FunctionPattern,11,37,110,0.33636363636363636,1,0.09090909090909091,643,58.45454545454545,73,0.6636363636363637,0.08888888888888889,0.00808080808080808,0.18372332853934512,0.0014475517180253545,3,10,13
org.apache.xalan.xsltc.dom.CurrentNodeListIterator,7,13,42,0.30952380952380953,1,0.14285714285714285,645,92.14285714285714,29,0.6904761904761905,0.0,0.0,0.0,0.0,0,6,6
org.apache.xpath.functions.FuncLang,7,15,42,0.35714285714285715,1,0.14285714285714285,644,92.0,27,0.6428571428571429,0.0,0.0,0.0,0.0,0,6,6
org.apache.xpath.functions.FuncUnparsedEntityURI,7,17,42,0.40476190476190477,1,0.14285714285714285,644,92.0,25,0.5952380952380952,0.0,0.0,0.0,0.0,0,6,6
org.apache.xalan.templates.ElemApplyTemplates,25,169,600,0.2816666666666667,1,0.04,643,25.72,431,0.7183333333333334,0.1816727053140097,0.007266908212560388,0.18983144205050836,0.0014032212627807371,2,24,26
org.apache.xalan.xsltc.dom.UnionIterator,6,13,30,0.43333333333333335,1,0.16666666666666666,645,107.5,17,0.5666666666666667,0.0,0.0,0.0011248593925759281,5.636964298381622e-06,2,6,8
org.apache.xml.dtm.ref.dom2dtm.DOM2DTM,21,64,420,0.1523809523809524,1,0.047619047619047616,643,30.61904761904762,356,0.8476190476190476,0.06447368421052631,0.003070175438596491,0.1826737208580189,0.009312741223998033,2,20,22
org.apache.xml.dtm.ref.DTMDocumentImpl,16,41,240,0.17083333333333334,1,0.0625,646,40.375,199,0.8291666666666667,0.0,0.0,0.0,0.0,0,15,15
org.apache.xalan.xsltc.compiler.EqualityExpr,21,153,420,0.36428571428571427,1,0.047619047619047616,643,30.61904761904762,267,0.6357142857142857,0.0,0.0,0.15229190369112033,1.6614277722264225e-06,1,20,21
org.apache.xalan.xsltc.runtime.Constants,1,0,0,0,1,1.0,-1,-1.0,0,0,0.0,0.0,0.14786452117917812,0.0,7,0,7
org.w3c.dom.xpath.XPathException,2,1,2,0.5,1,0.5,644,322.0,1,0.5,0.0,0.0,0.0,0.0,0,1,1
org.apache.xpath.operations.Quo,5,11,20,0.55,1,0.2,643,128.6,9,0.45,0.0,0.0,0.1588909168107117,1.468426272402981e-06,1,4,5
org.apache.xpath.axes.FilterExprWalker,18,85,306,0.2777777777777778,1,0.05555555555555555,643,35.72222222222222,221,0.7222222222222222,0.18180147058823531,0.010100081699346406,0.196311444615592,0.0064647785773453035,5,17,22
org.apache.xalan.xsltc.compiler.Include,15,81,210,0.38571428571428573,1,0.06666666666666667,643,42.86666666666667,129,0.6142857142857143,0.0,0.0,0.1855140873693875,0.0,1,14,15
org.apache.xalan.processor.StylesheetHandler,32,131,992,0.13205645161290322,1,0.03125,643,20.09375,861,0.8679435483870968,0.17973246287762418,0.0056166394649257555,0.18061007737792378,0.022703680169213224,26,31,57
org.apache.xalan.lib.sql.PooledConnection,1,0,0,0,1,1.0,-1,-1.0,0,0,0.0,0.0,0.0020247469066366703,0.0,1,0,1
org.apache.xalan.trace.EndSelectionEvent,7,17,42,0.40476190476190477,1,0.14285714285714285,643,91.85714285714286,25,0.5952380952380952,0.0,0.0,0.1682197395780073,0.0008325027145372399,3,6,9
org.apache.xalan.xsltc.compiler.util.ReferenceType,16,129,240,0.5375,1,0.0625,643,40.1875,111,0.4625,0.036111111111111115,0.0022569444444444447,0.22094532959499466,6.562161960979155e-05,18,15,33
org.apache.xpath.objects.GreaterThanOrEqualComparator,3,4,6,0.6666666666666666,1,0.3333333333333333,643,214.33333333333334,2,0.3333333333333333,0.0,0.0,0.22911441744760408,0.0,1,2,3
org.apache.xalan.xsltc.compiler.SimpleAttributeValue,8,18,56,0.32142857142857145,1,0.125,643,80.375,38,0.6785714285714286,0.14285714285714285,0.017857142857142856,0.1545592038814174,2.68436152631507e-05,1,7,8
org.apache.xalan.xsltc.compiler.VariableRef,9,30,72,0.4166666666666667,1,0.1111111111111111,643,71.44444444444444,42,0.5833333333333334,0.0,0.0,0.11762510336590504,1.4145191310545642e-06,2,8,10
org.apache.xpath.objects.XNodeSetForDOM,8,21,56,0.375,1,0.125,643,80.375,35,0.625,0.0,0.0,0.2266459320880892,7.564627544284284e-05,1,7,8
org.apache.xalan.xsltc.compiler.util.VoidType,8,29,56,0.5178571428571429,1,0.125,643,80.375,27,0.48214285714285715,0.0,0.0,0.21973067687594577,0.0,1,7,8
org.apache.xpath.functions.FuncNumber,6,15,30,0.5,1,0.16666666666666666,645,107.5,15,0.5,0.0,0.0,0.0,0.0,0,5,5
org.apache.xpath.patterns.UnionPattern,12,51,132,0.38636363636363635,1,0.08333333333333333,643,53.583333333333336,81,0.6136363636363636,0.10863636363636363,0.009053030303030302,0.23991002475230813,0.009730773981130288,4,11,15
org.apache.xalan.transformer.KeyTable,12,35,132,0.26515151515151514,1,0.08333333333333333,643,53.583333333333336,97,0.7348484848484849,0.0,0.0,0.14732403289249738,0.0021404640365551503,1,11,12
org.apache.xalan.xsltc.compiler.LocalNameCall,5,7,20,0.35,1,0.2,645,129.0,13,0.65,0.0,0.0,0.0,0.0,0,4,4
org.apache.xalan.xsltc.cmdline.getopt.GetOptsException,2,1,2,0.5,1,0.5,644,322.0,1,0.5,0.0,0.0,0.0035995500562429703,0.0,3,1,4
org.apache.xalan.xsltc.dom.NodeCounter,4,5,12,0.4166666666666667,1,0.25,644,161.0,7,0.5833333333333334,0.0,0.0,0.005061867266591676,7.600401301188703e-06,5,4,9
org.apache.xpath.functions.FuncExtElementAvailable,12,29,132,0.2196969696969697,1,0.08333333333333333,644,53.666666666666664,103,0.7803030303030303,0.0,0.0,0.0,0.0,0,11,11
org.apache.xml.dtm.DTMManager,11,22,110,0.2,1,0.09090909090909091,643,58.45454545454545,88,0.8,0.08333333333333334,0.007575757575757577,0.2777554560370711,0.0031120958106797907,28,11,39
org.apache.xalan.xsltc.ProcessorVersion,2,1,2,0.5,1,0.5,644,322.0,1,0.5,0.0,0.0,0.0,0.0,0,1,1
org.apache.xpath.objects.XBooleanStatic,4,7,12,0.5833333333333334,1,0.25,643,160.75,5,0.4166666666666667,0.0,0.0,0.1881337261649072,4.686914135733034e-06,3,3,6
org.apache.xalan.transformer.TransformerClient,2,1,2,0.5,1,0.5,643,321.5,1,0.5,0.0,0.0,0.162906093840369,0.0,1,1,2
org.apache.xpath.functions.FuncStartsWith,7,15,42,0.35714285714285715,1,0.14285714285714285,644,92.0,27,0.6428571428571429,0.0,0.0,0.0,0.0,0,6,6
org.apache.xalan.lib.sql.DTMDocument,13,26,156,0.16666666666666666,1,0.07692307692307693,647,49.76923076923077,130,0.8333333333333334,0.0,0.0,0.002530933633295838,0.0006368896201955138,2,12,14
org.apache.xpath.operations.String,5,14,20,0.7,1,0.2,643,128.6,6,0.3,0.5,0.1,0.6294332302950321,0.2772323864848629,438,4,442
org.apache.xalan.xsltc.compiler.Predicate,39,295,1482,0.199055330634278,1,0.02564102564102564,643,16.487179487179485,1187,0.800944669365722,0.13846779109937005,0.0035504561820351296,0.1813064646120868,0.017187745551269576,6,38,44
org.apache.xml.utils.Trie,3,3,6,0.5,1,0.3333333333333333,643,214.33333333333334,3,0.5,0.5,0.16666666666666666,0.23130214191976003,0.005694600674915636,2,2,4
org.apache.xml.utils.StringBufferPool,3,3,6,0.5,1,0.3333333333333333,643,214.33333333333334,3,0.5,0.0,0.0,0.1845717391998824,0.0005040025376025841,4,2,6
org.apache.xalan.templates.AVTPartSimple,7,15,42,0.35714285714285715,1,0.14285714285714285,643,91.85714285714286,27,0.6428571428571429,0.0,0.0,0.14811565730492693,0.0,1,6,7
org.apache.xalan.xsltc.trax.TransformerFactoryImpl,12,36,132,0.2727272727272727,1,0.08333333333333333,643,53.583333333333336,96,0.7272727272727273,0.23409090909090907,0.019507575757575755,0.17947467500554348,0.009076394382626276,6,11,17
org.apache.xml.utils.SuballocatedIntVector,1,0,0,0,1,1.0,-1,-1.0,0,0,0.0,0.0,0.21321922306279037,0.0,13,0,13
org.w3c.dom.xpath.XPathExpression,3,3,6,0.5,1,0.3333333333333333,645,215.0,3,0.5,0.0,0.0,0.0011248593925759281,0.0,1,2,3
org.apache.xalan.xsltc.cmdline.getopt.MissingOptArgException,3,3,6,0.5,1,0.3333333333333333,645,215.0,3,0.5,0.0,0.0,0.0014998125234345708,6.333667750990586e-07,1,2,3
org.apache.xalan.xsltc.compiler.ElementAvailableCall,11,37,110,0.33636363636363636,1,0.09090909090909091,644,58.54545454545455,73,0.6636363636363637,0.0,0.0,0.0,0.0,0,10,10
org.apache.xpath.ExpressionNode,1,1,0,0,1,1.0,-1,-1.0,-1,0,0.0,0.0,0.25055592253594944,0.0,6,1,7
org.apache.xpath.axes.LocPathIterator,21,95,420,0.2261904761904762,1,0.047619047619047616,643,30.61904761904762,325,0.7738095238095238,0.20570175438596489,0.009795321637426899,0.25580166479190103,0.01291114179883821,20,20,40
org.apache.xalan.xsltc.trax.SAX2DOM,4,3,12,0.25,1,0.25,643,160.75,9,0.75,0.0,0.0,0.14544763509364825,6.3336677509905865e-06,1,3,4
org.apache.xalan.xsltc.compiler.ParentPattern,15,70,210,0.3333333333333333,1,0.06666666666666667,643,42.86666666666667,140,0.6666666666666666,0.0,0.0,0.1558853748975606,5.582320270905397e-05,1,14,15
org.apache.xalan.xsltc.compiler.util.StringType,12,71,132,0.5378787878787878,1,0.08333333333333333,643,53.583333333333336,61,0.4621212121212121,0.0022727272727272726,0.0001893939393939394,0.22076227629789855,7.775153611616834e-05,18,11,29
org.apache.xml.utils.synthetic.reflection.Member,1,0,0,0,1,1.0,-1,-1.0,0,0,0.0,0.0,0.13838995514161764,0.0,4,0,4
org.apache.xalan.xsltc.runtime.MessageHandler,2,1,2,0.5,1,0.5,643,321.5,1,0.5,0.0,0.0,0.14587229972165888,0.0,2,1,3
org.apache.xalan.xsltc.compiler.util.MethodGenerator,6,13,30,0.43333333333333335,1,0.16666666666666666,643,107.16666666666667,17,0.5666666666666667,0.15000000000000002,0.025000000000000005,0.287650306755916,0.002274928034624242,121,5,126
org.apache.xpath.patterns.NodeTestFilter,2,1,2,0.5,1,0.5,0,0.0,1,0.5,0.0,0.0,0.0,0.0,0,1,1
org.apache.xalan.xsltc.compiler.LangCall,11,32,110,0.2909090909090909,1,0.09090909090909091,644,58.54545454545455,78,0.7090909090909091,0.0,0.0,0.0,0.0,0,10,10
org.apache.xalan.xsltc.dom.FilterIterator,4,7,12,0.5833333333333334,1,0.25,643,160.75,5,0.4166666666666667,0.0,0.0,0.1550989915550428,0.0,1,3,4
org.apache.xalan.xsltc.compiler.RelativePathPattern,2,2,2,1.0,1,0.5,643,321.5,0,0.0,0.0,0.0,0.18389238612254213,0.00014546999206560595,5,1,6
org.apache.xpath.axes.AxesWalker,16,69,240,0.2875,1,0.0625,643,40.1875,171,0.7125,0.03817460317460318,0.002385912698412699,0.1964561814880046,0.00025333488229424593,8,16,24
