name,Size,Ties,Pairs,Density,WeakComp,nWeakComp,2StepReach,ReachEffic,Broker,nBroker,EgoBetween,nEgoBetween,Closeness_Centrality,Betweenness_Centrality,in_degree,out_degree,degree
org.apache.xpath.res.XPATHErrorResources_sv,2,2,2,1.0,1,0.5,648,324.0,0,0.0,0.0,0.0,0.0,0.0,0,1,1
org.apache.xalan.xsltc.compiler.TransletOutput,14,62,182,0.34065934065934067,1,0.07142857142857142,648,46.285714285714285,120,0.6593406593406593,0.0,0.0,0.0,0.0,0,13,13
org.apache.xalan.lib.Extensions,14,43,182,0.23626373626373626,1,0.07142857142857142,655,46.785714285714285,139,0.7637362637362637,0.0,0.0,0.0010351966873706005,0.00014707144675700303,1,13,14
org.apache.xml.serializer.ToHTMLStream,15,37,210,0.1761904761904762,1,0.06666666666666667,647,43.13333333333333,173,0.8238095238095238,0.0,0.0,0.13667740602884376,0.004069224569460611,1,14,15
org.apache.xpath.functions.FuncConcat,9,26,72,0.3611111111111111,1,0.1111111111111111,650,72.22222222222223,46,0.6388888888888888,0.0,0.0,0.0,0.0,0,8,8
org.apache.xpath.patterns.StepPattern,15,48,210,0.22857142857142856,1,0.06666666666666667,647,43.13333333333333,162,0.7714285714285715,0.23260073260073258,0.015506715506715505,0.24082219471492605,0.004315241681689256,18,15,33
org.apache.xpath.functions.FunctionDef1Arg,10,27,90,0.3,1,0.1,648,64.8,63,0.7,0.0,0.0,0.009316770186335404,3.700962250185048e-05,9,9,18
org.apache.xalan.res.XSLTErrorResources_zh_CN,2,2,2,1.0,1,0.5,648,324.0,0,0.0,0.0,0.0,0.0,0.0,0,1,1
org.apache.xalan.templates.Stylesheet,24,131,552,0.23731884057971014,1,0.041666666666666664,647,26.958333333333332,421,0.7626811594202898,0.21783832109919066,0.009076596712466278,0.2302687765128301,0.021519871445967582,36,23,59
org.apache.xalan.xsltc.dom.LoadDocument,15,57,210,0.2714285714285714,1,0.06666666666666667,654,43.6,153,0.7285714285714285,0.0,0.0,0.0,0.0,0,14,14
org.apache.xalan.xsltc.compiler.AttributeValue,6,15,30,0.5,1,0.16666666666666666,647,107.83333333333333,15,0.5,0.30000000000000004,0.05000000000000001,0.18163707906464763,0.0015727600584169053,8,6,14
org.apache.xalan.xsltc.dom.FilteredStepIterator,4,5,12,0.4166666666666667,1,0.25,2,0.5,7,0.5833333333333334,0.0,0.0,0.0,0.0,0,3,3
org.apache.xalan.xsltc.compiler.NamespaceAlias,8,22,56,0.39285714285714285,1,0.125,647,80.875,34,0.6071428571428571,0.0,0.0,0.1988429351869824,0.0029567014400513057,3,7,10
org.apache.xml.serializer.ToTextSAXHandler,4,4,12,0.3333333333333333,1,0.25,647,161.75,8,0.6666666666666666,0.0,0.0,0.16118358648839895,4.629797881218681e-06,2,3,5
org.apache.xalan.templates.ElemLiteralResult,16,48,240,0.2,1,0.0625,647,40.4375,192,0.8,0.18571428571428572,0.011607142857142858,0.1573532964694513,0.0005531023083804286,7,15,22
org.apache.xml.utils.SAXSourceLocator,2,1,2,0.5,1,0.5,647,323.5,1,0.5,0.0,0.0,0.2529380939521366,0.0001730829780651339,9,1,10
org.apache.xalan.xsltc.compiler.FunctionAvailableCall,13,41,156,0.26282051282051283,1,0.07692307692307693,648,49.84615384615385,115,0.7371794871794872,0.0,0.0,0.0,0.0,0,12,12
org.apache.xalan.templates.DecimalFormatProperties,8,22,56,0.39285714285714285,1,0.125,647,80.875,34,0.6071428571428571,0.03571428571428571,0.004464285714285714,0.18586505306387038,3.447312016614342e-05,3,7,10
org.apache.xalan.transformer.TransformSnapshotImpl,15,39,210,0.18571428571428572,1,0.06666666666666667,647,43.13333333333333,171,0.8142857142857143,0.010073260073260074,0.0006715506715506716,0.1587333195334009,5.372214490344065e-05,1,14,15
org.apache.xpath.compiler.OpMapVector,1,0,0,0,1,1.0,-1,-1.0,0,0,0.0,0.0,0.16584683800202413,0.0,2,0,2
org.apache.xml.utils.DefaultErrorHandler,5,5,20,0.25,1,0.2,647,129.4,15,0.75,0.0,0.0,0.25620027131987416,0.0003382560338933342,11,4,15
org.apache.xml.utils.UnImplNode,8,11,56,0.19642857142857142,1,0.125,647,80.875,45,0.8035714285714286,0.0,0.0,0.17999130663555357,0.0025426178411567307,3,7,10
org.apache.xml.res.XMLErrorResources_ko,2,2,2,1.0,1,0.5,648,324.0,0,0.0,0.0,0.0,0.0,0.0,0,1,1
org.apache.xpath.XPathFactory,3,3,6,0.5,1,0.3333333333333333,647,215.66666666666666,3,0.5,0.0,0.0,0.15976082042484893,1.1915904719895263e-05,3,2,5
org.apache.xml.dtm.ref.ExtendedType,2,2,2,1.0,1,0.5,647,323.5,0,0.0,0.0,0.0,0.16099242192644395,0.0013035743056491484,9,2,11
org.apache.xml.utils.res.XResourceBundle,2,2,2,1.0,1,0.5,647,323.5,0,0.0,0.0,0.0,0.13343064589218218,0.012512470633669105,21,2,23
org.apache.xalan.xsltc.compiler.WithParam,14,61,182,0.33516483516483514,1,0.07142857142857142,648,46.285714285714285,121,0.6648351648351648,0.0,0.0,0.0,0.0,0,13,13
org.apache.xalan.lib.PipeDocument,13,41,156,0.26282051282051283,1,0.07692307692307693,650,50.0,115,0.7371794871794872,0.0,0.0,0.0,0.0,0,12,12
org.apache.xalan.xsltc.compiler.Variable,16,95,240,0.3958333333333333,1,0.0625,647,40.4375,145,0.6041666666666666,0.08476190476190476,0.0052976190476190475,0.21552280035085472,0.0001328457103868662,10,15,25
org.apache.xalan.xpath.xml.TreeWalker,4,5,12,0.4166666666666667,1,0.25,648,162.0,7,0.5833333333333334,0.0,0.0,0.0,0.0,0,3,3
org.apache.xalan.xsltc.compiler.SyntaxTreeNode,31,229,930,0.24623655913978496,1,0.03225806451612903,647,20.870967741935484,701,0.7537634408602151,0.34357279693486587,0.011082993449511802,0.26054403791614844,0.04408149144120496,17,31,48
org.apache.xalan.xsltc.compiler.util.RealType,14,88,182,0.4835164835164835,1,0.07142857142857142,647,46.214285714285715,94,0.5164835164835165,0.046474358974358976,0.0033195970695970695,0.21569403138926907,0.0006920379390064841,13,13,26
org.apache.xpath.operations.Or,6,15,30,0.5,1,0.16666666666666666,647,107.83333333333333,15,0.5,0.0,0.0,0.17530362947177788,2.5512037310527805e-05,1,5,6
org.apache.xalan.xsltc.TransletException,2,1,2,0.5,1,0.5,647,323.5,1,0.5,0.0,0.0,0.16328401413910987,0.0,11,1,12
org.apache.xalan.xsltc.runtime.Hashtable,4,4,12,0.3333333333333333,1,0.25,647,161.75,8,0.6666666666666666,0.0,0.0,0.23283609563347052,0.002644817250064931,20,3,23
org.apache.xml.utils.DOM2Helper,6,7,30,0.23333333333333334,1,0.16666666666666666,647,107.83333333333333,23,0.7666666666666667,0.0,0.0,0.1690103055666902,0.0012463392661717831,6,5,11
org.apache.xalan.processor.ProcessorKey,11,33,110,0.3,1,0.09090909090909091,647,58.81818181818182,77,0.7,0.0,0.0,0.14985476771405334,8.002870743780375e-05,1,10,11
org.apache.xml.res.XMLErrorResources_en,2,2,2,1.0,1,0.5,648,324.0,0,0.0,0.0,0.0,0.0,0.0,0,1,1
org.apache.xpath.objects.XRTreeFragSelectWrapper,12,45,132,0.3409090909090909,1,0.08333333333333333,647,53.916666666666664,87,0.6590909090909091,0.0,0.0,0.17602348444475469,3.233661876326685e-05,1,11,12
org.apache.xalan.transformer.KeyRefIterator,17,49,272,0.1801470588235294,1,0.058823529411764705,648,38.11764705882353,223,0.8198529411764706,0.0,0.0,0.0,0.0,0,16,16
org.apache.xpath.compiler.Compiler,48,176,2256,0.07801418439716312,1,0.020833333333333332,647,13.479166666666666,2080,0.9219858156028369,0.10513670469729675,0.0021903480145270154,0.21649672050129717,0.028710658189351264,24,47,71
org.apache.xalan.xsltc.util.IntegerArray,1,1,0,0,1,1.0,-1,-1.0,-1,0,0.0,0.0,0.12113045505949885,0.0,5,1,6
org.apache.xml.res.XMLErrorResources_es,2,2,2,1.0,1,0.5,648,324.0,0,0.0,0.0,0.0,0.0,0.0,0,1,1
org.apache.xml.utils.synthetic.Class,6,14,30,0.4666666666666667,1,0.16666666666666666,647,107.83333333333333,16,0.5333333333333333,0.4,0.06666666666666667,0.1977806368445556,0.007038446748174557,23,6,29
org.apache.xalan.xpath.xml.FormatterToDOM,2,1,2,0.5,1,0.5,0,0.0,1,0.5,0.0,0.0,0.0,0.0,0,1,1
org.apache.xalan.processor.ProcessorExsltFunction,26,71,650,0.10923076923076923,1,0.038461538461538464,647,24.884615384615383,579,0.8907692307692308,0.0,0.0,0.14985476771405334,2.695645196550264e-05,1,25,26
org.apache.xalan.templates.ElemChoose,13,50,156,0.32051282051282054,1,0.07692307692307693,647,49.76923076923077,106,0.6794871794871795,0.0,0.0,0.14988234496243652,2.01722768066148e-05,1,12,13
org.apache.xalan.xsltc.CollatorFactory,2,1,2,0.5,1,0.5,648,324.0,1,0.5,0.0,0.0,0.0027605244996549345,0.0,2,1,3
org.apache.xalan.xsltc.compiler.ParameterRef,11,44,110,0.4,1,0.09090909090909091,648,58.90909090909091,66,0.6,0.0,0.0,0.0010351966873706005,7.151617874753715e-07,1,10,11
org.apache.xalan.xsltc.compiler.FilterParentPath,14,71,182,0.3901098901098901,1,0.07142857142857142,647,46.214285714285715,111,0.6098901098901099,0.0,0.0,0.13972562403943728,3.854211204644056e-06,2,13,15
org.apache.xml.serializer.ToHTMLSAXHandler,5,6,20,0.3,1,0.2,647,129.4,14,0.7,0.0,0.0,0.16118358648839895,0.00030952114692665747,2,4,6
org.apache.xml.utils.AttList,3,3,6,0.5,1,0.3333333333333333,647,215.66666666666666,3,0.5,0.0,0.0,0.1496895170972027,0.00010049538433337366,1,2,3
org.apache.xalan.xslt.XSLTProcessorFactory,6,12,30,0.4,1,0.16666666666666666,647,107.83333333333333,18,0.6,0.0,0.0,0.16638624362122165,0.00012352942219698724,1,5,6
org.apache.xml.serializer.NamespaceMappings,2,1,2,0.5,1,0.5,647,323.5,1,0.5,0.0,0.0,0.17515283065072687,0.0006939903979777828,12,1,13
org.apache.xalan.xsltc.compiler.XslElement,15,78,210,0.37142857142857144,1,0.06666666666666667,647,43.13333333333333,132,0.6285714285714286,0.0,0.0,0.17841416484685213,0.00014287524371687512,1,14,15
org.apache.xml.dtm.ref.IncrementalSAXSource,1,0,0,0,1,1.0,-1,-1.0,0,0,0.0,0.0,0.18204686365877848,0.0,6,0,6
org.apache.xml.serializer.ToUnknownStream,10,18,90,0.2,1,0.1,647,64.7,72,0.8,0.0,0.0,0.13667740602884376,0.00011487562910824259,1,9,10
org.apache.xml.utils.res.XResources_it,2,2,2,1.0,1,0.5,648,324.0,0,0.0,0.0,0.0,0.0,0.0,0,1,1
org.apache.xml.utils.res.XResources_ko,2,2,2,1.0,1,0.5,648,324.0,0,0.0,0.0,0.0,0.0,0.0,0,1,1
org.apache.xpath.CachedXPathAPI,9,23,72,0.3194444444444444,1,0.1111111111111111,648,72.0,49,0.6805555555555556,0.0,0.0,0.0,0.0,1,9,10
org.apache.xalan.xsltc.compiler.ForEach,19,128,342,0.3742690058479532,1,0.05263157894736842,647,34.05263157894737,214,0.6257309941520468,0.00925925925925926,0.00048732943469785583,0.14095892394009693,1.7700254240015447e-06,1,18,19
org.apache.xml.utils.StringVector,2,1,2,0.5,1,0.5,647,323.5,1,0.5,0.0,0.0,0.22430753580993665,0.00010579139782339787,8,1,9
org.apache.xalan.xsltc.dom.DupFilterIterator,6,12,30,0.4,1,0.16666666666666666,647,107.83333333333333,18,0.6,0.0,0.0,0.13856084765666551,0.0005041877390584606,1,5,6
org.apache.xalan.res.XSLTErrorResources_sv,2,2,2,1.0,1,0.5,648,324.0,0,0.0,0.0,0.0,0.0,0.0,0,1,1
org.apache.xpath.functions.FuncQname,7,18,42,0.42857142857142855,1,0.14285714285714285,649,92.71428571428571,24,0.5714285714285714,0.0,0.0,0.0,0.0,0,6,6
org.apache.xpath.axes.IteratorPool,3,3,6,0.5,1,0.3333333333333333,647,215.66666666666666,3,0.5,0.0,0.0,0.195267480826152,1.1359965741583224e-06,2,2,4
org.apache.xalan.xsltc.compiler.RelativeLocationPath,2,1,2,0.5,1,0.5,647,323.5,1,0.5,0.0,0.0,0.139797573382403,1.7879044686884289e-07,3,1,4
org.apache.xalan.xsltc.DOMCache,3,4,6,0.6666666666666666,1,0.3333333333333333,647,215.66666666666666,2,0.3333333333333333,0.0,0.0,0.16042163926056333,0.0,4,2,6
org.apache.xpath.ExtensionsProvider,3,4,6,0.6666666666666666,1,0.3333333333333333,647,215.66666666666666,2,0.3333333333333333,0.0,0.0,0.1617919472637823,5.972951370979922e-06,4,2,6
org.apache.xalan.templates.XSLTVisitable,2,1,2,0.5,1,0.5,647,323.5,1,0.5,0.0,0.0,0.17923870214037851,0.0001693665821856314,3,1,4
org.apache.xalan.xsltc.trax.DOM2TO,6,8,30,0.26666666666666666,1,0.16666666666666666,647,107.83333333333333,22,0.7333333333333333,0.0,0.0,0.15854791951058594,0.0003893693977565739,1,5,6
org.apache.xalan.xpath.XNull,7,20,42,0.47619047619047616,1,0.14285714285714285,647,92.42857142857143,22,0.5238095238095238,0.0,0.0,0.15947927599880166,0.0002515937603089172,2,6,8
org.apache.xalan.trace.TraceListener,4,3,12,0.25,1,0.25,647,161.75,9,0.75,0.0,0.0,0.16591172591686287,0.000380185740090583,3,3,6
org.apache.xml.utils.res.XResources_en,2,2,2,1.0,1,0.5,648,324.0,0,0.0,0.0,0.0,0.0,0.0,0,1,1
org.apache.xalan.xsltc.compiler.VariableRefBase,10,34,90,0.37777777777777777,1,0.1,647,64.7,56,0.6222222222222222,0.19444444444444442,0.01944444444444444,0.2477070141502068,0.0018038019860574948,10,9,19
org.apache.xalan.templates.ElemCallTemplate,21,146,420,0.3476190476190476,1,0.047619047619047616,647,30.80952380952381,274,0.6523809523809524,0.0,0.0,0.14996513764055974,4.587955816176536e-05,3,20,23
org.apache.xpath.XPathException,4,6,12,0.5,1,0.25,647,161.75,6,0.5,0.0,0.0,0.28943164979597724,0.0003964913743303453,4,3,7
org.apache.xml.utils.synthetic.SynthesisException,2,1,2,0.5,1,0.5,647,323.5,1,0.5,0.0,0.0,0.16318586706589458,0.0,5,1,6
org.apache.xalan.xsltc.dom.Filter,1,0,0,0,1,1.0,-1,-1.0,0,0,0.0,0.0,0.002070393374741201,0.0,2,0,2
org.apache.xalan.xsltc.dom.ForwardPositionIterator,2,2,2,1.0,1,0.5,0,0.0,0,0.0,0.0,0.0,0.0,0.0,0,1,1
org.apache.xalan.xsltc.compiler.util.ClassGenerator,8,27,56,0.48214285714285715,1,0.125,647,80.875,29,0.5178571428571429,0.11111111111111109,0.013888888888888886,0.27797292236378157,0.03765782855430245,120,7,127
org.apache.xalan.res.XSLTErrorResources_en,2,2,2,1.0,1,0.5,648,324.0,0,0.0,0.0,0.0,0.0,0.0,0,1,1
org.apache.xalan.xsltc.util.JavaCupRedirect,2,1,2,0.5,1,0.5,648,324.0,1,0.5,0.0,0.0,0.0,0.0,0,1,1
org.apache.xalan.xsltc.compiler.KeyPattern,3,3,6,0.5,1,0.3333333333333333,648,216.0,3,0.5,0.0,0.0,0.0,0.0,0,2,2
org.apache.xpath.axes.ChildTestIterator,7,15,42,0.35714285714285715,1,0.14285714285714285,647,92.42857142857143,27,0.6428571428571429,0.03333333333333333,0.0047619047619047615,0.19531430756016305,0.0010188901837191754,7,6,13
org.apache.xml.utils.res.XResourceBundleBase,2,1,2,0.5,1,0.5,648,324.0,1,0.5,0.0,0.0,0.0,0.0,0,1,1
org.apache.xalan.templates.ElemIf,15,58,210,0.2761904761904762,1,0.06666666666666667,647,43.13333333333333,152,0.7238095238095238,0.0,0.0,0.14985476771405334,2.1722301529115803e-05,1,14,15
org.apache.xalan.xsltc.dom.DOMAdapter,14,40,182,0.21978021978021978,1,0.07142857142857142,647,46.214285714285715,142,0.7802197802197802,0.0,0.0,0.1384901653674341,0.00016523302269770267,5,13,18
org.apache.xml.dtm.ref.dom2dtm.DOM2DTMdefaultNamespaceDeclarationNode,4,4,12,0.3333333333333333,1,0.25,647,161.75,8,0.6666666666666666,0.0,0.0,0.16253455648091797,4.61194214613582e-06,2,3,5
org.apache.xml.utils.XMLCharacterRecognizer,2,1,2,0.5,1,0.5,647,323.5,1,0.5,0.0,0.0,0.2883046593011965,2.3636239991757225e-06,7,1,8
org.apache.xml.dtm.ref.DTMTreeWalker,4,5,12,0.4166666666666667,1,0.25,647,161.75,7,0.5833333333333334,0.0,0.0,0.17740376007969505,0.0005302481814740572,3,3,6
org.apache.xalan.xsltc.dom.MultipleNodeCounter,8,23,56,0.4107142857142857,1,0.125,650,81.25,33,0.5892857142857143,0.055555555555555546,0.006944444444444443,0.0010351966873706005,0.00022849419109838122,1,7,8
org.apache.xalan.transformer.ClonerToResultTree,6,9,30,0.3,1,0.16666666666666666,647,107.83333333333333,21,0.7,0.0,0.0,0.15898119510557876,0.0006769610050802409,3,5,8
org.w3c.dom.xpath.XPathResult,3,2,6,0.3333333333333333,1,0.3333333333333333,648,216.0,4,0.6666666666666666,0.0,0.0,0.002366163856847087,0.0,2,2,4
org.apache.xml.utils.PrefixResolverDefault,5,5,20,0.25,1,0.2,647,129.4,15,0.75,0.0,0.0,0.16035846869972042,5.634122924163421e-05,4,4,8
org.apache.xalan.lib.ExsltStrings,5,7,20,0.35,1,0.2,651,130.2,13,0.65,0.0,0.0,0.0,0.0,0,4,4
org.apache.xalan.xsltc.compiler.SourceLoader,2,1,2,0.5,1,0.5,647,323.5,1,0.5,0.0,0.0,0.1888823428863358,4.765590591164443e-06,6,1,7
org.apache.xpath.operations.Lte,5,11,20,0.55,1,0.2,647,129.4,9,0.45,0.0,0.0,0.17534136975799355,1.595948675392572e-05,1,4,5
org.apache.xalan.templates.Constants,2,1,2,0.5,1,0.5,0,0.0,1,0.5,0.0,0.0,0.19152936101500767,7.96163441833158e-05,50,1,51
org.apache.xalan.templates.ElemFallback,7,19,42,0.4523809523809524,1,0.14285714285714285,647,92.42857142857143,23,0.5476190476190477,0.0,0.0,0.15054725739849906,3.1755770298199063e-05,3,6,9
org.apache.xpath.objects.LessThanComparator,3,4,6,0.6666666666666666,1,0.3333333333333333,647,215.66666666666666,2,0.3333333333333333,0.0,0.0,0.1884889290733349,0.0,1,2,3
org.apache.xpath.operations.Number,6,16,30,0.5333333333333333,1,0.16666666666666666,647,107.83333333333333,14,0.4666666666666667,0.0,0.0,0.17537912629756244,1.809445329695892e-05,2,5,7
org.apache.xml.utils.URI,5,9,20,0.45,1,0.2,647,129.4,11,0.55,0.0,0.0,0.1854840953144796,5.271181508124395e-06,2,5,7
org.apache.xalan.xpath.xml.FormatterToXML,1,1,0,0,1,1.0,-1,-1.0,-1,0,0.0,0.0,0.16720573904750055,0.0,4,1,5
org.apache.xpath.operations.Mult,6,16,30,0.5333333333333333,1,0.16666666666666666,647,107.83333333333333,14,0.4666666666666667,0.0,0.0,0.17537912629756244,1.7864579865270404e-05,2,5,7
org.apache.xml.serializer.ToStream,23,59,506,0.116600790513834,1,0.043478260869565216,647,28.130434782608695,447,0.883399209486166,0.0,0.0,0.13774068366749195,0.00551447791827918,3,22,25
org.apache.xalan.res.XSLTErrorResources_it,3,4,6,0.6666666666666666,1,0.3333333333333333,648,216.0,2,0.3333333333333333,0.0,0.0,0.0,0.0,0,2,2
org.apache.xalan.xsltc.compiler.ValueOf,12,50,132,0.3787878787878788,1,0.08333333333333333,647,53.916666666666664,82,0.6212121212121212,0.0,0.0,0.20305675954272748,0.0001693568699604242,1,11,12
org.apache.xalan.xpath.XPathSupport,1,0,0,0,1,1.0,-1,-1.0,0,0,0.0,0.0,0.28662153674366664,0.0,5,0,5
org.apache.xml.utils.Hashtree2Node,2,1,2,0.5,1,0.5,648,324.0,1,0.5,0.0,0.0,0.0013802622498274672,3.218228043639172e-06,1,1,2
org.apache.xalan.processor.ProcessorStylesheetElement,8,23,56,0.4107142857142857,1,0.125,647,80.875,33,0.5892857142857143,0.045634920634920625,0.005704365079365078,0.15578819099576893,0.00012209217259540048,2,7,9
org.apache.xalan.transformer.TransformerIdentityImpl,14,33,182,0.1813186813186813,1,0.07142857142857142,647,46.214285714285715,149,0.8186813186813187,0.0,0.0,0.1565367408275764,0.0009689532163890709,1,13,14
org.apache.xml.utils.DOMHelper,11,24,110,0.21818181818181817,1,0.09090909090909091,647,58.81818181818182,86,0.7818181818181819,0.0,0.0,0.17114113522292076,0.004213533502527549,5,10,15
org.apache.xalan.xsltc.compiler.util.SlotAllocator,3,4,6,0.6666666666666666,1,0.3333333333333333,647,215.66666666666666,2,0.3333333333333333,0.0,0.0,0.21360101298869133,2.2478985077984525e-06,1,2,3
org.apache.xalan.xpath.XBooleanStatic,4,6,12,0.5,1,0.25,648,162.0,6,0.5,0.0,0.0,0.0010351966873706005,1.8951787368097347e-06,1,3,4
org.apache.xpath.domapi.XPathNamespaceImpl,4,3,12,0.25,1,0.25,649,162.25,9,0.75,0.0,0.0,0.0016563146997929609,1.0727426812130574e-06,1,3,4
org.apache.xalan.trace.TraceManager,14,46,182,0.25274725274725274,1,0.07142857142857142,647,46.214285714285715,136,0.7472527472527473,0.30341880341880345,0.021672771672771676,0.18831460405222658,0.005732826218123048,26,13,39
org.apache.xalan.xsltc.compiler.util.Util,4,6,12,0.5,1,0.25,647,161.75,6,0.5,0.0,0.0,0.22054174452366096,0.0002600962766572358,43,3,46
org.apache.xalan.xsltc.compiler.util.AttributeSetMethodGenerator,5,8,20,0.4,1,0.2,647,129.4,12,0.6,0.0,0.0,0.17328950266508084,4.2143462476227256e-07,1,4,5
org.apache.xalan.xsltc.compiler.FilteredAbsoluteLocationPath,11,48,110,0.43636363636363634,1,0.09090909090909091,648,58.90909090909091,62,0.5636363636363636,0.0,0.0,0.0,0.0,0,10,10
org.apache.xpath.functions.FuncCurrent,10,37,90,0.4111111111111111,1,0.1,647,64.7,53,0.5888888888888889,0.0,0.0,0.12739882098011576,2.7940778200685095e-05,1,9,10
org.apache.xml.serializer.OutputPropertyUtils,2,1,2,0.5,1,0.5,647,323.5,1,0.5,0.0,0.0,0.15864056535369692,0.0,3,1,4
org.apache.xalan.processor.XSLTElementProcessor,12,40,132,0.30303030303030304,1,0.08333333333333333,647,53.916666666666664,92,0.696969696969697,0.08636363636363636,0.007196969696969697,0.1419415584743604,0.0011195894200118624,13,11,24
org.apache.xalan.templates.ElemPI,14,58,182,0.31868131868131866,1,0.07142857142857142,647,46.214285714285715,124,0.6813186813186813,0.0,0.0,0.14990993236257683,3.4713936732870245e-05,2,13,15
org.apache.xml.dtm.ref.DTMDefaultBaseTraversers,30,82,870,0.09425287356321839,1,0.03333333333333333,647,21.566666666666666,788,0.9057471264367816,0.0,0.0,0.15263505669525487,0.01995773796445492,3,29,32
org.apache.xalan.xsltc.compiler.Import,15,80,210,0.38095238095238093,1,0.06666666666666667,648,43.2,130,0.6190476190476191,0.0,0.0,0.0,0.0,0,14,14
org.apache.xml.utils.NodeVector,1,1,0,0,1,1.0,-1,-1.0,-1,0,0.0,0.0,0.24909921777417232,0.0,9,1,10
org.apache.xml.dtm.DTMWSFilter,2,1,2,0.5,1,0.5,647,323.5,1,0.5,0.0,0.0,0.27524861862990196,1.0428039856769155e-05,19,1,20
org.w3c.dom.xpath.XPathException,2,1,2,0.5,1,0.5,648,324.0,1,0.5,0.0,0.0,0.0033126293995859217,2.7169136533990833e-07,3,1,4
org.apache.xalan.processor.ProcessorStripSpace,8,22,56,0.39285714285714285,1,0.125,647,80.875,34,0.6071428571428571,0.0,0.0,0.14985476771405334,0.000504570785089966,1,7,8
org.apache.xalan.xsltc.compiler.XSLTC,12,54,132,0.4090909090909091,1,0.08333333333333333,647,53.916666666666664,78,0.5909090909090909,0.019696969696969695,0.0016414141414141414,0.22542503806417935,0.0035936754004468855,19,11,30
org.apache.xalan.xslt.XSLTResultTarget,5,9,20,0.45,1,0.2,647,129.4,11,0.55,0.0,0.0,0.16648827933889615,5.852818306694995e-07,2,4,6
org.apache.xml.utils.synthetic.reflection.Constructor,4,7,12,0.5833333333333334,1,0.25,647,161.75,5,0.4166666666666667,0.3333333333333333,0.08333333333333333,0.16450427439423954,0.0007572917023343494,3,3,6
org.apache.xalan.xsltc.trax.DOM2SAX,4,5,12,0.4166666666666667,1,0.25,647,161.75,7,0.5833333333333334,0.0,0.0,0.13877332808415063,0.00021613969819158046,2,3,5
org.apache.xml.dtm.SecuritySupport,2,2,2,1.0,1,0.5,647,323.5,0,0.0,0.0,0.0,0.17429074738409586,0.0,3,2,5
org.apache.xalan.xsltc.dom.SingletonIterator,3,4,6,0.6666666666666666,1,0.3333333333333333,648,216.0,2,0.3333333333333333,0.0,0.0,0.002070393374741201,1.0727426812130574e-06,2,2,4
org.apache.xpath.objects.XNumber,9,24,72,0.3333333333333333,1,0.1111111111111111,647,71.88888888888889,48,0.6666666666666666,0.2857142857142857,0.031746031746031744,0.2900500934921225,0.014182027985973896,33,8,41
org.apache.xpath.axes.RTFIterator,3,5,6,0.8333333333333334,1,0.3333333333333333,647,215.66666666666666,1,0.16666666666666666,0.0,0.0,0.14854288939009302,9.130232153435577e-06,2,2,4
org.apache.xalan.transformer.XalanTransformState,10,31,90,0.34444444444444444,1,0.1,647,64.7,59,0.6555555555555556,0.14583333333333331,0.014583333333333332,0.1587333195334009,0.0005535228742876044,1,9,10
org.apache.xalan.processor.StopParseException,1,0,0,0,1,1.0,-1,-1.0,0,0,0.0,0.0,0.15695022815727028,0.0,2,0,2
org.apache.xml.utils.res.XResources_he,2,2,2,1.0,1,0.5,648,324.0,0,0.0,0.0,0.0,0.0,0.0,0,1,1
org.apache.xalan.processor.StylesheetPIHandler,4,4,12,0.3333333333333333,1,0.25,647,161.75,8,0.6666666666666666,0.0,0.0,0.15662705048574613,0.0,1,3,4
org.apache.xalan.xsltc.compiler.CastExpr,18,83,306,0.27124183006535946,1,0.05555555555555555,647,35.94444444444444,223,0.7287581699346405,0.0,0.0,0.19913463631439607,0.010172040231357277,33,17,50
org.apache.xml.res.XMLErrorResources,2,2,2,1.0,1,0.5,647,323.5,0,0.0,0.0,0.0,0.24583780939507394,0.009155931164024675,43,2,45
org.apache.xml.utils.res.XResources_ja_JP_I,2,2,2,1.0,1,0.5,648,324.0,0,0.0,0.0,0.0,0.0,0.0,0,1,1
org.apache.xpath.functions.FuncContains,6,12,30,0.4,1,0.16666666666666666,648,108.0,18,0.6,0.0,0.0,0.0,0.0,0,5,5
org.apache.xalan.xsltc.compiler.util.MethodType,3,4,6,0.6666666666666666,1,0.3333333333333333,647,215.66666666666666,2,0.3333333333333333,0.0,0.0,0.2545985190765489,1.0399068215481557e-06,8,2,10
org.apache.xml.utils.FastStringBuffer,3,4,6,0.6666666666666666,1,0.3333333333333333,647,215.66666666666666,2,0.3333333333333333,0.0,0.0,0.3120538936880766,0.0006039174509731061,24,3,27
org.apache.xalan.xsltc.dom.SimpleResultTreeImpl,21,55,420,0.13095238095238096,1,0.047619047619047616,647,30.80952380952381,365,0.8690476190476191,0.09473684210526316,0.004511278195488722,0.13886797315019267,0.004308135493502418,5,20,25
org.apache.xml.serializer.ToSAXHandler,4,4,12,0.3333333333333333,1,0.25,647,161.75,8,0.6666666666666666,0.0,0.0,0.1631205012068656,0.0005495064787698265,4,3,7
org.apache.xalan.transformer.QueuedEvents,3,2,6,0.3333333333333333,1,0.3333333333333333,649,216.33333333333334,4,0.6666666666666666,0.0,0.0,0.0,0.0,0,2,2
org.apache.xalan.xpath.XNodeSet,10,27,90,0.3,1,0.1,647,64.7,63,0.7,0.039351851851851846,0.003935185185185185,0.20499890826224013,0.003985735301340223,7,9,16
org.apache.xpath.functions.FuncSum,8,20,56,0.35714285714285715,1,0.125,648,81.0,36,0.6428571428571429,0.0,0.0,0.0,0.0,0,7,7
org.apache.xalan.xpath.xml.ProblemListenerDefault,5,6,20,0.3,1,0.2,647,129.4,14,0.7,0.0,0.0,0.1594480545273845,0.0,1,4,5
org.apache.xalan.xsltc.dom.NthIterator,2,2,2,1.0,1,0.5,0,0.0,0,0.0,0.0,0.0,0.0,0.0,0,1,1
org.apache.xalan.templates.StylesheetComposed,4,10,12,0.8333333333333334,1,0.25,647,161.75,2,0.16666666666666666,0.08333333333333333,0.020833333333333332,0.18870728974186282,4.205171850716213e-05,10,4,14
org.apache.xpath.domapi.XPathNSResolverImpl,5,7,20,0.35,1,0.2,649,129.8,13,0.65,0.0,0.0,0.0013802622498274672,4.29097072485223e-06,1,4,5
org.apache.xalan.xsltc.compiler.ForwardPositionExpr,9,31,72,0.4305555555555556,1,0.1111111111111111,647,71.88888888888889,41,0.5694444444444444,0.0,0.0,0.1665563727046789,1.0239714646191542e-05,2,8,10
org.apache.xpath.functions.FuncTranslate,6,13,30,0.43333333333333335,1,0.16666666666666666,648,108.0,17,0.5666666666666667,0.0,0.0,0.0,0.0,0,5,5
org.apache.xalan.xsltc.compiler.util.NumberType,2,2,2,1.0,1,0.5,647,323.5,0,0.0,0.0,0.0,0.17545468817877638,0.0,4,1,5
org.apache.xalan.processor.ProcessorCharacters,7,11,42,0.2619047619047619,1,0.14285714285714285,647,92.42857142857143,31,0.7380952380952381,0.0,0.0,0.14990993236257683,9.136147460950576e-05,2,6,8
org.apache.xalan.extensions.ExtensionNamespacesManager,6,9,30,0.3,1,0.16666666666666666,647,107.83333333333333,21,0.7,0.0,0.0,0.178648971819671,0.0015861707317253893,5,5,10
org.apache.xalan.extensions.ExtensionNamespaceSupport,3,3,6,0.5,1,0.3333333333333333,647,215.66666666666666,3,0.5,0.0,0.0,0.15121809553024135,6.043117104166891e-06,4,2,6
org.apache.xalan.processor.ProcessorExsltFuncResult,8,17,56,0.30357142857142855,1,0.125,647,80.875,39,0.6964285714285714,0.0,0.0,0.14985476771405334,2.6431284034604564e-05,1,7,8
org.apache.xalan.processor.ProcessorTemplateElem,6,16,30,0.5333333333333333,1,0.16666666666666666,647,107.83333333333333,14,0.4666666666666667,0.0,0.0,0.15029722504629636,0.00010395754637457722,9,5,14
org.apache.xalan.lib.sql.DefaultConnectionPool,6,9,30,0.3,1,0.16666666666666666,650,108.33333333333333,21,0.7,0.0,0.0,0.002070393374741201,5.184922959196444e-06,2,5,7
org.apache.xalan.templates.ElemExsltFuncResult,9,32,72,0.4444444444444444,1,0.1111111111111111,647,71.88888888888889,40,0.5555555555555556,0.0,0.0,0.15004802183601326,0.00012588100557650833,4,8,12
org.apache.xml.utils.WrappedRuntimeException,2,1,2,0.5,1,0.5,647,323.5,1,0.5,0.0,0.0,0.32371250497848963,0.003063913618159251,40,1,41
org.apache.xalan.templates.ElemParam,14,70,182,0.38461538461538464,1,0.07142857142857142,647,46.214285714285715,112,0.6153846153846154,0.0,0.0,0.18489458854162996,0.0005915643387603514,9,14,23
org.apache.xpath.patterns.FunctionPattern,10,33,90,0.36666666666666664,1,0.1,647,64.7,57,0.6333333333333333,0.09722222222222221,0.00972222222222222,0.17587144515782335,0.0012284497233095472,3,9,12
org.apache.xml.utils.Constants,1,0,0,0,1,1.0,-1,-1.0,0,0,0.0,0.0,0.1825792638159831,0.0,16,0,16
org.apache.xml.dtm.ref.DTMDefaultBaseIterators,33,80,1056,0.07575757575757576,1,0.030303030303030304,647,19.606060606060606,976,0.9242424242424242,0.0,0.0,0.17806310942848272,0.039099431354989174,3,32,35
org.apache.xalan.xsltc.compiler.StringLengthCall,6,13,30,0.43333333333333335,1,0.16666666666666666,648,108.0,17,0.5666666666666667,0.0,0.0,0.0,0.0,0,5,5
org.apache.xalan.xsltc.runtime.AttributeList,3,3,6,0.5,1,0.3333333333333333,647,215.66666666666666,3,0.5,0.0,0.0,0.22228729872431222,0.00011971364498194116,3,2,5
org.apache.xalan.processor.XSLTAttributeDef,16,49,240,0.20416666666666666,1,0.0625,647,40.4375,191,0.7958333333333333,0.0,0.0,0.15032496539791065,0.0012691183121775508,4,15,19
org.apache.xalan.xsltc.compiler.LiteralExpr,8,22,56,0.39285714285714285,1,0.125,647,80.875,34,0.6071428571428571,0.0,0.0,0.1620494752339594,4.259956914041215e-05,6,7,13
org.apache.xalan.xsltc.compiler.Text,8,25,56,0.44642857142857145,1,0.125,647,80.875,31,0.5535714285714286,0.08333333333333333,0.010416666666666666,0.23870476627370454,0.007037144437131564,10,7,17
org.apache.xml.utils.BoolStack,1,0,0,0,1,1.0,-1,-1.0,0,0,0.0,0.0,0.18401671249908988,0.0,9,0,9
org.apache.xml.utils.PrefixForUriEnumerator,2,2,2,1.0,1,0.5,647,323.5,0,0.0,0.0,0.0,0.12288181389949908,0.0,1,1,2
org.apache.xpath.functions.FuncDoclocation,7,18,42,0.42857142857142855,1,0.14285714285714285,649,92.71428571428571,24,0.5714285714285714,0.0,0.0,0.0,0.0,0,6,6
org.apache.xalan.processor.ProcessorImport,5,11,20,0.55,1,0.2,647,129.4,9,0.45,0.0,0.0,0.14985476771405334,2.5418046346574035e-06,1,4,5
org.apache.xalan.xsltc.dom.BitArray,2,3,2,1.5,1,0.5,0,0.0,-1,-0.5,0.0,0.0,0.13901535024624706,0.0,3,2,5
org.apache.xalan.templates.ElemMessage,10,34,90,0.37777777777777777,1,0.1,647,64.7,56,0.6222222222222222,0.0,0.0,0.14988234496243652,1.5315129388417415e-05,1,9,10
org.apache.xalan.xsltc.compiler.RoundCall,5,7,20,0.35,1,0.2,648,129.6,13,0.65,0.0,0.0,0.0,0.0,0,4,4
org.apache.xalan.transformer.ResultNameSpace,2,1,2,0.5,1,0.5,648,324.0,1,0.5,0.0,0.0,0.0,0.0,0,1,1
org.apache.xpath.operations.Gte,5,11,20,0.55,1,0.2,647,129.4,9,0.45,0.0,0.0,0.17534136975799355,1.595948675392572e-05,1,4,5
org.apache.xalan.xsltc.trax.XSLTCSource,10,29,90,0.32222222222222224,1,0.1,647,64.7,61,0.6777777777777778,0.0,0.0,0.15851706160488127,0.0006395309869276239,1,9,10
org.apache.xalan.templates.XUnresolvedVariable,11,48,110,0.43636363636363634,1,0.09090909090909091,647,58.81818181818182,62,0.5636363636363636,0.0022222222222222222,0.00020202020202020202,0.1587333195334009,1.7690766338786743e-06,1,10,11
org.apache.xml.serializer.CharInfo,7,12,42,0.2857142857142857,1,0.14285714285714285,647,92.42857142857143,30,0.7142857142857143,0.0,0.0,0.1379039387954419,0.0009734782251114759,5,7,12
org.apache.xml.dtm.ref.DTMNodeListBase,2,1,2,0.5,1,0.5,0,0.0,1,0.5,0.0,0.0,0.22593361102849785,0.0,3,1,4
org.apache.xalan.transformer.Counter,4,7,12,0.5833333333333334,1,0.25,647,161.75,5,0.4166666666666667,0.0,0.0,0.13556269349631822,0.0,1,3,4
org.apache.xalan.xsltc.compiler.NotCall,6,10,30,0.3333333333333333,1,0.16666666666666666,648,108.0,20,0.6666666666666666,0.0,0.0,0.0010351966873706005,9.118312790310988e-06,1,5,6
org.apache.xalan.templates.ElemUse,9,34,72,0.4722222222222222,1,0.1111111111111111,647,71.88888888888889,38,0.5277777777777778,0.008928571428571428,0.000992063492063492,0.15665717686591268,5.317931002741035e-05,4,8,12
org.apache.xpath.functions.Function3Args,8,15,56,0.26785714285714285,1,0.125,647,80.875,41,0.7321428571428571,0.11904761904761904,0.01488095238095238,0.1234031306857394,0.0012947307329272538,5,7,12
org.apache.xpath.objects.XObjectFactory,15,49,210,0.23333333333333334,1,0.06666666666666667,647,43.13333333333333,161,0.7666666666666667,0.1973443223443224,0.01315628815628816,0.28861114901696666,0.008354372534563097,1,14,15
org.apache.xalan.templates.TemplateList,20,90,380,0.23684210526315788,1,0.05,647,32.35,290,0.7631578947368421,0.12548732943469784,0.0062743664717348924,0.1781020473487601,0.002376947659944766,3,19,22
org.apache.xml.dtm.DTMConfigurationException,3,3,6,0.5,1,0.3333333333333333,647,215.66666666666666,3,0.5,0.0,0.0,0.21455760340513172,0.0005771668724468677,1,2,3
org.apache.xpath.functions.FuncLast,9,28,72,0.3888888888888889,1,0.1111111111111111,647,71.88888888888889,44,0.6111111111111112,0.0,0.0,0.15393321915061045,1.2804280793527925e-05,1,8,9
org.apache.xalan.transformer.KeyTable,18,62,306,0.20261437908496732,1,0.05555555555555555,647,35.94444444444444,244,0.7973856209150327,0.0,0.0,0.13547249875679973,0.000993614715417358,1,17,18
org.apache.xml.serializer.WriterToASCI,2,1,2,0.5,1,0.5,647,323.5,1,0.5,0.0,0.0,0.11991470296317433,0.0,1,1,2
org.apache.xalan.xsltc.trax.TemplatesImpl,6,10,30,0.3333333333333333,1,0.16666666666666666,647,107.83333333333333,20,0.6666666666666666,0.0,0.0,0.14246294604265874,0.001004951318999654,2,5,7
org.apache.xalan.xsltc.compiler.Key,19,93,342,0.2719298245614035,1,0.05263157894736842,647,34.05263157894737,249,0.7280701754385965,0.0,0.0,0.17931762715232938,0.0001935081933786112,1,18,19
org.apache.xalan.xsltc.runtime.AbstractTranslet,20,66,380,0.1736842105263158,1,0.05,647,32.35,314,0.8263157894736842,0.0,0.0,0.16048485961101083,0.00766126989155564,10,19,29
org.apache.xpath.functions.FuncGenerateId,6,16,30,0.5333333333333333,1,0.16666666666666666,649,108.16666666666667,14,0.4666666666666667,0.0,0.0,0.0,0.0,0,5,5
org.apache.xml.dtm.DTMManager,13,27,156,0.17307692307692307,1,0.07692307692307693,647,49.76923076923077,129,0.8269230769230769,0.07196969696969698,0.005536130536130537,0.279595146764806,0.006947071538544135,35,13,48
org.apache.xalan.xsltc.ProcessorVersion,2,1,2,0.5,1,0.5,648,324.0,1,0.5,0.0,0.0,0.0,0.0,0,1,1
org.apache.xpath.objects.XBooleanStatic,4,7,12,0.5833333333333334,1,0.25,647,161.75,5,0.4166666666666667,0.0,0.0,0.18204306270135895,4.040664099235849e-06,3,3,6
org.apache.xalan.transformer.TransformerClient,2,1,2,0.5,1,0.5,647,323.5,1,0.5,0.0,0.0,0.15879521593407683,0.0004746886364367779,1,1,2
org.apache.xpath.functions.FuncStartsWith,7,15,42,0.35714285714285715,1,0.14285714285714285,648,92.57142857142857,27,0.6428571428571429,0.0,0.0,0.0,0.0,0,6,6
org.apache.xalan.lib.sql.DTMDocument,15,32,210,0.1523809523809524,1,0.06666666666666667,651,43.4,178,0.8476190476190476,0.0,0.0,0.002329192546583851,0.0005522440999933695,2,14,16
org.apache.xpath.operations.String,5,14,20,0.7,1,0.2,647,129.4,6,0.3,0.5,0.1,0.615151557799003,0.2666441986572917,462,4,466
org.apache.xalan.xsltc.compiler.Predicate,39,291,1482,0.19635627530364372,1,0.02564102564102564,647,16.58974358974359,1191,0.8036437246963563,0.12461559303664567,0.003195271616324248,0.14556937668022876,0.009824285134519488,4,38,42
org.apache.xml.dtm.DTMIterator,3,6,6,1.0,1,0.3333333333333333,647,215.66666666666666,0,0.0,0.0,0.0,0.32371250497848963,0.0021797284641318746,50,3,53
org.apache.xml.utils.StringBufferPool,3,3,6,0.5,1,0.3333333333333333,647,215.66666666666666,3,0.5,0.0,0.0,0.15338242232125798,0.0005204095027482817,5,2,7
org.apache.xalan.templates.AVTPartSimple,7,15,42,0.35714285714285715,1,0.14285714285714285,647,92.42857142857143,27,0.6428571428571429,0.0,0.0,0.1364255716123752,0.0,1,6,7
org.apache.xalan.xsltc.trax.TransformerFactoryImpl,15,49,210,0.23333333333333334,1,0.06666666666666667,647,43.13333333333333,161,0.7666666666666667,0.21840659340659344,0.014560439560439562,0.16852072471050694,0.008769842631442114,4,14,18
org.apache.xml.utils.SuballocatedIntVector,1,0,0,0,1,1.0,-1,-1.0,0,0,0.0,0.0,0.2154389381488421,0.0,15,0,15
org.w3c.dom.xpath.XPathExpression,2,1,2,0.5,1,0.5,0,0.0,1,0.5,0.0,0.0,0.0033126293995859217,0.0,3,1,4
org.apache.xml.utils.NSInfo,2,1,2,0.5,1,0.5,647,323.5,1,0.5,0.0,0.0,0.144433527669069,0.0,1,1,2
org.apache.xalan.xsltc.compiler.FunctionCall,25,129,600,0.215,1,0.04,647,25.88,471,0.785,0.0,0.0,0.16996257565231218,0.0030047024316378524,25,24,49
org.apache.xalan.xsltc.compiler.ElementAvailableCall,11,37,110,0.33636363636363636,1,0.09090909090909091,648,58.90909090909091,73,0.6636363636363637,0.0,0.0,0.0,0.0,0,10,10
org.apache.xpath.ExpressionNode,1,1,0,0,1,1.0,-1,-1.0,-1,0,0.0,0.0,0.2411515913282017,0.0,8,1,9
org.apache.xpath.axes.LocPathIterator,22,100,462,0.21645021645021645,1,0.045454545454545456,647,29.40909090909091,362,0.7835497835497836,0.1898809523809524,0.008630952380952382,0.2471807777013293,0.011945050893601886,21,21,42
org.apache.xml.utils.SerializableLocatorImpl,2,1,2,0.5,1,0.5,648,324.0,1,0.5,0.0,0.0,0.0,0.0,0,1,1
org.apache.xpath.objects.EqualComparator,3,4,6,0.6666666666666666,1,0.3333333333333333,647,215.66666666666666,2,0.3333333333333333,0.0,0.0,0.1884889290733349,0.0,1,2,3
org.apache.xalan.xsltc.runtime.output.WriterOutputBuffer,3,4,6,0.6666666666666666,1,0.3333333333333333,649,216.33333333333334,2,0.3333333333333333,0.0,0.0,0.0,0.0,0,2,2
org.apache.xml.dtm.ref.DTMAxisIterNodeList,6,9,30,0.3,1,0.16666666666666666,647,107.83333333333333,21,0.7,0.0,0.0,0.13870242890427112,6.022774109215715e-05,1,5,6
org.apache.xml.serializer.EmptySerializer,8,12,56,0.21428571428571427,1,0.125,647,80.875,44,0.7857142857142857,0.0,0.0,0.121037399691764,5.287727466146031e-05,2,7,9
org.apache.xml.dtm.ref.DTMAxisIteratorBase,3,3,6,0.5,1,0.3333333333333333,647,215.66666666666666,3,0.5,0.0,0.0,0.1392478479271465,0.0007013234068877233,6,2,8
org.apache.xml.dtm.ref.CustomStringPool,3,3,6,0.5,1,0.3333333333333333,648,216.0,3,0.5,0.0,0.0,0.0,0.0,0,2,2
org.apache.xpath.SourceTreeManager,7,14,42,0.3333333333333333,1,0.14285714285714285,647,92.42857142857143,28,0.6666666666666666,0.06666666666666667,0.009523809523809523,0.2474812101263689,0.002444693933075542,4,6,10
org.apache.xalan.xsltc.compiler.IllegalCharException,2,1,2,0.5,1,0.5,648,324.0,1,0.5,0.0,0.0,0.0,0.0,0,1,1
org.apache.xml.dtm.ref.DTMNodeProxy,12,24,132,0.18181818181818182,1,0.08333333333333333,647,53.916666666666664,108,0.8181818181818182,0.0,0.0,0.17266496979560736,0.022754406968545877,7,11,18
org.apache.xalan.xsltc.compiler.Stylesheet,28,241,756,0.3187830687830688,1,0.03571428571428571,647,23.107142857142858,515,0.6812169312169312,0.27216178882845554,0.009720063886730555,0.22271278712766746,0.01640974755021192,24,27,51
org.apache.xpath.operations.Mod,6,16,30,0.5333333333333333,1,0.16666666666666666,647,107.83333333333333,14,0.4666666666666667,0.0,0.0,0.17537912629756244,1.7864579865270404e-05,2,5,7
org.apache.xml.serializer.AttributesImplSerializer,3,3,6,0.5,1,0.3333333333333333,647,215.66666666666666,3,0.5,0.0,0.0,0.14044846741263664,3.68218925326382e-05,5,2,7
org.apache.xpath.objects.XNodeSetForDOM,7,15,42,0.35714285714285715,1,0.14285714285714285,647,92.42857142857143,27,0.6428571428571429,0.0,0.0,0.2197681226459471,0.0005755599220078006,1,6,7
org.apache.xalan.xsltc.compiler.util.VoidType,9,39,72,0.5416666666666666,1,0.1111111111111111,647,71.88888888888889,33,0.4583333333333333,0.0,0.0,0.21270845195243668,0.0,1,8,9
org.apache.xpath.functions.FuncNumber,6,15,30,0.5,1,0.16666666666666666,649,108.16666666666667,15,0.5,0.0,0.0,0.0,0.0,0,5,5
org.apache.xpath.patterns.UnionPattern,11,49,110,0.44545454545454544,1,0.09090909090909091,647,58.81818181818182,61,0.5545454545454546,0.09944444444444445,0.009040404040404041,0.23237108773919543,0.0011842446321257312,4,10,14
org.apache.xalan.xsltc.compiler.FilterExpr,13,69,156,0.4423076923076923,1,0.07692307692307693,647,49.76923076923077,87,0.5576923076923077,0.001893939393939394,0.0001456876456876457,0.1256689804854004,1.532489544590082e-07,1,12,13
org.apache.xpath.operations.Operation,9,29,72,0.4027777777777778,1,0.1111111111111111,647,71.88888888888889,43,0.5972222222222222,0.14880952380952378,0.01653439153439153,0.23296929706117847,0.003326861675407929,17,8,25
org.apache.xalan.xsltc.runtime.BasisLibrary,18,57,306,0.18627450980392157,1,0.05555555555555555,654,36.333333333333336,249,0.8137254901960784,0.0,0.0,0.0,0.0,0,17,17
org.apache.xpath.objects.XString,13,49,156,0.3141025641025641,1,0.07692307692307693,647,49.76923076923077,107,0.6858974358974359,0.3693181818181818,0.028409090909090908,0.38673345798949665,0.06617342724292356,35,12,47
org.apache.xalan.xsltc.StripFilter,2,3,2,1.5,1,0.5,647,323.5,-1,-0.5,0.0,0.0,0.19503368355504788,2.145485362426115e-07,9,1,10
org.apache.xalan.serialize.Serializer,2,1,2,0.5,1,0.5,0,0.0,1,0.5,0.0,0.0,0.13829237342113257,1.430323574950743e-06,4,1,5
org.apache.xalan.xsltc.trax.TrAXFilter,4,6,12,0.5,1,0.25,647,161.75,6,0.5,0.0,0.0,0.14251280184179876,0.0002757879759402357,2,3,5
org.apache.xml.utils.QName,8,14,56,0.25,1,0.125,647,80.875,42,0.75,0.0,0.0,0.23614400189210782,0.002246608811372795,47,7,54
org.apache.xml.serializer.SerializerFactory,8,8,56,0.14285714285714285,1,0.125,647,80.875,48,0.8571428571428571,0.0,0.0,0.1619528062290475,0.0021493689109823555,10,7,17
org.apache.xalan.xsltc.runtime.StringValueHandler,3,3,6,0.5,1,0.3333333333333333,647,215.66666666666666,3,0.5,0.0,0.0,0.13676921285069352,0.00047665916257619653,1,2,3
org.apache.xpath.axes.FilterExprIteratorSimple,14,37,182,0.2032967032967033,1,0.07142857142857142,647,46.214285714285715,145,0.7967032967032966,0.07051282051282051,0.005036630036630037,0.16390836436423425,0.0016767595282377147,4,13,17
org.apache.xml.serializer.Serializer,2,1,2,0.5,1,0.5,0,0.0,1,0.5,0.0,0.0,0.16343141852964846,0.00046312006368266556,13,1,14
org.apache.xpath.objects.XStringForFSB,13,49,156,0.3141025641025641,1,0.07692307692307693,647,49.76923076923077,107,0.6858974358974359,0.03156565656565657,0.0024281274281274285,0.2246168401891561,4.190015675862803e-05,1,12,13
org.apache.xml.utils.synthetic.JavaUtils,2,1,2,0.5,1,0.5,648,324.0,1,0.5,0.0,0.0,0.0,0.0,0,1,1
org.apache.xalan.Version,3,3,6,0.5,1,0.3333333333333333,649,216.33333333333334,3,0.5,0.0,0.0,0.0,0.0,0,2,2
org.apache.xpath.objects.XMLStringFactoryImpl,8,28,56,0.5,1,0.125,647,80.875,28,0.5,0.3214285714285714,0.040178571428571425,0.2972484169802482,0.0019498292213799317,4,7,11
org.apache.xpath.operations.VariableSafeAbsRef,9,27,72,0.375,1,0.1111111111111111,647,71.88888888888889,45,0.625,0.0,0.0,0.14778818046196335,1.7941556738374935e-05,1,8,9
org.apache.xalan.templates.ElemAttributeSet,14,64,182,0.3516483516483517,1,0.07142857142857142,647,46.214285714285715,118,0.6483516483516484,0.08638583638583637,0.006170416884702598,0.1877502679866021,0.0020908886915544335,5,13,18
org.apache.xpath.objects.GreaterThanComparator,3,4,6,0.6666666666666666,1,0.3333333333333333,647,215.66666666666666,2,0.3333333333333333,0.0,0.0,0.1884889290733349,0.0,1,2,3
org.apache.xml.utils.PrefixResolver,2,1,2,0.5,1,0.5,647,323.5,1,0.5,0.0,0.0,0.2762756657143419,4.225682296014378e-06,36,1,37
org.apache.xalan.transformer.CountersTable,6,16,30,0.5333333333333333,1,0.16666666666666666,647,107.83333333333333,14,0.4666666666666667,0.05,0.008333333333333333,0.15898119510557876,0.0016261635691631107,3,5,8
org.apache.xalan.xsltc.compiler.CallTemplate,13,64,156,0.41025641025641024,1,0.07692307692307693,647,49.76923076923077,92,0.5897435897435898,0.0,0.0,0.20305675954272748,4.332747697911801e-06,1,12,13
org.apache.xalan.xsltc.NodeIterator,1,1,0,0,1,1.0,-1,-1.0,-1,0,0.0,0.0,0.29495658131879593,0.0,13,1,14
org.apache.xalan.xsltc.compiler.NameBase,8,18,56,0.32142857142857145,1,0.125,648,81.0,38,0.6785714285714286,0.0,0.0,0.003105590062111801,0.00012390944212783107,3,7,10
org.apache.xalan.xsltc.compiler.util.BooleanType,11,66,110,0.6,1,0.09090909090909091,647,58.81818181818182,44,0.4,0.0,0.0,0.2549970765578835,0.0008452753012505967,17,10,27
org.apache.xalan.xsltc.compiler.Constants,1,0,0,0,1,1.0,-1,-1.0,0,0,0.0,0.0,0.23007275553719356,0.0,11,0,11
org.apache.xalan.xsltc.runtime.output.TransletOutputHandlerFactory,14,31,182,0.17032967032967034,1,0.07142857142857142,647,46.214285714285715,151,0.8296703296703297,0.0,0.0,0.16035846869972042,0.009242319389383935,4,14,18
org.apache.xml.utils.synthetic.TestDriver,7,20,42,0.47619047619047616,1,0.14285714285714285,649,92.71428571428571,22,0.5238095238095238,0.16666666666666666,0.023809523809523808,0.0010351966873706005,0.0006962100001072744,1,6,7
org.apache.xalan.templates.ElemExtensionCall,20,94,380,0.24736842105263157,1,0.05,647,32.35,286,0.7526315789473684,0.12451267056530214,0.006225633528265107,0.15683817880336606,0.001179781596035832,7,19,26
org.apache.xml.utils.res.XResources_zh_TW,2,2,2,1.0,1,0.5,648,324.0,0,0.0,0.0,0.0,0.0,0.0,0,1,1
org.apache.xalan.xsltc.compiler.ProcessingInstruction,11,43,110,0.39090909090909093,1,0.09090909090909091,647,58.81818181818182,67,0.6090909090909091,0.0,0.0,0.16925616428218618,0.008974139763149444,3,10,13
org.apache.xml.utils.StringToIntTable,2,1,2,0.5,1,0.5,647,323.5,1,0.5,0.0,0.0,0.13083705422102487,0.0,2,1,3
org.apache.xpath.operations.Equals,6,15,30,0.5,1,0.16666666666666666,647,107.83333333333333,15,0.5,0.0,0.0,0.17530362947177788,2.5512037310527805e-05,1,5,6
org.apache.xalan.xsltc.compiler.LastCall,7,11,42,0.2619047619047619,1,0.14285714285714285,647,92.42857142857143,31,0.7380952380952381,0.0,0.0,0.1257271785313183,1.32882129712175e-05,1,6,7
org.apache.xml.dtm.ref.CoroutineManager,3,3,6,0.5,1,0.3333333333333333,647,215.66666666666666,3,0.5,0.0,0.0,0.15830139213331001,0.0006951372574260614,3,2,5
org.apache.xpath.functions.FuncStringLength,7,19,42,0.4523809523809524,1,0.14285714285714285,649,92.71428571428571,23,0.5476190476190477,0.0,0.0,0.0,0.0,0,6,6
org.apache.xalan.xsltc.dom.NodeSortRecord,8,22,56,0.39285714285714285,1,0.125,651,81.375,34,0.6071428571428571,0.047619047619047616,0.005952380952380952,0.002070393374741201,0.000345959514691211,3,8,11
org.apache.xalan.xsltc.runtime.HashtableEntry,1,0,0,0,1,1.0,-1,-1.0,0,0,0.0,0.0,0.18649137933882384,0.0,2,0,2
org.apache.xml.utils.IntVector,1,1,0,0,1,1.0,-1,-1.0,-1,0,0.0,0.0,0.2565499156975291,0.0,7,1,8
org.apache.xalan.lib.ExsltMath,4,5,12,0.4166666666666667,1,0.25,651,162.75,7,0.5833333333333334,0.0,0.0,0.0,0.0,0,3,3
org.apache.xalan.xsltc.compiler.util.ErrorMessages,2,1,2,0.5,1,0.5,648,324.0,1,0.5,0.0,0.0,0.0010351966873706005,0.0,1,1,2
org.apache.xalan.xsltc.compiler.KeyCall,13,48,156,0.3076923076923077,1,0.07692307692307693,647,49.76923076923077,108,0.6923076923076923,0.0,0.0,0.1257077731943016,2.0827384294059542e-05,1,12,13
org.apache.xpath.objects.XObject,20,80,380,0.21052631578947367,1,0.05,647,32.35,300,0.7894736842105263,0.5716374269005847,0.028581871345029236,0.42069249097411154,0.10833568438956251,127,19,146
org.apache.xml.utils.SystemIDResolver,4,7,12,0.5833333333333334,1,0.25,647,161.75,5,0.4166666666666667,0.0,0.0,0.23210620191675121,0.0019354879286036482,13,3,16
org.apache.xml.dtm.ref.DTMStringPool,3,3,6,0.5,1,0.3333333333333333,647,215.66666666666666,3,0.5,0.0,0.0,0.17915984657410472,1.1299556242110869e-05,5,2,7
org.apache.xpath.functions.FuncNot,6,12,30,0.4,1,0.16666666666666666,648,108.0,18,0.6,0.0,0.0,0.0,0.0,0,5,5
org.apache.xalan.templates.XMLNSDecl,2,1,2,0.5,1,0.5,647,323.5,1,0.5,0.0,0.0,0.17908106036189095,2.1049498764963365e-07,2,1,3
org.apache.xpath.functions.FuncSystemProperty,11,40,110,0.36363636363636365,1,0.09090909090909091,648,58.90909090909091,70,0.6363636363636364,0.0,0.0,0.0,0.0,0,10,10
org.apache.xalan.xsltc.cmdline.Compile,6,11,30,0.36666666666666664,1,0.16666666666666666,654,109.0,19,0.6333333333333333,0.0,0.0,0.0,0.0,0,5,5
org.apache.xalan.transformer.XSLInfiniteLoopException,2,1,2,0.5,1,0.5,648,324.0,1,0.5,0.0,0.0,0.0,0.0,0,1,1
org.apache.xml.utils.CharKey,1,0,0,0,1,1.0,-1,-1.0,0,0,0.0,0.0,0.12014985820517556,0.0,1,0,1
org.apache.xalan.xsltc.compiler.util.Type,20,158,380,0.41578947368421054,1,0.05,647,32.35,222,0.5842105263157895,0.2866471734892787,0.014332358674463936,0.2767450433319334,0.013438437151079187,113,20,133
org.apache.xml.utils.DOMBuilder,6,9,30,0.3,1,0.16666666666666666,647,107.83333333333333,21,0.7,0.0,0.0,0.15895016833057765,4.625970231945652e-05,2,5,7
org.apache.xalan.xsltc.compiler.util.TestGenerator,5,13,20,0.65,1,0.2,647,129.4,7,0.35,0.0,0.0,0.1259020965413325,3.503602447533214e-05,3,4,7
org.apache.xml.utils.WrongParserException,2,1,2,0.5,1,0.5,648,324.0,1,0.5,0.0,0.0,0.0,0.0,0,1,1
org.apache.xpath.res.XPATHErrorResources_it,3,4,6,0.6666666666666666,1,0.3333333333333333,648,216.0,2,0.3333333333333333,0.0,0.0,0.0,0.0,0,2,2
org.apache.xalan.xsltc.compiler.AbsolutePathPattern,15,68,210,0.3238095238095238,1,0.06666666666666667,647,43.13333333333333,142,0.6761904761904762,0.0,0.0,0.20305675954272748,0.010279923650460614,1,14,15
org.apache.xml.serializer.DOMSerializer,2,1,2,0.5,1,0.5,0,0.0,1,0.5,0.0,0.0,0.0010351966873706005,1.0727426812130574e-06,1,1,2
org.apache.xalan.xsltc.compiler.Number,21,119,420,0.2833333333333333,1,0.047619047619047616,647,30.80952380952381,301,0.7166666666666667,0.0,0.0,0.2369684790590282,0.013612484035146012,2,20,22
org.apache.xpath.res.XPATHErrorResources_ko,2,2,2,1.0,1,0.5,648,324.0,0,0.0,0.0,0.0,0.0,0.0,0,1,1
org.apache.xalan.templates.StylesheetRoot,30,178,870,0.2045977011494253,1,0.03333333333333333,647,21.566666666666666,692,0.7954022988505747,0.33162629994526555,0.011054209998175519,0.22054174452366096,0.07480588814908344,47,29,76
org.apache.xalan.xsltc.trax.SmartTransformerFactoryImpl,3,3,6,0.5,1,0.3333333333333333,648,216.0,3,0.5,0.0,0.0,0.0,0.0,0,2,2
org.apache.xml.utils.ThreadControllerWrapper,2,1,2,0.5,1,0.5,0,0.0,1,0.5,0.0,0.0,0.17397658496290766,0.000952595500917195,2,1,3
org.apache.xml.res.XMLErrorResources_zh_CN,2,2,2,1.0,1,0.5,648,324.0,0,0.0,0.0,0.0,0.0,0.0,0,1,1
org.apache.xpath.axes.ContextNodeList,3,3,6,0.5,1,0.3333333333333333,1,0.3333333333333333,3,0.5,0.0,0.0,0.003901895206243032,0.0,1,2,3
org.apache.xalan.xslt.XSLProcessorException,4,6,12,0.5,1,0.25,647,161.75,6,0.5,0.0,0.0,0.1888823428863358,0.00012480317002430683,1,3,4
org.apache.xalan.xsltc.compiler.util.NodeSortRecordGenerator,5,10,20,0.5,1,0.2,647,129.4,10,0.5,0.0,0.0,0.14103214935513073,8.04557010909793e-07,1,4,5
org.apache.xalan.xsltc.compiler.CurrentCall,5,7,20,0.35,1,0.2,648,129.6,13,0.65,0.0,0.0,0.0,0.0,0,4,4
org.apache.xalan.xsltc.compiler.CeilingCall,5,7,20,0.35,1,0.2,648,129.6,13,0.65,0.0,0.0,0.0,0.0,0,4,4
org.apache.xalan.xsltc.compiler.When,13,60,156,0.38461538461538464,1,0.07692307692307693,647,49.76923076923077,96,0.6153846153846154,0.0,0.0,0.2032087481351996,0.00018396531487002734,2,12,14
org.apache.xml.utils.ObjectStack,2,3,2,1.5,1,0.5,0,0.0,-1,-0.5,0.0,0.0,0.24691413691650416,3.5758089373768577e-07,5,2,7
org.apache.xpath.functions.FuncTrue,6,15,30,0.5,1,0.16666666666666666,648,108.0,15,0.5,0.0,0.0,0.0,0.0,0,5,5
org.apache.xalan.templates.ElemForEach,23,100,506,0.1976284584980237,1,0.043478260869565216,647,28.130434782608695,406,0.8023715415019763,0.07675479282622139,0.003337164905487886,0.18119258343178643,0.0031736961618267067,6,22,28
org.apache.xalan.extensions.ExtensionHandlerJavaClass,12,39,132,0.29545454545454547,1,0.08333333333333333,652,54.333333333333336,93,0.7045454545454546,0.0,0.0,0.0,0.0,0,11,11
org.apache.xml.dtm.DTM,5,7,20,0.35,1,0.2,647,129.4,13,0.65,0.0,0.0,0.29822799799556204,0.004346930037633392,52,4,56
org.apache.xalan.xsltc.cmdline.getopt.IllegalArgumentException,3,3,6,0.5,1,0.3333333333333333,649,216.33333333333334,3,0.5,0.0,0.0,0.0013802622498274672,5.363713406065287e-07,1,2,3
org.apache.xalan.xsltc.dom.KeyIndex,10,31,90,0.34444444444444444,1,0.1,647,64.7,59,0.6555555555555556,0.0,0.0,0.13839603441391332,0.0007373037606967349,3,10,13
org.apache.xalan.templates.ElemCopy,12,35,132,0.26515151515151514,1,0.08333333333333333,647,53.916666666666664,97,0.7348484848484849,0.0,0.0,0.149937529920081,0.0001700127415104606,2,11,13
org.apache.xalan.xsltc.dom.StepIterator,2,2,2,1.0,1,0.5,0,0.0,0,0.0,0.0,0.0,0.002070393374741201,0.0,2,1,3
org.apache.xalan.xsltc.compiler.StepPattern,18,68,306,0.2222222222222222,1,0.05555555555555555,647,35.94444444444444,238,0.7777777777777778,0.021446078431372553,0.0011914488017429196,0.16834656108430754,0.007949021136519829,8,17,25
org.apache.xpath.domapi.XPathEvaluatorImpl,12,31,132,0.23484848484848486,1,0.08333333333333333,659,54.916666666666664,101,0.7651515151515151,0.0,0.0,0.0010351966873706005,0.0002746304903317512,1,11,12
org.apache.xalan.xslt.Stylesheet,5,11,20,0.55,1,0.2,647,129.4,9,0.45,0.3333333333333333,0.06666666666666667,0.23745208819996502,0.09048616664741493,23,4,27
org.apache.xalan.transformer.NodeSortKey,7,13,42,0.30952380952380953,1,0.14285714285714285,647,92.42857142857143,29,0.6904761904761905,0.15,0.02142857142857143,0.15885716062529354,0.0007689975416733619,3,6,9
org.apache.xpath.axes.PathComponent,1,0,0,0,1,1.0,-1,-1.0,0,0,0.0,0.0,0.1960370164855818,0.0,5,0,5
org.apache.xalan.lib.ExsltSets,4,4,12,0.3333333333333333,1,0.25,651,162.75,8,0.6666666666666666,0.0,0.0,0.0013802622498274672,2.4058317592897455e-05,1,3,4
org.apache.xml.utils.ListingErrorHandler,7,12,42,0.2857142857142857,1,0.14285714285714285,648,92.57142857142857,30,0.7142857142857143,0.0,0.0,0.0,0.0,0,6,6
org.apache.xml.dtm.DTMException,4,6,12,0.5,1,0.25,647,161.75,6,0.5,0.0,0.0,0.18901384602596424,0.0005398407389682652,11,3,14
org.apache.xalan.extensions.ExtensionsTable,11,27,110,0.24545454545454545,1,0.09090909090909091,647,58.81818181818182,83,0.7545454545454545,0.0,0.0,0.15901223399568137,0.00040404149457305385,2,10,12
org.apache.xml.utils.StringToStringTable,2,1,2,0.5,1,0.5,648,324.0,1,0.5,0.0,0.0,0.0010351966873706005,0.0,1,1,2
org.apache.xalan.xsltc.compiler.UnparsedEntityUriCall,10,30,90,0.3333333333333333,1,0.1,648,64.8,60,0.6666666666666666,0.0,0.0,0.0,0.0,0,9,9
org.apache.xalan.xsltc.dom.AnyNodeCounter,7,22,42,0.5238095238095238,1,0.14285714285714285,650,92.85714285714286,20,0.47619047619047616,0.03333333333333333,0.0047619047619047615,0.0010351966873706005,2.145485362426115e-06,1,6,7
org.apache.xalan.xpath.xml.XMLParserLiaison,1,0,0,0,1,1.0,-1,-1.0,0,0,0.0,0.0,0.1601052213619218,0.0,4,0,4
org.apache.xpath.WhitespaceStrippingElementMatcher,2,1,2,0.5,1,0.5,647,323.5,1,0.5,0.0,0.0,0.1788843976555853,0.0,1,1,2
org.apache.xalan.processor.TransformerFactoryImpl,18,55,306,0.17973856209150327,1,0.05555555555555555,647,35.94444444444444,251,0.8202614379084967,0.1213235294117647,0.006740196078431373,0.18857621267096086,0.019249347919075118,10,17,27
org.apache.xalan.xslt.XSLTInputSource,3,2,6,0.3333333333333333,1,0.3333333333333333,647,215.66666666666666,4,0.6666666666666666,0.0,0.0,0.16669272667332788,5.852818306694995e-07,3,2,5
org.apache.xalan.xsltc.compiler.DecimalFormatting,10,31,90,0.34444444444444444,1,0.1,647,64.7,59,0.6555555555555556,0.15277777777777776,0.015277777777777776,0.21337717121453495,1.4749129093245124e-05,2,9,11
org.apache.xalan.xsltc.dom.AbsoluteIterator,3,3,6,0.5,1,0.3333333333333333,648,216.0,3,0.5,0.0,0.0,0.0010351966873706005,0.0,1,2,3
org.apache.xalan.xsltc.compiler.NamespaceUriCall,5,7,20,0.35,1,0.2,649,129.8,13,0.65,0.0,0.0,0.0,0.0,0,4,4
org.apache.xalan.xsltc.compiler.ContainsCall,11,35,110,0.3181818181818182,1,0.09090909090909091,648,58.90909090909091,75,0.6818181818181818,0.0,0.0,0.0,0.0,0,10,10
org.apache.xalan.xsltc.dom.CollatorFactoryBase,3,3,6,0.5,1,0.3333333333333333,649,216.33333333333334,3,0.5,0.0,0.0,0.0018633540372670805,0.0,1,2,3
org.apache.xml.serializer.SerializerTrace,2,1,2,0.5,1,0.5,647,323.5,1,0.5,0.0,0.0,0.1626319214308866,2.096724331461885e-07,5,1,6
org.apache.xalan.processor.XSLTElementDef,9,27,72,0.375,1,0.1111111111111111,647,71.88888888888889,45,0.625,0.07738095238095237,0.008597883597883597,0.1559373276901934,0.00042683738049829965,7,9,16
org.apache.xalan.xsltc.compiler.Pattern,7,15,42,0.35714285714285715,1,0.14285714285714285,647,92.42857142857143,27,0.6428571428571429,0.0,0.0,0.21501073456332628,8.146740830663918e-06,11,6,17
org.apache.xalan.xsltc.compiler.ArgumentList,3,3,6,0.5,1,0.3333333333333333,648,216.0,3,0.5,0.0,0.0,0.0,0.0,0,2,2
org.apache.xalan.xpath.XNumber,4,8,12,0.6666666666666666,1,0.25,647,161.75,4,0.3333333333333333,0.0,0.0,0.20230021423891703,8.106355701358958e-05,3,3,6
org.apache.xalan.xsltc.compiler.StringCall,9,22,72,0.3055555555555556,1,0.1111111111111111,648,72.0,50,0.6944444444444444,0.0,0.0,0.0,0.0,0,8,8
org.apache.xalan.extensions.MethodResolver,16,48,240,0.2,1,0.0625,650,40.625,192,0.8,0.0,0.0,0.002070393374741201,2.6340941122262524e-05,2,15,17
org.apache.xalan.lib.sql.XConnection,16,42,240,0.175,1,0.0625,660,41.25,198,0.825,0.0,0.0,0.0,0.0,0,15,15
org.apache.xalan.xsltc.runtime.Node,1,0,0,0,1,1.0,-1,-1.0,0,0,0.0,0.0,0.29259963178492876,0.0,77,0,77
org.apache.xml.utils.ObjectVector,1,1,0,0,1,1.0,-1,-1.0,-1,0,0.0,0.0,0.24859850536597397,0.0,9,1,10
org.apache.xpath.functions.FuncSubstring,11,36,110,0.32727272727272727,1,0.09090909090909091,648,58.90909090909091,74,0.6727272727272727,0.0,0.0,0.0,0.0,0,10,10
org.apache.xalan.xsltc.compiler.AttributeValueTemplate,12,47,132,0.3560606060606061,1,0.08333333333333333,647,53.916666666666664,85,0.6439393939393939,0.05909090909090909,0.004924242424242424,0.19461425627858542,0.002018603704982026,4,11,15
org.apache.xalan.xsltc.compiler.util.NodeSortRecordFactGenerator,4,7,12,0.5833333333333334,1,0.25,647,161.75,5,0.4166666666666667,0.0,0.0,0.14103214935513073,8.04557010909793e-07,1,3,4
org.apache.xalan.xslt.XSLTProcessor,15,36,210,0.17142857142857143,1,0.06666666666666667,647,43.13333333333333,174,0.8285714285714286,0.05494505494505495,0.0036630036630036634,0.16652231906069925,0.0005579299271295153,3,14,17
org.apache.xml.dtm.ref.DTMNodeList,4,5,12,0.4166666666666667,1,0.25,647,161.75,7,0.5833333333333334,0.0,0.0,0.2868829385438112,0.0011423166244814399,5,3,8
org.apache.xml.utils.NamespaceSupport2,4,6,12,0.5,1,0.25,647,161.75,6,0.5,0.3333333333333333,0.08333333333333333,0.14184267894912572,0.002593891803173173,2,3,5
org.apache.xml.serializer.XSLOutputAttributes,2,1,2,0.5,1,0.5,647,323.5,1,0.5,0.0,0.0,0.1617276931147498,0.0,4,1,5
org.apache.xalan.processor.ProcessorOutputElem,9,24,72,0.3333333333333333,1,0.1111111111111111,647,71.88888888888889,48,0.6666666666666666,0.0,0.0,0.14985476771405334,7.433545862611052e-05,1,8,9
org.apache.xalan.xsltc.compiler.UnionPathExpr,13,56,156,0.358974358974359,1,0.07692307692307693,647,49.76923076923077,100,0.6410256410256411,0.011363636363636364,0.0008741258741258741,0.13970165738008233,1.6269930665064703e-06,2,12,14
org.apache.xalan.xsltc.compiler.Attribute,5,6,20,0.3,1,0.2,648,129.6,14,0.7,0.0,0.0,0.0,0.0,0,4,4
org.apache.xml.utils.XMLString,2,2,2,1.0,1,0.5,647,323.5,0,0.0,0.0,0.0,0.3293411494241326,0.005204270516157042,45,2,47
org.apache.xml.serializer.SerializerConstants,1,0,0,0,1,1.0,-1,-1.0,0,0,0.0,0.0,0.1400889199667003,0.0,2,0,2
org.apache.xml.utils.synthetic.reflection.Field,5,9,20,0.45,1,0.2,647,129.4,11,0.55,0.08333333333333333,0.016666666666666666,0.16276192296680253,0.00024040818635334032,1,4,5
org.apache.xpath.functions.FuncLocalPart,7,18,42,0.42857142857142855,1,0.14285714285714285,649,92.71428571428571,24,0.5714285714285714,0.0,0.0,0.0,0.0,0,6,6
org.apache.xpath.functions.FuncCount,7,17,42,0.40476190476190477,1,0.14285714285714285,648,92.57142857142857,25,0.5952380952380952,0.0,0.0,0.0,0.0,0,6,6
org.apache.xalan.lib.ExsltDatetime,6,18,30,0.6,1,0.16666666666666666,648,108.0,12,0.4,0.0,0.0,0.0,0.0,0,5,5
org.apache.xalan.templates.ElemTextLiteral,9,28,72,0.3888888888888889,1,0.1111111111111111,647,71.88888888888889,44,0.6111111111111112,0.005952380952380952,0.0006613756613756613,0.1799515383397879,0.00031509901161920365,7,8,15
org.apache.xalan.xsltc.dom.MatchingIterator,2,2,2,1.0,1,0.5,0,0.0,0,0.0,0.0,0.0,0.0,0.0,0,1,1
org.apache.xalan.processor.ProcessorInclude,11,33,110,0.3,1,0.09090909090909091,647,58.81818181818182,77,0.7,0.0,0.0,0.14990993236257683,0.00019389874243879127,2,10,12
org.apache.xalan.res.XSLTErrorResources_de,2,2,2,1.0,1,0.5,648,324.0,0,0.0,0.0,0.0,0.0,0.0,0,1,1
org.apache.xml.serializer.SerializerTraceWriter,3,3,6,0.5,1,0.3333333333333333,647,215.66666666666666,3,0.5,0.0,0.0,0.11991470296317433,0.0,1,2,3
org.apache.xalan.xsltc.dom.MultiDOM,19,74,342,0.21637426900584794,1,0.05263157894736842,650,34.21052631578947,268,0.783625730994152,0.07135076252723313,0.003755303290907007,0.004140786749482402,0.0008660328509037849,4,18,22
org.apache.xalan.serialize.SerializerFactory,5,8,20,0.4,1,0.2,650,130.0,12,0.6,0.0,0.0,0.0,0.0,0,4,4
org.apache.xml.res.XMLErrorResources_de,2,2,2,1.0,1,0.5,648,324.0,0,0.0,0.0,0.0,0.0,0.0,0,1,1
org.apache.xalan.serialize.DOMSerializer,1,0,0,0,1,1.0,-1,-1.0,0,0,0.0,0.0,0.14329397034316924,0.0,8,0,8
org.apache.xalan.processor.ProcessorText,6,11,30,0.36666666666666664,1,0.16666666666666666,647,107.83333333333333,19,0.6333333333333333,0.0,0.0,0.14985476771405334,2.6431284034604564e-05,1,5,6
org.apache.xalan.transformer.DecimalToRoman,2,1,2,0.5,1,0.5,647,323.5,1,0.5,0.0,0.0,0.1303554197384571,0.0,2,1,3
org.apache.xalan.xsltc.compiler.Comment,8,25,56,0.44642857142857145,1,0.125,647,80.875,31,0.5535714285714286,0.0,0.0,0.1689752411879419,0.0066710192563320505,2,7,9
org.apache.xalan.xsltc.compiler.Fallback,9,32,72,0.4444444444444444,1,0.1111111111111111,647,71.88888888888889,40,0.5555555555555556,0.0,0.0,0.17208127245423196,2.6818567030326436e-07,1,8,9
org.apache.xpath.res.XPATHErrorResources_zh_CN,2,2,2,1.0,1,0.5,648,324.0,0,0.0,0.0,0.0,0.0,0.0,0,1,1
org.apache.xalan.xsltc.compiler.PositionCall,7,11,42,0.2619047619047619,1,0.14285714285714285,647,92.42857142857143,31,0.7380952380952381,0.0,0.0,0.1257271785313183,1.32882129712175e-05,1,6,7
org.apache.xalan.templates.ElemVariablePsuedo,8,23,56,0.4107142857142857,1,0.125,647,80.875,33,0.5892857142857143,0.0,0.0,0.1477613683827794,0.0010256273152072309,1,7,8
org.apache.xalan.templates.XSLTVisitor,7,18,42,0.42857142857142855,1,0.14285714285714285,647,92.42857142857143,24,0.5714285714285714,0.6333333333333333,0.09047619047619047,0.1884889290733349,0.005699020241274376,19,6,25
org.apache.xalan.xsltc.compiler.DocumentCall,12,47,132,0.3560606060606061,1,0.08333333333333333,648,54.0,85,0.6439393939393939,0.0,0.0,0.0,0.0,0,11,11
org.apache.xalan.xsltc.dom.Axis,1,0,0,0,1,1.0,-1,-1.0,0,0,0.0,0.0,0.18331420090859255,0.0,17,0,17
org.apache.xml.dtm.ref.IncrementalSAXSource_Filter,9,14,72,0.19444444444444445,1,0.1111111111111111,647,71.88888888888889,58,0.8055555555555556,0.0,0.0,0.19056168987503042,0.002765016467936932,5,8,13
org.apache.xalan.templates.ElemWithParam,22,120,462,0.2597402597402597,1,0.045454545454545456,647,29.40909090909091,342,0.7402597402597403,0.0,0.0,0.14999275552962799,8.701395346343898e-05,3,21,24
org.apache.xalan.xslt.StylesheetSpec,2,1,2,0.5,1,0.5,647,323.5,1,0.5,0.0,0.0,0.1595105096995456,0.0,2,1,3
org.apache.xalan.xsltc.runtime.output.StringOutputBuffer,3,4,6,0.6666666666666666,1,0.3333333333333333,649,216.33333333333334,2,0.3333333333333333,0.0,0.0,0.0,0.0,0,2,2
org.apache.xpath.functions.FuncString,6,16,30,0.5333333333333333,1,0.16666666666666666,649,108.16666666666667,14,0.4666666666666667,0.0,0.0,0.0,0.0,0,5,5
org.apache.xalan.transformer.SerializerSwitcher,8,16,56,0.2857142857142857,1,0.125,647,80.875,40,0.7142857142857143,0.0,0.0,0.13380329596285198,0.0002589989964420275,1,7,8
org.apache.xalan.lib.sql.ObjectArray,3,2,6,0.3333333333333333,1,0.3333333333333333,649,216.33333333333334,4,0.6666666666666666,0.0,0.0,0.0027605244996549345,0.00011927246373757989,2,2,4
org.apache.xalan.xsltc.compiler.TopLevelElement,10,35,90,0.3888888888888889,1,0.1,647,64.7,55,0.6111111111111112,0.0,0.0,0.21220965672899428,0.0002214645864477321,16,9,25
org.apache.xalan.xsltc.compiler.XslAttribute,22,146,462,0.31601731601731603,1,0.045454545454545456,647,29.40909090909091,316,0.683982683982684,0.0,0.0,0.17365898987758635,0.0011919821202658013,2,21,23
org.apache.xml.dtm.ref.DTMDefaultBase,16,52,240,0.21666666666666667,1,0.0625,647,40.4375,188,0.7833333333333333,0.008333333333333335,0.0005208333333333334,0.17146540263702734,0.04037358742798486,76,15,91
org.apache.xml.res.XMLErrorResources_zh_TW,2,2,2,1.0,1,0.5,648,324.0,0,0.0,0.0,0.0,0.0,0.0,0,1,1
org.apache.xalan.templates.FuncFormatNumb,15,45,210,0.21428571428571427,1,0.06666666666666667,647,43.13333333333333,165,0.7857142857142857,0.0,0.0,0.14157146923794195,0.0019424532372423968,1,14,15
org.apache.xalan.lib.sql.SQLDocument,7,11,42,0.2619047619047619,1,0.14285714285714285,653,93.28571428571429,31,0.7380952380952381,0.0,0.0,0.0010351966873706005,2.0747818675279816e-05,1,6,7
org.apache.xpath.functions.FuncExtFunctionAvailable,11,19,110,0.17272727272727273,1,0.09090909090909091,648,58.90909090909091,91,0.8272727272727273,0.0,0.0,0.0,0.0,0,10,10
org.apache.xalan.xsltc.compiler.ApplyImports,13,65,156,0.4166666666666667,1,0.07692307692307693,648,49.84615384615385,91,0.5833333333333334,0.0,0.0,0.0,0.0,0,12,12
org.apache.xpath.functions.FunctionMultiArgs,9,18,72,0.25,1,0.1111111111111111,649,72.11111111111111,54,0.75,0.10714285714285714,0.011904761904761904,0.002070393374741201,0.0002225394426005063,2,8,10
org.apache.xml.dtm.Axis,1,0,0,0,1,1.0,-1,-1.0,0,0,0.0,0.0,0.27300941024948583,0.0,35,0,35
org.apache.xalan.xsltc.trax.TransformerImpl,21,78,420,0.18571428571428572,1,0.047619047619047616,647,30.80952380952381,342,0.8142857142857143,0.04078947368421053,0.001942355889724311,0.19136763687168232,0.07292594175944196,51,20,71
org.apache.xalan.xpath.xml.FormatterToHTML,2,2,2,1.0,1,0.5,0,0.0,0,0.0,0.0,0.0,0.16665948073621126,0.0,1,1,2
org.apache.xpath.functions.FuncId,12,38,132,0.2878787878787879,1,0.08333333333333333,648,54.0,94,0.7121212121212122,0.0,0.0,0.0,0.0,0,11,11
org.apache.xml.dtm.ref.sax2dtm.SAX2RTFDTM,10,25,90,0.2777777777777778,1,0.1,647,64.7,65,0.7222222222222222,0.0,0.0,0.2582310280678123,0.03594986385990096,2,9,11
org.apache.xalan.processor.XSLProcessorVersion,2,1,2,0.5,1,0.5,648,324.0,1,0.5,0.0,0.0,0.002070393374741201,0.0,2,1,3
org.apache.xalan.templates.ElemSort,11,33,110,0.3,1,0.09090909090909091,647,58.81818181818182,77,0.7,0.0,0.0,0.15932329079144758,2.866793473997199e-05,3,10,13
org.apache.xalan.templates.ElemExtensionDecl,15,57,210,0.2714285714285714,1,0.06666666666666667,647,43.13333333333333,153,0.7285714285714285,0.0,0.0,0.1504638208989248,4.179081208008032e-05,2,14,16
org.apache.xalan.processor.ProcessorAttributeSet,6,12,30,0.4,1,0.16666666666666666,647,107.83333333333333,18,0.6,0.0,0.0,0.14985476771405334,6.865767180237263e-05,1,5,6
org.apache.xalan.templates.WhiteSpaceInfo,7,24,42,0.5714285714285714,1,0.14285714285714285,647,92.42857142857143,18,0.42857142857142855,0.041666666666666664,0.005952380952380952,0.18779355834122202,0.00021974738197071955,6,6,12
org.apache.xalan.xsltc.cmdline.getopt.GetOpt,7,11,42,0.2619047619047619,1,0.14285714285714285,653,93.28571428571429,31,0.7380952380952381,0.0,0.0,0.0010351966873706005,4.29097072485223e-06,1,6,7
org.apache.xml.res.XMLErrorResources_it,2,2,2,1.0,1,0.5,648,324.0,0,0.0,0.0,0.0,0.0,0.0,0,1,1
org.apache.xml.res.XMLErrorResources_ja,2,2,2,1.0,1,0.5,648,324.0,0,0.0,0.0,0.0,0.0,0.0,0,1,1
org.apache.xml.utils.XMLChar,2,1,2,0.5,1,0.5,647,323.5,1,0.5,0.0,0.0,0.18831460405222658,0.0,2,1,3
org.apache.xalan.extensions.ExtensionHandlerGeneral,19,74,342,0.21637426900584794,1,0.05263157894736842,649,34.1578947368421,268,0.783625730994152,0.0,0.0,0.0,0.0,0,18,18
org.apache.xalan.templates.ElemExtensionScript,4,6,12,0.5,1,0.25,647,161.75,6,0.5,0.0,0.0,0.15021406538655108,3.3175819486144094e-07,2,3,5
org.apache.xpath.axes.WalkingIterator,13,48,156,0.3076923076923077,1,0.07692307692307693,647,49.76923076923077,108,0.6923076923076923,0.03977272727272727,0.0030594405594405595,0.1900281527125245,0.0007928517869511261,8,12,20
org.apache.xalan.xsltc.compiler.Template,16,84,240,0.35,1,0.0625,647,40.4375,156,0.65,0.07501133786848072,0.004688208616780045,0.2155798471481948,0.0007419567762761988,11,16,27
org.apache.xml.utils.res.XResources_sv,2,2,2,1.0,1,0.5,648,324.0,0,0.0,0.0,0.0,0.0,0.0,0,1,1
org.apache.xalan.trace.SelectionEvent,6,11,30,0.36666666666666664,1,0.16666666666666666,647,107.83333333333333,19,0.6333333333333333,0.0,0.0,0.15665717686591268,0.00037642467688195564,4,5,9
org.apache.xpath.functions.FuncNamespace,6,16,30,0.5333333333333333,1,0.16666666666666666,649,108.16666666666667,14,0.4666666666666667,0.0,0.0,0.0,0.0,0,5,5
org.apache.xml.serializer.TransformStateSetter,2,1,2,0.5,1,0.5,0,0.0,1,0.5,0.0,0.0,0.13965750840820576,1.0727426812130574e-06,2,1,3
org.apache.xpath.compiler.FunctionTable,7,15,42,0.35714285714285715,1,0.14285714285714285,647,92.42857142857143,27,0.6428571428571429,0.13333333333333333,0.019047619047619046,0.1821652119270588,0.0012839099169547057,5,6,11
org.apache.xalan.processor.ProcessorGlobalVariableDecl,6,13,30,0.43333333333333335,1,0.16666666666666666,647,107.83333333333333,17,0.5666666666666667,0.0,0.0,0.14985476771405334,2.6681153911757668e-05,1,5,6
org.apache.xalan.xsltc.compiler.util.FilterGenerator,5,10,20,0.5,1,0.2,647,129.4,10,0.5,0.0,0.0,0.12578543050592741,1.764524909842856e-05,2,4,6
org.apache.xpath.axes.WalkerFactory,32,157,992,0.15826612903225806,1,0.03125,647,20.21875,835,0.8417338709677419,0.285309582890228,0.008915924465319625,0.20260215485718408,0.00964092188644159,16,31,47
org.apache.xpath.axes.SubContextList,2,2,2,1.0,1,0.5,647,323.5,0,0.0,0.0,0.0,0.24628384110247356,0.0,5,1,6
org.apache.xml.dtm.ref.DTMChildIterNodeList,4,4,12,0.3333333333333333,1,0.25,647,161.75,8,0.6666666666666666,0.0,0.0,0.1455433635678842,9.387019699221111e-05,1,3,4
org.apache.xpath.objects.XNodeSet,22,68,462,0.1471861471861472,1,0.045454545454545456,647,29.40909090909091,394,0.8528138528138528,0.0380952380952381,0.0017316017316017318,0.23683066662572838,0.009965516333279686,14,21,35
org.apache.xpath.objects.Comparator,2,2,2,1.0,1,0.5,647,323.5,0,0.0,0.0,0.0,0.18980672629360987,0.0,7,1,8
org.apache.xalan.templates.ElemNumber,29,124,812,0.15270935960591134,1,0.034482758620689655,647,22.310344827586206,688,0.8472906403940886,0.10273368606701938,0.003542540898862737,0.151640413801132,0.005210729442572143,5,28,33
org.apache.xpath.compiler.OpCodes,1,0,0,0,1,1.0,-1,-1.0,0,0,0.0,0.0,0.197173462957962,0.0,9,0,9
org.apache.xalan.xsltc.compiler.ApplyTemplates,21,141,420,0.3357142857142857,1,0.047619047619047616,647,30.80952380952381,279,0.6642857142857143,0.0106140350877193,0.0005054302422723477,0.2032087481351996,0.007698058439630868,2,20,22
org.apache.xml.dtm.ref.DTMSafeStringPool,3,3,6,0.5,1,0.3333333333333333,648,216.0,3,0.5,0.0,0.0,0.0,0.0,0,2,2
org.apache.xpath.compiler.XPathParser,16,57,240,0.2375,1,0.0625,647,40.4375,183,0.7625,0.01666666666666667,0.0010416666666666669,0.18204306270135895,0.0026107776724206356,4,15,19
org.apache.xml.res.XMLErrorResources_fr,2,2,2,1.0,1,0.5,648,324.0,0,0.0,0.0,0.0,0.0,0.0,0,1,1
org.apache.xalan.xsltc.compiler.LogicalExpr,13,55,156,0.3525641025641026,1,0.07692307692307693,649,49.92307692307692,101,0.6474358974358975,0.0,0.0,0.0,0.0,0,12,12
org.apache.xpath.functions.FunctionOneArg,8,17,56,0.30357142857142855,1,0.125,647,80.875,39,0.6964285714285714,0.0,0.0,0.11170767556245782,0.0010651944723506616,15,7,22
org.apache.xalan.processor.ProcessorPreserveSpace,8,19,56,0.3392857142857143,1,0.125,647,80.875,37,0.6607142857142857,0.0,0.0,0.14990993236257683,0.0005457427459696674,2,7,9
org.apache.xpath.operations.Plus,6,16,30,0.5333333333333333,1,0.16666666666666666,647,107.83333333333333,14,0.4666666666666667,0.0,0.0,0.17537912629756244,1.7864579865270404e-05,2,5,7
org.apache.xml.utils.XMLStringDefault,3,4,6,0.6666666666666666,1,0.3333333333333333,647,215.66666666666666,2,0.3333333333333333,0.0,0.0,0.12417451784203079,0.0,3,2,5
org.apache.xalan.transformer.TreeWalker2Result,8,15,56,0.26785714285714285,1,0.125,647,80.875,41,0.7321428571428571,0.0,0.0,0.1289519731674921,0.0,1,7,8
org.apache.xalan.xsltc.compiler.IntExpr,8,22,56,0.39285714285714285,1,0.125,648,81.0,34,0.6071428571428571,0.0,0.0,0.0,0.0,0,7,7
org.apache.xalan.xsltc.dom.AdaptiveResultTreeImpl,20,78,380,0.20526315789473684,1,0.05,647,32.35,302,0.7947368421052632,0.025828460038986353,0.0012914230019493178,0.1386788119403848,0.003717876422568382,2,19,21
org.apache.xml.utils.StringToStringTableVector,3,3,6,0.5,1,0.3333333333333333,649,216.33333333333334,3,0.5,0.0,0.0,0.0,0.0,0,2,2
org.apache.xml.dtm.ref.IncrementalSAXSource_Xerces,8,18,56,0.32142857142857145,1,0.125,647,80.875,38,0.6785714285714286,0.0,0.0,0.16208172388574726,7.338409613717282e-05,1,7,8
org.apache.xpath.compiler.Keywords,4,5,12,0.4166666666666667,1,0.25,647,161.75,7,0.5833333333333334,0.16666666666666666,0.041666666666666664,0.15729251883466203,1.802068755569263e-05,5,3,8
org.apache.xalan.transformer.TransformerImpl,73,381,5256,0.07248858447488585,1,0.0136986301369863,647,8.863013698630137,4875,0.9275114155251142,0.48046075761744783,0.006581654213937641,0.1918635247410789,0.06480422544453211,68,72,140
org.apache.xalan.xsltc.compiler.LocationPathPattern,13,47,156,0.30128205128205127,1,0.07692307692307693,647,49.76923076923077,109,0.6987179487179487,0.0,0.0,0.16796466540026397,0.0007694759129541357,6,13,19
org.apache.xalan.xsltc.trax.TemplatesHandlerImpl,11,41,110,0.37272727272727274,1,0.09090909090909091,647,58.81818181818182,69,0.6272727272727273,0.02777777777777778,0.0025252525252525255,0.1424131251138101,0.0003095703199532519,1,10,11
org.apache.xalan.templates.ElemTemplate,18,96,306,0.3137254901960784,1,0.05555555555555555,647,35.94444444444444,210,0.6862745098039216,0.07138480392156864,0.003965822440087146,0.1893213999362808,0.002775916407198837,21,17,38
org.apache.xml.utils.ObjectPool,6,11,30,0.36666666666666664,1,0.16666666666666666,647,107.83333333333333,19,0.6333333333333333,0.0,0.0,0.17081809197270972,0.0010186708593168908,2,5,7
org.apache.xalan.lib.NodeInfo,4,5,12,0.4166666666666667,1,0.25,648,162.0,7,0.5833333333333334,0.0,0.0,0.0,0.0,0,3,3
org.apache.xalan.xsltc.compiler.Expression,15,75,210,0.35714285714285715,1,0.06666666666666667,647,43.13333333333333,135,0.6428571428571429,0.10073260073260074,0.006715506715506716,0.33489336452544405,0.0775634791967736,91,14,105
org.apache.xalan.xsltc.compiler.util.ResultTreeType,16,116,240,0.48333333333333334,1,0.0625,647,40.4375,124,0.5166666666666667,0.02142857142857143,0.0013392857142857143,0.21315379809627844,4.916910040585877e-05,9,15,24
org.apache.xalan.xsltc.dom.SingleNodeCounter,7,23,42,0.5476190476190477,1,0.14285714285714285,650,92.85714285714286,19,0.4523809523809524,0.0,0.0,0.0010351966873706005,0.0,1,6,7
org.apache.xalan.xsltc.compiler.IdKeyPattern,13,46,156,0.2948717948717949,1,0.07692307692307693,647,49.76923076923077,110,0.7051282051282052,0.07575757575757576,0.005827505827505828,0.15043602928073144,0.0019164063178935585,3,12,15
org.apache.xml.utils.res.XResources_ka,2,2,2,1.0,1,0.5,648,324.0,0,0.0,0.0,0.0,0.0,0.0,0,1,1
org.apache.xalan.templates.ElemAttribute,13,49,156,0.3141025641025641,1,0.07692307692307693,647,49.76923076923077,107,0.6858974358974359,0.0,0.0,0.1564765922239923,0.0001039516877652311,3,12,15
org.apache.xpath.axes.ReverseAxesWalker,6,15,30,0.5,1,0.16666666666666666,647,107.83333333333333,15,0.5,0.0,0.0,0.16604702599916002,1.071223008346832e-05,1,5,6
org.apache.xalan.serialize.SerializerUtils,7,13,42,0.30952380952380953,1,0.14285714285714285,647,92.42857142857143,29,0.6904761904761905,0.0,0.0,0.13619743520499664,0.0006917744699232288,5,6,11
org.apache.xalan.xsltc.compiler.FormatNumberCall,14,65,182,0.35714285714285715,1,0.07142857142857142,648,46.285714285714285,117,0.6428571428571429,0.0,0.0,0.0,0.0,0,13,13
org.apache.xalan.xsltc.compiler.RelationalExpr,23,171,506,0.33794466403162055,1,0.043478260869565216,648,28.17391304347826,335,0.6620553359683794,0.0,0.0,0.0,0.0,0,22,22
org.apache.xalan.xsltc.DOM,7,11,42,0.2619047619047619,1,0.14285714285714285,647,92.42857142857143,31,0.7380952380952381,0.16666666666666666,0.023809523809523808,0.23512143837352195,0.004616774101287132,36,7,43
org.apache.xml.serializer.ToTextStream,4,7,12,0.5833333333333334,1,0.25,647,161.75,5,0.4166666666666667,0.0,0.0,0.16118358648839895,0.007658028542175056,2,3,5
org.apache.xpath.axes.NodeSequence,10,32,90,0.35555555555555557,1,0.1,647,64.7,58,0.6444444444444445,0.0,0.0,0.19701515784370582,0.00015417185130174062,9,9,18
org.apache.xalan.xsltc.compiler.util.StringStack,2,1,2,0.5,1,0.5,648,324.0,1,0.5,0.0,0.0,0.0,0.0,0,1,1
org.apache.xalan.processor.ProcessorDecimalFormat,6,12,30,0.4,1,0.16666666666666666,647,107.83333333333333,18,0.6,0.0,0.0,0.14985476771405334,6.865767180237263e-05,1,5,6
org.apache.xalan.xsltc.dom.SortingIterator,5,9,20,0.45,1,0.2,652,130.4,11,0.55,0.0,0.0,0.0,0.0,0,4,4
org.apache.xml.utils.res.XResources_el,2,2,2,1.0,1,0.5,648,324.0,0,0.0,0.0,0.0,0.0,0.0,0,1,1
org.apache.xml.dtm.DTMDOMException,2,1,2,0.5,1,0.5,647,323.5,1,0.5,0.0,0.0,0.1897183001457908,0.00033666241145403127,3,1,4
org.apache.xml.utils.res.XResources_es,2,2,2,1.0,1,0.5,648,324.0,0,0.0,0.0,0.0,0.0,0.0,0,1,1
org.apache.xalan.res.XSLTErrorResources_es,2,2,2,1.0,1,0.5,648,324.0,0,0.0,0.0,0.0,0.0,0.0,0,1,1
org.apache.xpath.operations.Gt,5,11,20,0.55,1,0.2,647,129.4,9,0.45,0.0,0.0,0.17534136975799355,1.595948675392572e-05,1,4,5
org.apache.xalan.xsltc.compiler.util.NodeType,16,115,240,0.4791666666666667,1,0.0625,647,40.4375,125,0.5208333333333334,0.004761904761904762,0.00029761904761904765,0.21343308766401467,7.098641443289314e-05,13,15,28
org.apache.xpath.objects.XStringForChars,7,16,42,0.38095238095238093,1,0.14285714285714285,647,92.42857142857143,26,0.6190476190476191,0.0,0.0,0.22467880345541516,2.145485362426115e-06,1,6,7
org.apache.xpath.axes.WalkingIteratorSorted,7,22,42,0.5238095238095238,1,0.14285714285714285,647,92.42857142857143,20,0.47619047619047616,0.01111111111111111,0.001587301587301587,0.16601318029471665,2.6818567030326436e-07,1,6,7
org.apache.xalan.templates.NamespaceAlias,5,14,20,0.7,1,0.2,647,129.4,6,0.3,0.041666666666666664,0.008333333333333333,0.18744779344669274,3.210325666281999e-05,5,4,9
org.apache.xml.utils.res.XResources_fr,2,2,2,1.0,1,0.5,648,324.0,0,0.0,0.0,0.0,0.0,0.0,0,1,1
org.apache.xalan.xsltc.compiler.util.ErrorMsg,4,10,12,0.8333333333333334,1,0.25,647,161.75,2,0.16666666666666666,0.0,0.0,0.2822109017761192,0.009723459949854353,71,3,74
org.apache.xalan.transformer.TrAXFilter,6,12,30,0.4,1,0.16666666666666666,647,107.83333333333333,18,0.6,0.0,0.0,0.1565066607467102,9.151286175619799e-05,1,5,6
org.apache.xalan.res.XSLTErrorResources_zh_TW,2,2,2,1.0,1,0.5,648,324.0,0,0.0,0.0,0.0,0.0,0.0,0,1,1
org.apache.xml.res.XMLMessages,2,1,2,0.5,1,0.5,647,323.5,1,0.5,0.0,0.0,0.2756212055925144,0.002204558589764062,34,1,35
org.w3c.dom.xpath.XPathEvaluator,5,6,20,0.3,1,0.2,650,130.0,14,0.7,0.0,0.0,0.002070393374741201,5.363713406065287e-07,2,4,6
org.apache.xml.utils.NameSpace,2,1,2,0.5,1,0.5,647,323.5,1,0.5,0.0,0.0,0.1880537202784299,0.0,1,1,2
org.apache.xpath.operations.Bool,6,15,30,0.5,1,0.16666666666666666,647,107.83333333333333,15,0.5,0.0,0.0,0.17530362947177788,2.5512037310527805e-05,1,5,6
org.apache.xalan.xsltc.compiler.ConcatCall,9,25,72,0.3472222222222222,1,0.1111111111111111,648,72.0,47,0.6527777777777778,0.0,0.0,0.0,0.0,0,8,8
org.apache.xalan.lib.Redirect,12,40,132,0.30303030303030304,1,0.08333333333333333,650,54.166666666666664,92,0.696969696969697,0.0,0.0,0.0,0.0,0,11,11
org.apache.xalan.xsltc.compiler.Whitespace,13,43,156,0.27564102564102566,1,0.07692307692307693,647,49.76923076923077,113,0.7243589743589743,0.08333333333333334,0.006410256410256411,0.17943614508170963,0.0013891207842247305,2,12,14
org.apache.xml.serializer.ToXMLStream,9,25,72,0.3472222222222222,1,0.1111111111111111,647,71.88888888888889,47,0.6527777777777778,0.0,0.0,0.13683814894588037,0.000304661956581133,3,9,12
org.apache.xalan.trace.PrintTraceListener,19,71,342,0.20760233918128654,1,0.05263157894736842,648,34.10526315789474,271,0.7923976608187134,0.0,0.0,0.002070393374741201,0.0002054298174934679,2,18,20
org.apache.xalan.xsltc.compiler.VariableBase,13,60,156,0.38461538461538464,1,0.07692307692307693,647,49.76923076923077,96,0.6153846153846154,0.1388888888888889,0.010683760683760684,0.2182370478365166,0.00019705690788149088,16,13,29
org.apache.xalan.xsltc.compiler.Step,20,90,380,0.23684210526315788,1,0.05,647,32.35,290,0.7631578947368421,0.05701754385964912,0.002850877192982456,0.16463728775538305,0.007907225716960446,5,19,24
org.apache.xalan.xsltc.compiler.UnresolvedRef,17,110,272,0.40441176470588236,1,0.058823529411764705,649,38.1764705882353,162,0.5955882352941176,0.0,0.0,0.0,0.0,0,16,16
org.apache.xpath.operations.Lt,5,11,20,0.55,1,0.2,647,129.4,9,0.45,0.0,0.0,0.17534136975799355,1.595948675392572e-05,1,4,5
org.apache.xpath.objects.NotEqualComparator,3,4,6,0.6666666666666666,1,0.3333333333333333,647,215.66666666666666,2,0.3333333333333333,0.0,0.0,0.1884889290733349,0.0,1,2,3
org.apache.xpath.functions.FuncSubstringBefore,6,13,30,0.43333333333333335,1,0.16666666666666666,648,108.0,17,0.5666666666666667,0.0,0.0,0.0,0.0,0,5,5
org.apache.xalan.templates.OutputProperties,12,38,132,0.2878787878787879,1,0.08333333333333333,647,53.916666666666664,94,0.7121212121212122,0.08636363636363636,0.007196969696969697,0.18796691957670897,0.0013206195399991646,9,12,21
org.apache.xml.serializer.ToXMLSAXHandler,8,12,56,0.21428571428571427,1,0.125,647,80.875,44,0.7857142857142857,0.0,0.0,0.16367778587738746,0.0009389991932325732,3,7,10
org.apache.xalan.templates.ElemEmpty,2,2,2,1.0,1,0.5,648,324.0,0,0.0,0.0,0.0,0.0,0.0,0,1,1
org.apache.xalan.res.XSLTErrorResources_ja,2,2,2,1.0,1,0.5,648,324.0,0,0.0,0.0,0.0,0.0,0.0,0,1,1
org.apache.xml.serializer.ElemDesc,3,3,6,0.5,1,0.3333333333333333,647,215.66666666666666,3,0.5,0.0,0.0,0.11910802318307692,3.381055057751867e-05,1,2,3
org.apache.xalan.res.XSLTErrorResources,2,2,2,1.0,1,0.5,647,323.5,0,0.0,0.0,0.0,0.19601941336362935,0.006265353653684102,64,2,66
org.apache.xpath.axes.BasicTestIterator,11,35,110,0.3181818181818182,1,0.09090909090909091,647,58.81818181818182,75,0.6818181818181818,0.05,0.004545454545454546,0.1612154913946714,0.00045608487052302546,2,10,12
org.apache.xalan.xsltc.compiler.UnsupportedElement,13,59,156,0.3782051282051282,1,0.07692307692307693,647,49.76923076923077,97,0.6217948717948718,0.14141414141414144,0.01087801087801088,0.2116581763320894,0.00095555042012256,1,12,13
org.apache.xalan.xsltc.compiler.Closure,3,5,6,0.8333333333333334,1,0.3333333333333333,647,215.66666666666666,1,0.16666666666666666,0.0,0.0,0.19962271140340196,1.3459617298113838e-05,7,3,10
org.apache.xalan.templates.ElemText,5,10,20,0.5,1,0.2,647,129.4,10,0.5,0.0,0.0,0.15004802183601326,3.6838703329649304e-05,4,4,8
org.apache.xalan.xsltc.compiler.BooleanCall,8,18,56,0.32142857142857145,1,0.125,648,81.0,38,0.6785714285714286,0.0,0.0,0.0,0.0,0,7,7
org.apache.xpath.XPathProcessorException,3,3,6,0.5,1,0.3333333333333333,647,215.66666666666666,3,0.5,0.0,0.0,0.15475216844497053,1.5197187983851646e-06,3,2,5
org.apache.xalan.xsltc.dom.CurrentNodeListFilter,2,1,2,0.5,1,0.5,648,324.0,1,0.5,0.0,0.0,0.0010351966873706005,0.0,1,1,2
org.apache.xpath.operations.Minus,6,16,30,0.5333333333333333,1,0.16666666666666666,647,107.83333333333333,14,0.4666666666666667,0.0,0.0,0.17537912629756244,1.7864579865270404e-05,2,5,7
org.apache.xalan.xsltc.compiler.util.MatchGenerator,5,13,20,0.65,1,0.2,647,129.4,7,0.35,0.0,0.0,0.1884889290733349,0.0,1,4,5
org.apache.xpath.compiler.OpMap,9,16,72,0.2222222222222222,1,0.1111111111111111,647,71.88888888888889,56,0.7777777777777778,0.0,0.0,0.20184898699526146,0.0009535078112712939,12,8,20
org.apache.xml.dtm.SecuritySupport12,3,4,6,0.6666666666666666,1,0.3333333333333333,648,216.0,2,0.3333333333333333,0.0,0.0,0.0,0.0,0,2,2
org.apache.xalan.xsltc.dom.SAXImpl,55,178,2970,0.059932659932659935,1,0.01818181818181818,647,11.763636363636364,2792,0.94006734006734,0.0418704868390403,0.0007612815788916418,0.1631205012068656,0.041064805292305315,14,54,68
org.apache.xml.utils.res.XResources_de,2,2,2,1.0,1,0.5,648,324.0,0,0.0,0.0,0.0,0.0,0.0,0,1,1
org.apache.xalan.res.XSLTErrorResources_ko,2,2,2,1.0,1,0.5,648,324.0,0,0.0,0.0,0.0,0.0,0.0,0,1,1
org.apache.xml.utils.res.XResources_cy,2,2,2,1.0,1,0.5,648,324.0,0,0.0,0.0,0.0,0.0,0.0,0,1,1
org.apache.xalan.xsltc.compiler.QName,3,2,6,0.3333333333333333,1,0.3333333333333333,647,215.66666666666666,4,0.6666666666666666,0.0,0.0,0.24688107381809032,0.000698089248394633,82,2,84
org.apache.xalan.templates.ElemCopyOf,24,107,552,0.19384057971014493,1,0.041666666666666664,647,26.958333333333332,445,0.8061594202898551,0.0,0.0,0.14990993236257683,0.0011784579483473375,2,23,25
org.apache.xalan.xsltc.compiler.UseAttributeSets,12,54,132,0.4090909090909091,1,0.08333333333333333,647,53.916666666666664,78,0.5909090909090909,0.004545454545454545,0.0003787878787878788,0.18015055574560496,2.376146404035794e-05,5,11,16
org.apache.xpath.functions.Function2Args,8,15,56,0.26785714285714285,1,0.125,647,80.875,41,0.7321428571428571,0.11904761904761904,0.01488095238095238,0.12413666552749276,0.0024574194412082667,8,7,15
org.apache.xpath.objects.XBoolean,6,16,30,0.5333333333333333,1,0.16666666666666666,647,107.83333333333333,14,0.4666666666666667,0.041666666666666664,0.006944444444444444,0.22674294613749443,0.0011241319773395361,25,5,30
org.apache.xpath.axes.UnionPathIterator,20,87,380,0.22894736842105262,1,0.05,647,32.35,293,0.7710526315789473,0.15326510721247563,0.007663255360623782,0.23124947828673478,0.014150718572387712,4,19,23
org.apache.xalan.xsltc.compiler.TestSeq,11,46,110,0.41818181818181815,1,0.09090909090909091,647,58.81818181818182,64,0.5818181818181818,0.014814814814814815,0.0013468013468013469,0.15015867671937316,7.586660991085988e-07,1,10,11
org.apache.xml.dtm.ref.ExpandedNameTable,4,6,12,0.5,1,0.25,647,161.75,6,0.5,0.0,0.0,0.19332083136147163,0.003990452963458675,22,3,25
org.apache.xml.serializer.WriterToUTF8,2,1,2,0.5,1,0.5,647,323.5,1,0.5,0.0,0.0,0.11991470296317433,0.0,1,1,2
org.apache.xpath.operations.Quo,5,11,20,0.55,1,0.2,647,129.4,9,0.45,0.0,0.0,0.1539623180578223,1.3224257939264915e-06,1,4,5
org.apache.xpath.axes.FilterExprWalker,16,72,240,0.3,1,0.0625,647,40.4375,168,0.7,0.1642857142857143,0.010267857142857145,0.1898509702857529,0.003025365644830934,5,15,20
org.apache.xalan.xsltc.compiler.Include,15,81,210,0.38571428571428573,1,0.06666666666666667,647,43.13333333333333,129,0.6142857142857143,0.0,0.0,0.17927815595991195,0.0,1,14,15
org.apache.xalan.processor.StylesheetHandler,33,135,1056,0.1278409090909091,1,0.030303030303030304,647,19.606060606060606,921,0.8721590909090909,0.17034730222734254,0.0051620394614346225,0.16724038244884598,0.02174975151853583,26,32,58
org.apache.xalan.xsltc.dom.DocumentCache,9,22,72,0.3055555555555556,1,0.1111111111111111,649,72.11111111111111,50,0.6944444444444444,0.08928571428571427,0.00992063492063492,0.0010351966873706005,5.191303928593315e-05,1,8,9
org.apache.xml.dtm.DTMAxisIterator,1,1,0,0,1,1.0,-1,-1.0,-1,0,0.0,0.0,0.2758544333004109,0.0,76,1,77
org.apache.xalan.lib.sql.QueryParameter,2,1,2,0.5,1,0.5,648,324.0,1,0.5,0.0,0.0,0.0010351966873706005,0.0,1,1,2
org.apache.xalan.xsltc.compiler.If,13,60,156,0.38461538461538464,1,0.07692307692307693,647,49.76923076923077,96,0.6153846153846154,0.0,0.0,0.20325946157371597,0.0001824238072664193,2,12,14
org.apache.xalan.processor.WhitespaceInfoPaths,4,8,12,0.6666666666666666,1,0.25,647,161.75,4,0.3333333333333333,0.0,0.0,0.12897239311573713,1.0727426812130574e-06,2,3,5
org.apache.xalan.xsltc.compiler.util.IntType,14,88,182,0.4835164835164835,1,0.07142857142857142,647,46.214285714285715,94,0.5164835164835165,0.016025641025641024,0.0011446886446886445,0.21360101298869133,0.00030255707181245535,8,13,21
org.apache.xalan.xsltc.compiler.util.NodeSetType,15,113,210,0.5380952380952381,1,0.06666666666666667,647,43.13333333333333,97,0.46190476190476193,0.0,0.0,0.2541218915837379,0.002967556226924258,15,14,29
org.apache.xalan.xpath.xml.FormatterToText,1,0,0,0,1,1.0,-1,-1.0,0,0,0.0,0.0,0.16665948073621126,0.0,1,0,1
org.apache.xml.utils.res.XResources_ja_JP_A,2,2,2,1.0,1,0.5,648,324.0,0,0.0,0.0,0.0,0.0,0.0,0,1,1
org.apache.xml.utils.res.XResources_hy,2,2,2,1.0,1,0.5,648,324.0,0,0.0,0.0,0.0,0.0,0.0,0,1,1
org.apache.xalan.templates.ElemValueOf,18,76,306,0.24836601307189543,1,0.05555555555555555,647,35.94444444444444,230,0.7516339869281046,0.0389093137254902,0.002161628540305011,0.17853149112798772,0.00011866267421500617,4,17,21
org.apache.xalan.xsltc.runtime.Parameter,2,1,2,0.5,1,0.5,647,323.5,1,0.5,0.0,0.0,0.136792183830346,0.0,2,1,3
org.apache.xalan.xsltc.compiler.FlowList,1,1,0,0,1,1.0,-1,-1.0,-1,0,0.0,0.0,0.2562945483974765,0.0,27,1,28
org.apache.xalan.res.XSLTErrorResources_fr,2,2,2,1.0,1,0.5,648,324.0,0,0.0,0.0,0.0,0.0,0.0,0,1,1
org.apache.xpath.axes.UnionChildIterator,5,8,20,0.4,1,0.2,647,129.4,12,0.6,0.0,0.0,0.18485262426824328,2.490492107719648e-05,1,4,5
org.apache.xalan.xpath.xml.ProblemListener,3,2,6,0.3333333333333333,1,0.3333333333333333,647,215.66666666666666,4,0.6666666666666666,0.0,0.0,0.15969816912272156,0.0,3,2,5
org.apache.xpath.functions.FuncExtFunction,16,61,240,0.25416666666666665,1,0.0625,647,40.4375,179,0.7458333333333333,0.11666666666666668,0.007291666666666668,0.1831483387735282,0.003975928250538135,12,15,27
org.apache.xalan.xsltc.dom.DOMWSFilter,9,22,72,0.3055555555555556,1,0.1111111111111111,647,71.88888888888889,50,0.6944444444444444,0.0,0.0,0.1586096713779708,0.00014686406321467508,2,8,10
org.apache.xpath.functions.FuncNormalizeSpace,8,24,56,0.42857142857142855,1,0.125,649,81.125,32,0.5714285714285714,0.0,0.0,0.0,0.0,0,7,7
org.apache.xalan.xsltc.compiler.FloorCall,5,7,20,0.35,1,0.2,648,129.6,13,0.65,0.0,0.0,0.0,0.0,0,4,4
org.apache.xalan.templates.KeyDeclaration,10,37,90,0.4111111111111111,1,0.1,647,64.7,53,0.5888888888888889,0.03819444444444444,0.003819444444444444,0.1861198954583821,0.0010908708030558296,6,9,15
org.apache.xml.utils.res.XResources_zh_CN,2,2,2,1.0,1,0.5,648,324.0,0,0.0,0.0,0.0,0.0,0.0,0,1,1
org.apache.xalan.xslt.XSLTEngineImpl,43,206,1806,0.11406423034330011,1,0.023255813953488372,647,15.046511627906977,1600,0.8859357696566998,0.12486173331121066,0.0029037612397955965,0.19268054471868462,0.06837560953553612,6,42,48
org.apache.xpath.operations.And,6,15,30,0.5,1,0.16666666666666666,647,107.83333333333333,15,0.5,0.0,0.0,0.17530362947177788,2.5512037310527805e-05,1,5,6
org.apache.xalan.templates.ElemApplyImport,10,34,90,0.37777777777777777,1,0.1,647,64.7,56,0.6222222222222222,0.0,0.0,0.149937529920081,2.9171232923527155e-05,2,9,11
org.apache.xpath.XPathContext,29,95,812,0.11699507389162561,1,0.034482758620689655,647,22.310344827586206,717,0.8830049261083743,0.16577380952380952,0.005716338259441707,0.3310815701324715,0.1711918503312085,155,28,183
org.apache.xalan.lib.sql.ConnectionPoolManager,5,8,20,0.4,1,0.2,649,129.8,12,0.6,0.0,0.0,0.002070393374741201,3.039437596770329e-06,2,4,6
org.apache.xalan.processor.XSLTSchema,60,191,3540,0.053954802259887004,1,0.016666666666666666,647,10.783333333333333,3349,0.946045197740113,0.15293200857198516,0.002548866809533086,0.17900234341228133,0.04840554646301183,3,59,62
org.apache.xalan.xsltc.compiler.util.ErrorMessages_no,3,3,6,0.5,1,0.3333333333333333,649,216.33333333333334,3,0.5,0.0,0.0,0.0,0.0,0,2,2
org.apache.xalan.xsltc.compiler.AncestorPattern,15,59,210,0.28095238095238095,1,0.06666666666666667,647,43.13333333333333,151,0.719047619047619,0.0,0.0,0.1667268500564749,1.430323574950743e-06,2,14,16
org.apache.xpath.patterns.ContextMatchStepPattern,9,26,72,0.3611111111111111,1,0.1111111111111111,647,71.88888888888889,46,0.6388888888888888,0.03571428571428571,0.003968253968253968,0.16601318029471665,9.280205352872989e-06,1,8,9
org.apache.xalan.xsltc.compiler.util.TypeCheckError,4,9,12,0.75,1,0.25,647,161.75,3,0.25,0.0,0.0,0.2739524596454356,0.0013487158427969307,88,3,91
org.apache.xalan.xsltc.compiler.NameCall,5,7,20,0.35,1,0.2,649,129.8,13,0.65,0.0,0.0,0.0,0.0,0,4,4
org.apache.xalan.xsltc.dom.NodeSortRecordFactory,9,29,72,0.4027777777777778,1,0.1111111111111111,651,72.33333333333333,43,0.5972222222222222,0.03571428571428571,0.003968253968253968,0.002070393374741201,0.0003566869415033416,2,8,10
org.apache.xpath.objects.XRTreeFrag,15,52,210,0.24761904761904763,1,0.06666666666666667,647,43.13333333333333,158,0.7523809523809524,0.0,0.0,0.1768260231276335,0.0012217446832300657,6,14,20
org.apache.xalan.xsltc.dom.CurrentNodeListIterator,5,8,20,0.4,1,0.2,649,129.8,12,0.6,0.0,0.0,0.0,0.0,0,4,4
org.apache.xpath.functions.FuncLang,6,12,30,0.4,1,0.16666666666666666,648,108.0,18,0.6,0.0,0.0,0.0,0.0,0,5,5
org.apache.xpath.functions.FuncUnparsedEntityURI,7,15,42,0.35714285714285715,1,0.14285714285714285,648,92.57142857142857,27,0.6428571428571429,0.0,0.0,0.0,0.0,0,6,6
org.apache.xalan.templates.ElemApplyTemplates,25,152,600,0.25333333333333335,1,0.04,647,25.88,448,0.7466666666666667,0.1568840579710145,0.00627536231884058,0.1781020473487601,0.0013972804948454399,3,24,27
org.apache.xalan.xsltc.dom.UnionIterator,5,11,20,0.55,1,0.2,649,129.8,9,0.45,0.0,0.0,0.0010351966873706005,1.430323574950743e-06,2,5,7
org.apache.xml.dtm.ref.dom2dtm.DOM2DTM,21,65,420,0.15476190476190477,1,0.047619047619047616,647,30.80952380952381,355,0.8452380952380952,0.06447368421052631,0.003070175438596491,0.17071068172833367,0.0058122830317419915,2,20,22
org.apache.xml.dtm.ref.DTMDocumentImpl,16,39,240,0.1625,1,0.0625,650,40.625,201,0.8375,0.0,0.0,0.0,0.0,0,15,15
org.apache.xalan.xsltc.compiler.EqualityExpr,21,153,420,0.36428571428571427,1,0.047619047619047616,647,30.80952380952381,267,0.6357142857142857,0.0,0.0,0.1257077731943016,7.713530707770079e-07,1,20,21
org.apache.xalan.xsltc.runtime.Constants,1,0,0,0,1,1.0,-1,-1.0,0,0,0.0,0.0,0.11935928303055457,0.0,3,0,3
org.apache.xalan.xsltc.compiler.ParentPattern,16,74,240,0.30833333333333335,1,0.0625,647,40.4375,166,0.6916666666666667,0.0,0.0,0.13965374871842937,7.949498575472156e-05,1,15,16
org.apache.xalan.xsltc.compiler.util.StringType,12,71,132,0.5378787878787878,1,0.08333333333333333,647,53.916666666666664,61,0.4621212121212121,0.0022727272727272726,0.0001893939393939394,0.2136570468326023,6.407666629522708e-05,18,11,29
org.apache.xml.utils.synthetic.reflection.Member,1,0,0,0,1,1.0,-1,-1.0,0,0,0.0,0.0,0.14013701916668886,0.0,4,0,4
org.apache.xalan.xsltc.runtime.MessageHandler,2,1,2,0.5,1,0.5,647,323.5,1,0.5,0.0,0.0,0.13693017191087425,0.0,2,1,3
org.apache.xalan.lib.sql.PooledConnection,1,0,0,0,1,1.0,-1,-1.0,0,0,0.0,0.0,0.0018633540372670805,0.0,1,0,1
org.apache.xalan.trace.EndSelectionEvent,7,17,42,0.40476190476190477,1,0.14285714285714285,647,92.42857142857143,25,0.5952380952380952,0.0,0.0,0.1564765922239923,0.0007099946558364242,3,6,9
org.apache.xalan.xsltc.compiler.util.ReferenceType,16,129,240,0.5375,1,0.0625,647,40.4375,111,0.4625,0.036111111111111115,0.0022569444444444447,0.2142190064507838,9.915103682029586e-05,19,15,34
org.apache.xalan.xsltc.cmdline.Transform,13,35,156,0.22435897435897437,1,0.07692307692307693,648,49.84615384615385,121,0.7756410256410257,0.0,0.0,0.0,0.0,0,12,12
org.apache.xalan.templates.VarNameCollector,6,12,30,0.4,1,0.16666666666666666,647,107.83333333333333,18,0.6,0.0,0.0,0.14778818046196335,1.4258752001961116e-06,1,5,6
org.apache.xml.utils.MutableAttrListImpl,3,3,6,0.5,1,0.3333333333333333,648,216.0,3,0.5,0.0,0.0,0.0010351966873706005,0.0006940645147448483,1,2,3
org.apache.xalan.xsltc.compiler.StartsWithCall,10,30,90,0.3333333333333333,1,0.1,648,64.8,60,0.6666666666666666,0.0,0.0,0.0,0.0,0,9,9
org.apache.xalan.xsltc.compiler.AttributeSet,16,78,240,0.325,1,0.0625,647,40.4375,162,0.675,0.23174603174603176,0.014484126984126985,0.21343308766401467,0.0033695613083377083,3,15,18
org.apache.xalan.extensions.ExpressionVisitor,8,15,56,0.26785714285714285,1,0.125,647,80.875,41,0.7321428571428571,0.0,0.0,0.14154686522868962,0.00012031645493436776,1,7,8
org.apache.xalan.xsltc.compiler.CompilerException,2,1,2,0.5,1,0.5,647,323.5,1,0.5,0.0,0.0,0.21382532489521658,0.0,2,1,3
org.apache.xalan.xsltc.compiler.Choose,15,76,210,0.3619047619047619,1,0.06666666666666667,647,43.13333333333333,134,0.638095238095238,0.0,0.0,0.20325946157371597,0.0024269075843193523,2,14,16
org.apache.xalan.transformer.TransformState,5,9,20,0.45,1,0.2,647,129.4,11,0.55,0.0,0.0,0.1354950361879687,0.0006940645147448482,2,4,6
org.apache.xalan.xsltc.compiler.ProcessingInstructionPattern,12,39,132,0.29545454545454547,1,0.08333333333333333,648,54.0,93,0.7045454545454546,0.0,0.0,0.0,0.0,0,11,11
org.apache.xml.utils.synthetic.reflection.EntryPoint,6,15,30,0.5,1,0.16666666666666666,647,107.83333333333333,15,0.5,0.0,0.0,0.13984558079084475,0.0003464958860318176,3,5,8
org.apache.xpath.operations.NotEquals,5,11,20,0.55,1,0.2,647,129.4,9,0.45,0.0,0.0,0.17534136975799355,1.595948675392572e-05,1,4,5
org.apache.xalan.extensions.XSLProcessorContext,24,82,552,0.14855072463768115,1,0.041666666666666664,648,27.0,470,0.8514492753623188,0.0,0.0,0.008281573498964804,0.0015811124726943608,8,23,31
org.apache.xpath.XPathVisitor,14,48,182,0.26373626373626374,1,0.07142857142857142,647,46.214285714285715,134,0.7362637362637363,0.6891025641025641,0.04922161172161172,0.3048131222027994,0.08365552977361079,30,13,43
org.apache.xalan.xsltc.compiler.LocalNameCall,5,7,20,0.35,1,0.2,649,129.8,13,0.65,0.0,0.0,0.0,0.0,0,4,4
org.apache.xalan.xsltc.cmdline.getopt.GetOptsException,2,1,2,0.5,1,0.5,648,324.0,1,0.5,0.0,0.0,0.0033126293995859217,0.0,3,1,4
org.apache.xalan.xsltc.dom.NodeCounter,6,12,30,0.4,1,0.16666666666666666,648,108.0,18,0.6,0.0,0.0,0.004658385093167702,6.436456087278344e-06,5,6,11
org.apache.xpath.functions.FuncExtElementAvailable,13,31,156,0.1987179487179487,1,0.07692307692307693,648,49.84615384615385,125,0.8012820512820513,0.0,0.0,0.0,0.0,0,12,12
org.apache.xml.dtm.FactoryFinder,4,6,12,0.5,1,0.25,647,161.75,6,0.5,0.0,0.0,0.21455760340513172,0.0009493772728735558,1,3,4
org.apache.xml.dtm.DTMAxisTraverser,1,0,0,0,1,1.0,-1,-1.0,0,0,0.0,0.0,0.23722700861550788,0.0,28,0,28
org.apache.xpath.axes.AttributeIterator,4,6,12,0.5,1,0.25,647,161.75,6,0.5,0.0,0.0,0.16604702599916002,0.0,1,3,4
org.apache.xalan.xsltc.compiler.CopyOf,16,95,240,0.3958333333333333,1,0.0625,647,40.4375,145,0.6041666666666666,0.0,0.0,0.14611780813166128,1.21067049632799e-05,1,15,16
org.apache.xalan.xsltc.compiler.Output,11,38,110,0.34545454545454546,1,0.09090909090909091,647,58.81818181818182,72,0.6545454545454545,0.07777777777777778,0.007070707070707071,0.21360101298869133,0.001613249440764144,2,10,12
org.apache.xpath.SourceTree,2,1,2,0.5,1,0.5,647,323.5,1,0.5,0.0,0.0,0.1951271352481744,0.0,1,1,2
org.apache.xalan.xsltc.compiler.util.CompareGenerator,6,16,30,0.5333333333333333,1,0.16666666666666666,647,107.83333333333333,14,0.4666666666666667,0.0,0.0,0.14176860966507918,3.707423556963695e-05,3,5,8
org.apache.xpath.axes.ChildIterator,6,12,30,0.4,1,0.16666666666666666,647,107.83333333333333,18,0.6,0.0,0.0,0.16604702599916002,6.6200573078726385e-06,1,5,6
org.apache.xml.utils.Trie,3,3,6,0.5,1,0.3333333333333333,647,215.66666666666666,3,0.5,0.5,0.16666666666666666,0.11926499670901741,0.0016445145302996173,2,2,4
org.apache.xalan.xpath.XPathSupportDefault,3,2,6,0.3333333333333333,1,0.3333333333333333,648,216.0,4,0.6666666666666666,0.0,0.0,0.0,0.0,0,2,2
org.apache.xpath.Arg,6,15,30,0.5,1,0.16666666666666666,647,107.83333333333333,15,0.5,0.0,0.0,0.15885716062529354,1.7690766338786743e-06,1,5,6
org.apache.xalan.xsltc.compiler.RealExpr,8,22,56,0.39285714285714285,1,0.125,648,81.0,34,0.6071428571428571,0.0,0.0,0.0,0.0,0,7,7
org.apache.xalan.trace.GenerateEvent,3,3,6,0.5,1,0.3333333333333333,647,215.66666666666666,3,0.5,0.5,0.16666666666666666,0.15888815109751853,0.00022373434490235313,4,2,6
org.apache.xml.dtm.ref.DTMNamedNodeMap,5,6,20,0.3,1,0.2,647,129.4,14,0.7,0.0,0.0,0.14551735975091654,0.0009504500155547689,1,4,5
org.apache.xml.serializer.SerializerBase,13,21,156,0.1346153846153846,1,0.07692307692307693,647,49.76923076923077,135,0.8653846153846154,0.0,0.0,0.16344785521289984,0.0018181444939400185,4,12,16
org.apache.xalan.xsltc.cmdline.getopt.MissingOptArgException,3,3,6,0.5,1,0.3333333333333333,649,216.33333333333334,3,0.5,0.0,0.0,0.0013802622498274672,5.363713406065287e-07,1,2,3
org.apache.xml.serializer.OutputPropertiesFactory,8,13,56,0.23214285714285715,1,0.125,648,81.0,43,0.7678571428571429,0.0,0.0,0.0,0.0,0,7,7
org.apache.xalan.xpath.XString,7,22,42,0.5238095238095238,1,0.14285714285714285,647,92.42857142857143,20,0.47619047619047616,0.0,0.0,0.15947927599880166,3.4169983868606267e-05,2,6,8
org.apache.xpath.axes.SelfIteratorNoPredicate,4,6,12,0.5,1,0.25,647,161.75,6,0.5,0.0,0.0,0.18075025799509098,0.0006387501637713568,3,3,6
org.apache.xalan.xsltc.dom.XSLTCDTMManager,12,34,132,0.25757575757575757,1,0.08333333333333333,647,53.916666666666664,98,0.7424242424242424,0.06969696969696969,0.005808080808080807,0.16279445583167698,0.0018115100085385513,10,12,22
org.apache.xalan.xsltc.trax.SAX2DOM,4,3,12,0.25,1,0.25,647,161.75,9,0.75,0.0,0.0,0.13667740602884376,0.0009483045301923428,1,3,4
org.apache.xalan.xsltc.compiler.util.MethodGenerator,6,13,30,0.43333333333333335,1,0.16666666666666666,647,107.83333333333333,17,0.5666666666666667,0.15000000000000002,0.025000000000000005,0.2781627945785109,0.001953990211338197,122,5,127
org.apache.xml.serializer.SerializationHandler,3,2,6,0.3333333333333333,1,0.3333333333333333,647,215.66666666666666,4,0.6666666666666666,0.0,0.0,0.21393765761121092,0.0006517163830381055,35,2,37
org.apache.xpath.functions.FuncBoolean,6,12,30,0.4,1,0.16666666666666666,648,108.0,18,0.6,0.0,0.0,0.0,0.0,0,5,5
org.apache.xpath.patterns.NodeTestFilter,2,1,2,0.5,1,0.5,0,0.0,1,0.5,0.0,0.0,0.0,0.0,0,1,1
org.apache.xalan.xsltc.compiler.LangCall,11,32,110,0.2909090909090909,1,0.09090909090909091,648,58.90909090909091,78,0.7090909090909091,0.0,0.0,0.0,0.0,0,10,10
org.apache.xalan.xsltc.dom.FilterIterator,4,5,12,0.4166666666666667,1,0.25,648,162.0,7,0.5833333333333334,0.0,0.0,0.0,0.0,0,3,3
org.apache.xalan.xsltc.compiler.RelativePathPattern,2,2,2,1.0,1,0.5,647,323.5,0,0.0,0.0,0.0,0.16755002314871012,6.89155904294449e-06,5,1,6
org.apache.xpath.axes.AxesWalker,17,75,272,0.2757352941176471,1,0.058823529411764705,647,38.05882352941177,197,0.7242647058823529,0.03423611111111111,0.002013888888888889,0.18998382610820622,0.00025526067130253894,8,17,25
org.apache.xpath.objects.GreaterThanOrEqualComparator,3,4,6,0.6666666666666666,1,0.3333333333333333,647,215.66666666666666,2,0.3333333333333333,0.0,0.0,0.1884889290733349,0.0,1,2,3
org.apache.xalan.xsltc.compiler.SimpleAttributeValue,8,18,56,0.32142857142857145,1,0.125,647,80.875,38,0.6785714285714286,0.14285714285714285,0.017857142857142856,0.15166865223945622,2.0802468308532034e-05,1,7,8
org.apache.xalan.xsltc.compiler.VariableRef,9,30,72,0.4166666666666667,1,0.1111111111111111,647,71.88888888888889,42,0.5833333333333334,0.0,0.0,0.14112990166797434,1.1978959940212475e-06,2,8,10
org.apache.xalan.xsltc.compiler.Message,9,31,72,0.4305555555555556,1,0.1111111111111111,648,72.0,41,0.5694444444444444,0.0,0.0,0.0,0.0,0,8,8
org.apache.xalan.xpath.xdom.XercesLiaison,9,15,72,0.20833333333333334,1,0.1111111111111111,648,72.0,57,0.7916666666666666,0.0,0.0,0.0,0.0,0,8,8
org.apache.xpath.compiler.PsuedoNames,1,0,0,0,1,1.0,-1,-1.0,0,0,0.0,0.0,0.19594290365961659,0.0,3,0,3
org.apache.xalan.transformer.TransformerHandlerImpl,11,31,110,0.2818181818181818,1,0.09090909090909091,647,58.81818181818182,79,0.7181818181818181,0.03333333333333333,0.0030303030303030303,0.16772254170631795,0.0033907521727969555,2,10,12
org.apache.xalan.templates.AVT,17,66,272,0.2426470588235294,1,0.058823529411764705,647,38.05882352941177,206,0.7573529411764706,0.2375,0.013970588235294117,0.16016925516733135,0.004762783669234021,11,16,27
org.apache.xpath.functions.FuncFalse,6,15,30,0.5,1,0.16666666666666666,648,108.0,15,0.5,0.0,0.0,0.0,0.0,0,5,5
org.apache.xalan.xsltc.compiler.LiteralElement,16,98,240,0.4083333333333333,1,0.0625,647,40.4375,142,0.5916666666666667,0.21904761904761907,0.013690476190476192,0.22132083220811957,0.0030405926825106196,5,15,20
org.apache.xpath.NodeSetDTM,11,31,110,0.2818181818181818,1,0.09090909090909091,647,58.81818181818182,79,0.7181818181818181,0.0,0.0,0.2986654428037697,0.001903325007828577,17,11,28
org.apache.xpath.compiler.Lexer,12,37,132,0.2803030303030303,1,0.08333333333333333,647,53.916666666666664,95,0.7196969696969697,0.013636363636363636,0.0011363636363636363,0.15195161614288807,6.915558234600135e-05,1,11,12
org.apache.xalan.templates.ElemExsltFunction,19,103,342,0.30116959064327486,1,0.05263157894736842,647,34.05263157894737,239,0.6988304093567251,0.0,0.0,0.15010332888423883,0.00020860306404747747,5,18,23
org.apache.xml.utils.XMLStringFactoryDefault,6,14,30,0.4666666666666667,1,0.16666666666666666,648,108.0,16,0.5333333333333333,0.0,0.0,0.0,0.0,0,5,5
org.apache.xml.dtm.ref.CoroutineParser,2,1,2,0.5,1,0.5,648,324.0,1,0.5,0.0,0.0,0.0,0.0,0,1,1
org.apache.xpath.operations.Variable,23,116,506,0.22924901185770752,1,0.043478260869565216,647,28.130434782608695,390,0.7707509881422925,0.10483405483405485,0.004558002384089341,0.23217236674055872,0.06016838649503352,8,22,30
org.apache.xml.dtm.ref.DTMManagerDefault,25,105,600,0.175,1,0.04,647,25.88,495,0.825,0.06461352657004832,0.0025845410628019326,0.19653973516551157,0.013934267792436103,10,24,34
org.apache.xalan.processor.ProcessorUnknown,4,6,12,0.5,1,0.25,647,161.75,6,0.5,0.0,0.0,0.14985476771405334,2.6431284034604564e-05,1,3,4
org.apache.xml.dtm.ref.ChunkedIntArray,4,4,12,0.3333333333333333,1,0.25,649,162.25,8,0.6666666666666666,0.0,0.0,0.0010351966873706005,1.787904468688429e-06,1,3,4
org.apache.xml.utils.ElemDesc,2,1,2,0.5,1,0.5,647,323.5,1,0.5,0.0,0.0,0.11910802318307692,0.0,1,1,2
org.apache.xalan.xpath.XObject,9,27,72,0.375,1,0.1111111111111111,647,71.88888888888889,45,0.625,0.30357142857142855,0.03373015873015873,0.4134318083887715,0.035543741035877825,105,9,114
org.apache.xalan.xsltc.Translet,4,7,12,0.5833333333333334,1,0.25,647,161.75,5,0.4166666666666667,0.0,0.0,0.16253455648091797,0.00045193355270514235,14,3,17
org.apache.xalan.xsltc.compiler.util.ObjectType,12,48,132,0.36363636363636365,1,0.08333333333333333,647,53.916666666666664,84,0.6363636363636364,0.18181818181818182,0.015151515151515152,0.21343308766401467,0.0043776833624874665,6,11,17
org.apache.xalan.xsltc.compiler.BinOpExpr,12,53,132,0.4015151515151515,1,0.08333333333333333,648,54.0,79,0.5984848484848485,0.0,0.0,0.0,0.0,0,11,11
org.apache.xpath.functions.Function,12,43,132,0.32575757575757575,1,0.08333333333333333,647,53.916666666666664,89,0.6742424242424242,0.1303030303030303,0.010858585858585859,0.24334050269670748,0.00472473040746361,16,11,27
org.apache.xalan.extensions.ExtensionHandlerJavaPackage,14,54,182,0.2967032967032967,1,0.07142857142857142,652,46.57142857142857,128,0.7032967032967034,0.0,0.0,0.0,0.0,0,13,13
org.apache.xml.utils.XMLStringFactory,4,7,12,0.5833333333333334,1,0.25,647,161.75,5,0.4166666666666667,0.0,0.0,0.3164182838095882,0.0003646521768761132,17,3,20
org.apache.xalan.templates.ElemComment,9,26,72,0.3611111111111111,1,0.1111111111111111,647,71.88888888888889,46,0.6388888888888888,0.0,0.0,0.149937529920081,0.00016950364727862804,2,8,10
org.apache.xpath.res.XPATHErrorResources,2,2,2,1.0,1,0.5,647,323.5,0,0.0,0.0,0.0,0.3120538936880766,0.0062631337297591695,41,2,43
org.apache.xpath.axes.MatchPatternIterator,11,36,110,0.32727272727272727,1,0.09090909090909091,647,58.81818181818182,74,0.6727272727272727,0.03703703703703704,0.0033670033670033673,0.16601318029471665,6.077228109365559e-05,1,10,11
org.apache.xpath.res.XPATHErrorResources_zh_TW,2,2,2,1.0,1,0.5,648,324.0,0,0.0,0.0,0.0,0.0,0.0,0,1,1
org.apache.xml.utils.synthetic.reflection.Method,6,15,30,0.5,1,0.16666666666666666,647,107.83333333333333,15,0.5,0.1,0.016666666666666666,0.1648038572492675,0.0009283071226870674,6,5,11
org.apache.xalan.templates.RedundentExprEliminator,36,175,1260,0.1388888888888889,1,0.027777777777777776,647,17.97222222222222,1085,0.8611111111111112,0.16575630252100843,0.004604341736694679,0.17602348444475469,0.008464849138845919,2,35,37
org.apache.xml.utils.TreeWalker,8,16,56,0.2857142857142857,1,0.125,647,80.875,40,0.7142857142857143,0.09523809523809523,0.011904761904761904,0.17860979441357017,0.00554153625464594,7,7,14
org.apache.xalan.lib.sql.SQLErrorDocument,4,6,12,0.5,1,0.25,652,163.0,6,0.5,0.0,0.0,0.0010351966873706005,1.8065961972247174e-05,1,3,4
org.apache.xml.res.XMLErrorResources_sv,2,2,2,1.0,1,0.5,648,324.0,0,0.0,0.0,0.0,0.0,0.0,0,1,1
org.apache.xalan.processor.ProcessorStylesheetDoc,2,1,2,0.5,1,0.5,647,323.5,1,0.5,0.0,0.0,0.14988234496243652,3.983103252818978e-05,1,1,2
org.apache.xalan.templates.ElemTemplateElement,27,107,702,0.15242165242165243,1,0.037037037037037035,647,23.962962962962962,595,0.8475783475783476,0.22243589743589745,0.008238366571699905,0.22198437245186153,0.05020262378224297,63,27,90
org.apache.xml.utils.IntStack,2,3,2,1.5,1,0.5,0,0.0,-1,-0.5,0.0,0.0,0.2611318415374161,3.464414225553554e-05,11,2,13
org.apache.xalan.lib.sql.ConnectionPool,2,1,2,0.5,1,0.5,648,324.0,1,0.5,0.0,0.0,0.004313319530710835,0.00011498149301272766,4,1,5
org.apache.xpath.NodeSet,9,19,72,0.2638888888888889,1,0.1111111111111111,649,72.11111111111111,53,0.7361111111111112,0.0,0.0,0.006211180124223602,0.0019371769004653248,7,9,16
org.apache.xalan.xsltc.compiler.Parser,25,168,600,0.28,1,0.04,647,25.88,432,0.72,0.3099005060961582,0.01239602024384633,0.2749698388000945,0.03783257729709576,87,24,111
org.apache.xalan.xsltc.compiler.Mode,26,138,650,0.2123076923076923,1,0.038461538461538464,647,24.884615384615383,512,0.7876923076923077,0.17698611111111112,0.00680715811965812,0.1794756858805377,0.006792255567276691,4,25,29
org.apache.xalan.lib.ExsltDynamic,14,45,182,0.24725274725274726,1,0.07142857142857142,651,46.5,137,0.7527472527472527,0.0,0.0,0.0013802622498274672,0.0001558290978930944,1,13,14
org.apache.xalan.templates.TemplateSubPatternAssociation,10,32,90,0.35555555555555557,1,0.1,647,64.7,58,0.6444444444444445,0.0,0.0,0.1492779806682331,5.1298142968625195e-05,3,10,13
org.apache.xalan.templates.AVTPartXPath,13,41,156,0.26282051282051283,1,0.07692307692307693,647,49.76923076923077,115,0.7371794871794872,0.0,0.0,0.1364255716123752,4.890362770727788e-05,1,12,13
org.apache.xpath.operations.UnaryOperation,8,24,56,0.42857142857142855,1,0.125,647,80.875,32,0.5714285714285714,0.04365079365079365,0.005456349206349206,0.3760206198180424,0.07815931295590167,6,7,13
org.apache.xalan.xslt.StylesheetRoot,15,52,210,0.24761904761904763,1,0.06666666666666667,647,43.13333333333333,158,0.7523809523809524,0.35485347985347987,0.02365689865689866,0.20310739713862344,0.021984082661760322,37,14,51
org.apache.xalan.processor.ProcessorGlobalParamDecl,6,12,30,0.4,1,0.16666666666666666,647,107.83333333333333,18,0.6,0.0,0.0,0.14985476771405334,2.6681153911757668e-05,1,5,6
org.apache.xalan.xsltc.compiler.util.NamedMethodGenerator,4,8,12,0.6666666666666666,1,0.25,647,161.75,4,0.3333333333333333,0.0,0.0,0.15024177504627925,1.0053015280357232e-06,1,3,4
org.apache.xpath.axes.DescendantIterator,13,41,156,0.26282051282051283,1,0.07692307692307693,647,49.76923076923077,115,0.7371794871794872,0.05681818181818182,0.004370629370629371,0.16662452179334697,0.0002162403519768544,2,12,14
org.apache.xalan.xpath.XBoolean,4,8,12,0.6666666666666666,1,0.25,647,161.75,4,0.3333333333333333,0.0,0.0,0.1598235209038226,0.00011670546367046628,3,3,6
org.apache.xalan.processor.ProcessorTemplate,6,12,30,0.4,1,0.16666666666666666,647,107.83333333333333,18,0.6,0.0,0.0,0.14985476771405334,2.6681153911757668e-05,1,5,6
org.apache.xpath.functions.FuncSubstringAfter,7,17,42,0.40476190476190477,1,0.14285714285714285,648,92.57142857142857,25,0.5952380952380952,0.0,0.0,0.0,0.0,0,6,6
org.apache.xalan.xsltc.compiler.IdPattern,3,4,6,0.6666666666666666,1,0.3333333333333333,647,215.66666666666666,2,0.3333333333333333,0.0,0.0,0.12927947024220318,0.0,1,2,3
org.apache.xml.utils.Context2,2,2,2,1.0,1,0.5,647,323.5,0,0.0,0.0,0.0,0.12301172972751548,0.0,2,2,4
org.apache.xalan.xsltc.compiler.AbsoluteLocationPath,11,48,110,0.43636363636363634,1,0.09090909090909091,647,58.81818181818182,62,0.5636363636363636,0.0,0.0,0.1257077731943016,1.7879044686884289e-07,1,10,11
org.apache.xpath.res.XPATHErrorResources_ja,2,2,2,1.0,1,0.5,648,324.0,0,0.0,0.0,0.0,0.0,0.0,0,1,1
org.apache.xalan.transformer.StackGuard,11,35,110,0.3181818181818182,1,0.09090909090909091,647,58.81818181818182,75,0.6818181818181818,0.023148148148148147,0.0021043771043771043,0.15938564824381213,5.032616196777742e-05,3,10,13
org.apache.xml.utils.DOMOrder,1,0,0,0,1,1.0,-1,-1.0,0,0,0.0,0.0,0.1430345429553115,0.0,1,0,1
org.apache.xml.serializer.EncodingInfo,2,1,2,0.5,1,0.5,647,323.5,1,0.5,0.0,0.0,0.1503804768326957,0.0,1,1,2
org.apache.xalan.xsltc.dom.EmptyFilter,2,1,2,0.5,1,0.5,0,0.0,1,0.5,0.0,0.0,0.0,0.0,0,1,1
org.apache.xpath.functions.FuncCeiling,6,13,30,0.43333333333333335,1,0.16666666666666666,648,108.0,17,0.5666666666666667,0.0,0.0,0.0,0.0,0,5,5
org.apache.xalan.templates.AVTPart,6,10,30,0.3333333333333333,1,0.16666666666666666,647,107.83333333333333,20,0.6666666666666666,0.0,0.0,0.13653992665982898,2.145485362426115e-06,3,5,8
org.apache.xalan.xsltc.runtime.Attributes,4,6,12,0.5,1,0.25,647,161.75,6,0.5,0.0,0.0,0.22994372177466968,0.0006167734503613417,10,3,13
org.apache.xalan.transformer.NodeSorter,7,18,42,0.42857142857142855,1,0.14285714285714285,647,92.42857142857143,24,0.5714285714285714,0.01111111111111111,0.001587301587301587,0.15149937919008186,0.0009669351558517563,2,6,8
org.apache.xpath.domapi.XPathResultImpl,11,34,110,0.3090909090909091,1,0.09090909090909091,652,59.27272727272727,76,0.6909090909090909,0.0,0.0,0.0015527950310559005,7.0657283463559386e-06,1,10,11
org.apache.xalan.templates.XUnresolvedVariableSimple,7,26,42,0.6190476190476191,1,0.14285714285714285,647,92.42857142857143,16,0.38095238095238093,0.0,0.0,0.12733906543556597,2.733655623624407e-06,1,6,7
org.apache.xalan.xsltc.compiler.BooleanExpr,9,26,72,0.3611111111111111,1,0.1111111111111111,647,71.88888888888889,46,0.6388888888888888,0.0,0.0,0.12574658986041068,1.0727426812130575e-07,1,8,9
org.apache.xalan.templates.AbsPathChecker,8,21,56,0.375,1,0.125,647,80.875,35,0.625,0.0,0.0,0.14778818046196335,0.0009600816756800883,1,7,8
org.apache.xpath.res.XPATHErrorResources_de,2,2,2,1.0,1,0.5,648,324.0,0,0.0,0.0,0.0,0.0,0.0,0,1,1
org.apache.xalan.extensions.ExtensionHandlerJava,3,3,6,0.5,1,0.3333333333333333,648,216.0,3,0.5,0.0,0.0,0.002070393374741201,1.0727426812130574e-06,2,2,4
org.apache.xalan.xsltc.trax.Util,6,11,30,0.36666666666666664,1,0.16666666666666666,647,107.83333333333333,19,0.6333333333333333,0.0,0.0,0.14251280184179876,0.0001822349552463506,2,5,7
org.apache.xpath.axes.OneStepIteratorForward,8,18,56,0.32142857142857145,1,0.125,647,80.875,38,0.6785714285714286,0.03571428571428571,0.004464285714285714,0.24436263502126612,0.007908734421234765,3,7,10
org.apache.xpath.objects.XNull,4,8,12,0.6666666666666666,1,0.25,647,161.75,4,0.3333333333333333,0.0,0.0,0.15814770146133592,0.0,2,3,5
org.apache.xalan.templates.ElemOtherwise,4,6,12,0.5,1,0.25,647,161.75,6,0.5,0.0,0.0,0.14988234496243652,3.3175819486144094e-07,1,3,4
org.apache.xpath.domapi.XPathExpressionImpl,13,36,156,0.23076923076923078,1,0.07692307692307693,654,50.30769230769231,120,0.7692307692307693,0.0,0.0,0.0013802622498274672,0.00018102452894080083,1,12,13
org.apache.xalan.trace.TraceListenerEx,2,1,2,0.5,1,0.5,647,323.5,1,0.5,0.0,0.0,0.15635643358147053,0.0,1,1,2
org.apache.xalan.xpath.xml.XMLParserLiaisonDefault,2,1,2,0.5,1,0.5,0,0.0,1,0.5,0.0,0.0,0.15971397703892834,1.0727426812130574e-06,2,1,3
org.apache.xpath.functions.FuncPosition,10,30,90,0.3333333333333333,1,0.1,647,64.7,60,0.6666666666666666,0.0,0.0,0.15393321915061045,1.3161861687265612e-05,1,9,10
org.apache.xpath.res.XPATHErrorResources_es,2,2,2,1.0,1,0.5,648,324.0,0,0.0,0.0,0.0,0.0,0.0,0,1,1
org.apache.xpath.res.XPATHErrorResources_en,2,2,2,1.0,1,0.5,648,324.0,0,0.0,0.0,0.0,0.0,0.0,0,1,1
org.apache.xalan.xsltc.runtime.output.OutputBuffer,2,2,2,1.0,1,0.5,648,324.0,0,0.0,0.0,0.0,0.002070393374741201,0.0,3,2,5
org.apache.xalan.extensions.ExtensionHandler,8,21,56,0.375,1,0.125,647,80.875,35,0.625,0.0,0.0,0.15161218587600148,0.001820720044679335,7,7,14
org.apache.xml.dtm.ref.NodeLocator,2,1,2,0.5,1,0.5,647,323.5,1,0.5,0.0,0.0,0.1768260231276335,0.0,1,1,2
org.apache.xml.dtm.DTMFilter,1,0,0,0,1,1.0,-1,-1.0,0,0,0.0,0.0,0.267113264609281,0.0,17,0,17
org.apache.xalan.extensions.ExtensionHandlerExsltFunction,20,102,380,0.26842105263157895,1,0.05,648,32.4,278,0.7315789473684211,0.0,0.0,0.0,0.0,0,19,19
org.apache.xalan.xsltc.compiler.NumberCall,8,18,56,0.32142857142857145,1,0.125,648,81.0,38,0.6785714285714286,0.0,0.0,0.0,0.0,0,7,7
org.apache.xalan.processor.ProcessorNamespaceAlias,6,12,30,0.4,1,0.16666666666666666,647,107.83333333333333,18,0.6,0.0,0.0,0.14985476771405334,6.731674345085633e-05,1,5,6
org.apache.xalan.xsltc.compiler.util.MultiHashtable,1,0,0,0,1,1.0,-1,-1.0,0,0,0.0,0.0,0.16464262538240473,0.0,2,0,2
org.apache.xpath.objects.LessThanOrEqualComparator,3,4,6,0.6666666666666666,1,0.3333333333333333,647,215.66666666666666,2,0.3333333333333333,0.0,0.0,0.1884889290733349,0.0,1,2,3
org.apache.xpath.res.XPATHErrorResources_fr,2,2,2,1.0,1,0.5,648,324.0,0,0.0,0.0,0.0,0.0,0.0,0,1,1
org.apache.xalan.templates.FuncDocument,14,37,182,0.2032967032967033,1,0.07142857142857142,647,46.214285714285715,145,0.7967032967032966,0.0,0.0,0.1415960818021349,0.0028842296312432975,1,13,14
org.apache.xpath.functions.FuncRound,6,13,30,0.43333333333333335,1,0.16666666666666666,648,108.0,17,0.5666666666666667,0.0,0.0,0.0,0.0,0,5,5
org.apache.xalan.transformer.XalanProperties,1,0,0,0,1,1.0,-1,-1.0,0,0,0.0,0.0,0.15679948840683108,0.0,2,0,2
org.apache.xalan.xsltc.runtime.Operators,1,0,0,0,1,1.0,-1,-1.0,0,0,0.0,0.0,0.12616663626676392,0.0,4,0,4
org.apache.xalan.trace.TraceListenerEx2,2,1,2,0.5,1,0.5,647,323.5,1,0.5,0.0,0.0,0.1564164898263645,0.0,2,1,3
org.apache.xalan.xsltc.compiler.Copy,11,46,110,0.41818181818181815,1,0.09090909090909091,648,58.90909090909091,64,0.5818181818181818,0.0,0.0,0.0,0.0,0,10,10
org.apache.xalan.xsltc.compiler.util.RtMethodGenerator,5,13,20,0.65,1,0.2,648,129.6,7,0.35,0.0,0.0,0.0,0.0,0,4,4
org.apache.xalan.xsltc.dom.StripWhitespaceFilter,2,2,2,1.0,1,0.5,648,324.0,0,0.0,0.0,0.0,0.0,0.0,0,1,1
org.apache.xalan.xsltc.compiler.UnaryOpExpr,11,46,110,0.41818181818181815,1,0.09090909090909091,648,58.90909090909091,64,0.5818181818181818,0.0,0.0,0.0,0.0,0,10,10
org.apache.xalan.xsltc.runtime.TransletLoader,3,4,6,0.6666666666666666,1,0.3333333333333333,647,215.66666666666666,2,0.3333333333333333,0.0,0.0,0.1867172541324805,8.982091954919168e-06,6,2,8
org.apache.xpath.ExpressionOwner,2,1,2,0.5,1,0.5,647,323.5,1,0.5,0.0,0.0,0.3053845753752831,0.0010261098855261146,39,1,40
org.apache.xml.dtm.ref.sax2dtm.SAX2DTM,23,71,506,0.14031620553359683,1,0.043478260869565216,647,28.130434782608695,435,0.8596837944664032,0.017316017316017316,0.0007528703180877094,0.21870587071049408,0.04693742948333859,6,22,28
org.apache.xalan.extensions.ExpressionContext,5,8,20,0.4,1,0.2,647,129.4,12,0.6,0.0,0.0,0.24554135137952365,0.0001650943483793598,14,4,18
org.apache.xalan.templates.ElemWhen,10,26,90,0.28888888888888886,1,0.1,647,64.7,64,0.7111111111111111,0.0,0.0,0.149937529920081,3.432832485873234e-05,2,9,11
org.apache.xalan.xsltc.dom.NodeIteratorBase,2,2,2,1.0,1,0.5,0,0.0,0,0.0,0.0,0.0,0.0,0.0,0,1,1
org.apache.xpath.XPath,23,108,506,0.2134387351778656,1,0.043478260869565216,647,28.130434782608695,398,0.7865612648221344,0.0,0.0,0.21638168504938363,0.010974525099235067,48,22,70
org.apache.xalan.transformer.MsgMgr,6,10,30,0.3333333333333333,1,0.16666666666666666,647,107.83333333333333,20,0.6666666666666666,0.1,0.016666666666666666,0.15922984604611534,9.790646861047946e-05,9,5,14
org.apache.xalan.transformer.NumeratorFormatter,6,9,30,0.3,1,0.16666666666666666,649,108.16666666666667,21,0.7,0.0,0.0,0.0,0.0,0,5,5
org.apache.xml.dtm.ref.sax2dtm.SAX2DTM2,16,45,240,0.1875,1,0.0625,647,40.4375,195,0.8125,0.0,0.0,0.14288783553085613,0.006000276761976692,24,15,39
org.apache.xalan.xslt.XSLProcessorContext,6,13,30,0.43333333333333335,1,0.16666666666666666,649,108.16666666666667,17,0.5666666666666667,0.0,0.0,0.002070393374741201,5.486277376647408e-05,2,5,7
org.apache.xalan.templates.FuncKey,12,33,132,0.25,1,0.08333333333333333,648,54.0,99,0.75,0.0,0.0,0.0,0.0,0,11,11
org.apache.xml.serializer.WriterToUTF8Buffered,2,1,2,0.5,1,0.5,647,323.5,1,0.5,0.0,0.0,0.11991470296317433,0.0,1,1,2
org.apache.xalan.xsltc.compiler.Instruction,9,36,72,0.5,1,0.1111111111111111,647,71.88888888888889,36,0.5,0.13541666666666666,0.015046296296296295,0.2292318217072558,0.002918237607336143,48,8,56
org.w3c.dom.xpath.XPathNSResolver,2,1,2,0.5,1,0.5,648,324.0,1,0.5,0.0,0.0,0.004140786749482402,0.0,4,1,5
org.apache.xalan.client.XSLTProcessorApplet,5,8,20,0.4,1,0.2,649,129.8,12,0.6,0.25,0.05,0.0010351966873706005,0.0006962100001072744,1,4,5
org.apache.xalan.xslt.Process,14,38,182,0.2087912087912088,1,0.07142857142857142,650,46.42857142857143,144,0.7912087912087912,0.0,0.0,0.0,0.0,0,13,13
org.apache.xalan.xslt.StylesheetHandler,5,11,20,0.55,1,0.2,647,129.4,9,0.45,0.0,0.0,0.1380207867354482,0.0012217656961492833,22,4,26
org.apache.xml.serializer.ExtendedLexicalHandler,2,1,2,0.5,1,0.5,647,323.5,1,0.5,0.0,0.0,0.13946244221333562,0.0,3,1,4
org.w3c.dom.xpath.XPathNamespace,1,0,0,0,1,1.0,-1,-1.0,0,0,0.0,0.0,0.0028755463538072236,0.0,2,0,2
org.apache.xalan.xsltc.compiler.LiteralAttribute,12,48,132,0.36363636363636365,1,0.08333333333333333,647,53.916666666666664,84,0.6363636363636364,0.0,0.0,0.17853149112798772,0.0001631414960574879,2,11,13
org.apache.xalan.xpath.XRTreeFrag,6,19,30,0.6333333333333333,1,0.16666666666666666,648,108.0,11,0.36666666666666664,0.0,0.0,0.0,0.0,0,5,5
org.apache.xalan.xsltc.compiler.AlternativePattern,10,32,90,0.35555555555555557,1,0.1,647,64.7,58,0.6444444444444445,0.0,0.0,0.15021406538655108,1.478283528388753e-06,1,9,10
org.apache.xalan.lib.ExsltBase,4,5,12,0.4166666666666667,1,0.25,648,162.0,7,0.5833333333333334,0.0,0.0,0.004140786749482401,0.00016054637567335832,4,3,7
org.apache.xalan.transformer.KeyManager,10,29,90,0.32222222222222224,1,0.1,647,64.7,61,0.6777777777777778,0.0,0.0,0.15879521593407683,0.0023531225193045785,2,9,11
org.apache.xalan.xsltc.compiler.Param,16,104,240,0.43333333333333335,1,0.0625,647,40.4375,136,0.5666666666666667,0.0880952380952381,0.005505952380952381,0.21540879728269768,0.0019716786502682977,8,15,23
org.apache.xml.utils.NodeConsumer,2,1,2,0.5,1,0.5,0,0.0,1,0.5,0.0,0.0,0.1654434812821165,1.609114021819586e-06,3,1,4
org.apache.xalan.xsltc.compiler.Otherwise,10,32,90,0.35555555555555557,1,0.1,647,64.7,58,0.6444444444444445,0.0,0.0,0.2032087481351996,5.064163162375247e-06,2,9,11
org.apache.xpath.XPathVisitable,2,1,2,0.5,1,0.5,647,323.5,1,0.5,0.0,0.0,0.23877474714918792,4.7642087355021415e-06,13,1,14
org.apache.xalan.transformer.KeyIterator,10,19,90,0.2111111111111111,1,0.1,647,64.7,71,0.7888888888888889,0.0,0.0,0.11822625381417913,7.1004039079216884e-06,2,9,11
org.apache.xpath.operations.Neg,6,16,30,0.5333333333333333,1,0.16666666666666666,647,107.83333333333333,14,0.4666666666666667,0.0,0.0,0.17530362947177788,1.1443237834977358e-05,1,5,6
org.apache.xml.dtm.ref.DTMNodeIterator,5,5,20,0.25,1,0.2,647,129.4,15,0.75,0.0,0.0,0.2110548490608655,0.0007753166643284985,7,4,11
org.apache.xpath.functions.FuncFloor,6,13,30,0.43333333333333335,1,0.16666666666666666,648,108.0,17,0.5666666666666667,0.0,0.0,0.0,0.0,0,5,5
org.apache.xalan.lib.ExsltCommon,8,14,56,0.25,1,0.125,656,82.0,42,0.75,0.0,0.0,0.0,0.0,0,7,7
org.apache.xalan.xsltc.compiler.ParentLocationPath,13,47,156,0.30128205128205127,1,0.07692307692307693,647,49.76923076923077,109,0.6987179487179487,0.002525252525252525,0.00019425019425019422,0.13970165738008233,1.5018397536982803e-06,2,12,14
org.apache.xpath.VariableStack,13,56,156,0.358974358974359,1,0.07692307692307693,647,49.76923076923077,100,0.6410256410256411,0.14299242424242425,0.01099941724941725,0.2502183295010384,0.09757940116470364,18,12,30
org.apache.xpath.axes.OneStepIterator,11,31,110,0.2818181818181818,1,0.09090909090909091,647,58.81818181818182,79,0.7181818181818181,0.05925925925925927,0.005387205387205388,0.22430753580993665,0.0014032959830093596,3,10,13
org.apache.xml.serializer.Encodings,4,5,12,0.4166666666666667,1,0.25,647,161.75,7,0.5833333333333334,0.0,0.0,0.17959441290537595,0.0009558380824633499,5,3,8
org.apache.xalan.xsltc.trax.TransformerHandlerImpl,11,35,110,0.3181818181818182,1,0.09090909090909091,647,58.81818181818182,75,0.6818181818181818,0.0,0.0,0.14253774282917048,0.0004541932405396024,2,10,12
org.apache.xml.serializer.Method,1,0,0,0,1,1.0,-1,-1.0,0,0,0.0,0.0,0.18269877722604358,0.0,7,0,7
org.apache.xalan.templates.ElemVariable,27,164,702,0.2336182336182336,1,0.037037037037037035,647,23.962962962962962,538,0.7663817663817664,0.33418131868131856,0.012377085877085872,0.21759568862566922,0.060146508874802454,21,27,48
org.apache.xml.serializer.ExtendedContentHandler,3,3,6,0.5,1,0.3333333333333333,647,215.66666666666666,3,0.5,0.0,0.0,0.19168290480722053,0.0002724796207203352,19,2,21
org.apache.xml.utils.res.XResources_ja_JP_HA,2,2,2,1.0,1,0.5,648,324.0,0,0.0,0.0,0.0,0.0,0.0,0,1,1
org.apache.xalan.templates.ElemUnknown,4,5,12,0.4166666666666667,1,0.25,647,161.75,7,0.5833333333333334,0.0,0.0,0.14988234496243652,1.2878805194693789e-05,1,3,4
org.apache.xml.utils.res.XResources_ja_JP_HI,2,2,2,1.0,1,0.5,648,324.0,0,0.0,0.0,0.0,0.0,0.0,0,1,1
org.apache.xpath.XPathAPI,9,22,72,0.3055555555555556,1,0.1111111111111111,647,71.88888888888889,50,0.6944444444444444,0.0,0.0,0.15960428424963352,0.0005839762308167516,2,8,10
org.apache.xalan.xsltc.compiler.SymbolTable,14,61,182,0.33516483516483514,1,0.07142857142857142,647,46.214285714285715,121,0.6648351648351648,0.23237179487179485,0.016597985347985348,0.27432154345768944,0.029767072563424854,88,13,101
org.apache.xpath.compiler.FuncLoader,3,2,6,0.3333333333333333,1,0.3333333333333333,647,215.66666666666666,4,0.6666666666666666,0.0,0.0,0.17625203690237612,0.0,2,2,4
org.apache.xalan.res.XSLMessages,3,3,6,0.5,1,0.3333333333333333,647,215.66666666666666,3,0.5,0.0,0.0,0.3224309827893428,6.876880575485474e-05,68,2,70
org.apache.xalan.xsltc.compiler.GenerateIdCall,5,7,20,0.35,1,0.2,648,129.6,13,0.65,0.0,0.0,0.0,0.0,0,4,4
org.apache.xalan.trace.TracerEvent,7,16,42,0.38095238095238093,1,0.14285714285714285,647,92.42857142857143,26,0.6190476190476191,0.0,0.0,0.15662705048574613,0.0009331010050632363,4,6,10
org.apache.xpath.operations.Div,6,16,30,0.5333333333333333,1,0.16666666666666666,647,107.83333333333333,14,0.4666666666666667,0.0,0.0,0.17537912629756244,1.7864579865270404e-05,2,5,7
org.apache.xalan.xsltc.compiler.Sort,29,170,812,0.20935960591133004,1,0.034482758620689655,647,22.310344827586206,642,0.7906403940886699,0.030222863556196893,0.0010421677088343756,0.16648827933889615,0.0050809736028895195,2,28,30
org.apache.xalan.templates.ElemElement,18,63,306,0.20588235294117646,1,0.05555555555555555,647,35.94444444444444,243,0.7941176470588235,0.0,0.0,0.15002038359290476,7.843649329178796e-05,3,17,20
org.apache.xpath.axes.HasPositionalPredChecker,18,46,306,0.1503267973856209,1,0.05555555555555555,647,35.94444444444444,260,0.8496732026143791,0.0,0.0,0.18481067903922851,0.003279350242973132,1,17,18
org.apache.xalan.xsltc.compiler.util.NodeCounterGenerator,5,10,20,0.5,1,0.2,647,129.4,10,0.5,0.0,0.0,0.1884889290733349,3.286682195925032e-05,1,4,5
org.apache.xpath.functions.WrongNumberArgsException,2,1,2,0.5,1,0.5,647,323.5,1,0.5,0.0,0.0,0.20412547932979447,4.357910370871565e-06,12,1,13
org.apache.xalan.xslt.EnvironmentCheck,5,7,20,0.35,1,0.2,648,129.6,13,0.65,0.0,0.0,0.0013802622498274672,1.8236625580621976e-05,1,4,5
org.apache.xalan.xsltc.dom.DOMBuilder,1,0,0,0,1,1.0,-1,-1.0,0,0,0.0,0.0,0.1388262137152998,0.0,2,0,2
org.apache.xalan.processor.ProcessorLRE,19,68,342,0.19883040935672514,1,0.05263157894736842,647,34.05263157894737,274,0.8011695906432749,0.0,0.0,0.14985476771405334,5.132086221510699e-05,1,18,19
org.apache.xpath.axes.FilterExprIterator,9,16,72,0.2222222222222222,1,0.1111111111111111,649,72.11111111111111,56,0.7777777777777778,0.10714285714285714,0.011904761904761904,0.0010351966873706005,0.0002578111749635605,1,8,9
org.apache.xpath.res.XPATHMessages,4,6,12,0.5,1,0.25,647,161.75,6,0.5,0.0,0.0,0.31098154353794577,0.0005651611385300365,32,3,35
org.apache.xpath.Expression,14,52,182,0.2857142857142857,1,0.07142857142857142,647,46.214285714285715,130,0.7142857142857143,0.1858974358974359,0.013278388278388278,0.3029987583801637,0.01030482968423323,34,13,47
