name,Size,Ties,Pairs,Density,WeakComp,nWeakComp,2StepReach,ReachEffic,Broker,nBroker,EgoBetween,nEgoBetween,Closeness_Centrality,Betweenness_Centrality,in_degree,out_degree,degree
org.xml.sax.SAXException,1,0,0,0,1,1.0,-1,-1.0,0,0,0.0,0.0,0.09473957560468912,0.0,44,0,44
org.apache.xerces.parsers.DOMParser,41,171,1640,0.10426829268292682,1,0.024390243902439025,266,6.487804878048781,1469,0.8957317073170732,0.0,0.0,0.025420736730610804,0.006081892973246785,9,40,49
org.apache.xerces.dom.RangeExceptionImpl,2,1,2,0.5,1,0.5,0,0.0,1,0.5,0.0,0.0,0.08389646727109909,0.0,1,1,2
org.apache.html.dom.HTMLIFrameElementImpl,4,5,12,0.4166666666666667,1,0.25,117,29.25,7,0.5833333333333334,0.0,0.0,0.0,0.0,0,3,3
org.apache.xerces.dom.ChildAndParentNode,16,58,240,0.24166666666666667,1,0.0625,87,5.4375,182,0.7583333333333333,0.08174603174603175,0.005109126984126984,0.11157320022592217,0.006236254920949071,6,15,21
org.apache.xerces.validators.datatype.DatatypeValidator,1,0,0,0,1,1.0,-1,-1.0,0,0,0.0,0.0,0.05590676388457959,0.0,24,0,24
org.w3c.dom.events.DocumentEvent,2,1,2,0.5,1,0.5,16,8.0,1,0.5,0.0,0.0,0.10832346590513339,0.0,1,1,2
org.apache.html.dom.HTMLTitleElementImpl,7,12,42,0.2857142857142857,1,0.14285714285714285,115,16.428571428571427,30,0.7142857142857143,0.2,0.028571428571428574,0.047358862761060834,0.00015859819614085836,1,6,7
org.apache.wml.dom.WMLSmallElementImpl,4,6,12,0.5,1,0.25,161,40.25,6,0.5,0.3333333333333333,0.08333333333333333,0.032002431156201785,0.0001079315072489134,1,3,4
org.apache.html.dom.HTMLButtonElementImpl,5,6,20,0.3,1,0.2,117,23.4,14,0.7,0.0,0.0,0.0,0.0,0,4,4
org.apache.xerces.utils.regex.REUtil,4,7,12,0.5833333333333334,1,0.25,28,7.0,5,0.4166666666666667,0.3333333333333333,0.08333333333333333,0.037285386759763436,0.00028655328996625933,7,3,10
org.apache.xerces.dom.ParentNode,17,74,272,0.27205882352941174,1,0.058823529411764705,87,5.117647058823529,198,0.7279411764705882,0.06319444444444444,0.0037173202614379083,0.12135731163034917,0.009297441236489156,8,16,24
javax.xml.parsers.DocumentBuilderFactory,4,4,12,0.3333333333333333,1,0.25,22,5.5,8,0.6666666666666666,0.0,0.0,0.0017064846416382253,2.917067763484146e-06,2,4,6
org.apache.xerces.utils.regex.RangeToken,3,8,6,1.3333333333333333,1,0.3333333333333333,28,9.333333333333334,-2,-0.3333333333333333,0.0,0.0,0.03742824264773188,0.00012212790369786953,7,3,10
org.apache.xerces.validators.common.CMException,1,0,0,0,1,1.0,-1,-1.0,0,0,0.0,0.0,0.03830996636138189,0.0,11,0,11
org.apache.xerces.readers.XMLEntityHandler,3,2,6,0.3333333333333333,1,0.3333333333333333,2,0.6666666666666666,4,0.6666666666666666,0.0,0.0,0.061797124153751465,0.00018722713261962412,22,2,24
org.apache.xerces.dom.NamedNodeMapImpl,7,21,42,0.5,1,0.14285714285714285,87,12.428571428571429,21,0.5,0.0,0.0,0.10152156056592918,4.4371841868997724e-05,7,7,14
org.apache.wml.dom.WMLStrongElementImpl,4,6,12,0.5,1,0.25,161,40.25,6,0.5,0.3333333333333333,0.08333333333333333,0.032002431156201785,0.0001079315072489134,1,3,4
org.apache.xerces.utils.Base64,1,0,0,0,1,1.0,-1,-1.0,0,0,0.0,0.0,0.024932405478480562,0.0,1,0,1
org.xml.sax.Attributes,1,0,0,0,1,1.0,-1,-1.0,0,0,0.0,0.0,0.04502494092937778,0.0,15,0,15
org.apache.xerces.readers.CharReader,6,11,30,0.36666666666666664,1,0.16666666666666666,19,3.1666666666666665,19,0.6333333333333333,0.0,0.0,0.026625426621160412,0.00024503369213266826,1,5,6
org.apache.xerces.framework.XMLDocumentHandler,2,2,2,1.0,1,0.5,0,0.0,0,0.0,0.0,0.0,0.03497637175111578,4.959015197923048e-06,4,1,5
org.apache.html.dom.HTMLObjectElementImpl,5,6,20,0.3,1,0.2,116,23.2,14,0.7,0.0,0.0,0.0,0.0,0,4,4
org.apache.wml.WMLCardElement,1,0,0,0,1,1.0,-1,-1.0,0,0,0.0,0.0,0.02219967407680718,0.0,1,0,1
org.apache.xerces.readers.DefaultReaderFactory,13,35,156,0.22435897435897437,1,0.07692307692307693,34,2.6153846153846154,121,0.7756410256410257,0.0,0.0,0.032343465918152535,0.0017910796067792656,1,12,13
org.w3c.dom.NamedNodeMap,2,3,2,1.5,1,0.5,12,6.0,-1,-0.5,0.0,0.0,0.18685892603405657,4.9541534183172406e-05,36,1,37
org.apache.xerces.validators.common.XMLElementDecl,3,4,6,0.6666666666666666,1,0.3333333333333333,1,0.3333333333333333,2,0.3333333333333333,0.0,0.0,0.04761181494916284,6.257110352673492e-05,9,3,12
org.apache.html.dom.HTMLOListElementImpl,4,5,12,0.4166666666666667,1,0.25,117,29.25,7,0.5833333333333334,0.0,0.0,0.0,0.0,0,3,3
org.apache.xerces.validators.schema.XUtil,9,29,72,0.4027777777777778,1,0.1111111111111111,88,9.777777777777779,43,0.5972222222222222,0.0,0.0,0.02540183423265392,0.0005072410419395632,3,8,11
org.apache.xerces.readers.UTF8Recognizer,10,23,90,0.25555555555555554,1,0.1,26,2.6,67,0.7444444444444445,0.05555555555555555,0.005555555555555555,0.03368473551932875,0.0004025553513608121,1,9,10
org.apache.html.dom.HTMLIsIndexElementImpl,4,5,12,0.4166666666666667,1,0.25,117,29.25,7,0.5833333333333334,0.0,0.0,0.0,0.0,0,3,3
org.apache.xerces.framework.XMLParser,27,79,702,0.11253561253561253,1,0.037037037037037035,266,9.851851851851851,623,0.8874643874643875,0.008846153846153846,0.0003276353276353276,0.03914343531970159,0.02699203316381928,14,26,40
org.w3c.dom.html.HTMLBodyElement,1,0,0,0,1,1.0,-1,-1.0,0,0,0.0,0.0,0.048650325783431585,0.0,2,0,2
org.apache.html.dom.HTMLFormControl,1,0,0,0,1,1.0,-1,-1.0,0,0,0.0,0.0,0.03721052752135969,0.0,8,0,8
org.apache.xerces.validators.datatype.BooleanDatatypeValidator,8,9,56,0.16071428571428573,1,0.125,37,4.625,47,0.8392857142857143,0.0,0.0,0.03014422547616426,0.0007277575792934163,1,7,8
org.apache.xerces.readers.StreamingCharReader,14,24,182,0.13186813186813187,1,0.07142857142857142,18,1.2857142857142858,158,0.8681318681318682,0.0,0.0,0.0,0.0,0,13,13
org.apache.xml.serialize.OutputFormat,8,8,56,0.14285714285714285,1,0.125,20,2.5,48,0.8571428571428571,0.0,0.0,0.03063856394758096,0.001797837480431337,13,7,20
org.w3c.dom.html.HTMLFrameSetElement,1,0,0,0,1,1.0,-1,-1.0,0,0,0.0,0.0,0.048650325783431585,0.0,2,0,2
org.w3c.dom.html.HTMLLIElement,1,0,0,0,1,1.0,-1,-1.0,0,0,0.0,0.0,0.0017064846416382253,0.0,1,0,1
org.apache.xerces.validators.dtd.DTDGrammar,13,32,156,0.20512820512820512,1,0.07692307692307693,266,20.46153846153846,124,0.7948717948717948,0.0,0.0,0.028629179230590808,0.004537982768927024,2,12,14
javax.xml.parsers.SAXParser,5,7,20,0.35,1,0.2,11,2.2,13,0.65,0.0,0.0,0.005119453924914676,3.660920043172602e-05,3,4,7
org.apache.wml.WMLOneventElement,1,0,0,0,1,1.0,-1,-1.0,0,0,0.0,0.0,0.02219967407680718,0.0,1,0,1
org.apache.xerces.validators.datatype.IDREFDatatypeValidator,8,9,56,0.16071428571428573,1,0.125,8,1.0,47,0.8392857142857143,0.0,0.0,0.03014422547616426,3.376063956268734e-05,1,7,8
org.w3c.dom.Element,3,3,6,0.5,1,0.3333333333333333,12,4.0,3,0.5,0.5,0.16666666666666666,0.2095850116327932,0.0002733882853336782,33,2,35
org.apache.xerces.dom.NotationImpl,6,14,30,0.4666666666666667,1,0.16666666666666666,87,14.5,16,0.5333333333333333,0.0,0.0,0.1106342953151851,0.00011368966431537547,4,5,9
org.apache.xml.serialize.TextSerializer,10,17,90,0.18888888888888888,1,0.1,40,4.0,73,0.8111111111111111,0.0,0.0,0.0022753128555176336,3.5539608918448514e-05,1,9,10
org.apache.xerces.validators.common.ContentLeafNameTypeVector,2,3,2,1.5,1,0.5,0,0.0,-1,-0.5,0.0,0.0,0.03168591169090628,0.0,6,2,8
org.apache.wml.dom.WMLBrElementImpl,4,6,12,0.5,1,0.25,161,40.25,6,0.5,0.3333333333333333,0.08333333333333333,0.032002431156201785,0.0001079315072489134,1,3,4
org.w3c.dom.html.HTMLStyleElement,1,0,0,0,1,1.0,-1,-1.0,0,0,0.0,0.0,0.0017064846416382253,0.0,1,0,1
org.w3c.dom.html.HTMLBRElement,1,0,0,0,1,1.0,-1,-1.0,0,0,0.0,0.0,0.0017064846416382253,0.0,1,0,1
org.apache.html.dom.HTMLLabelElementImpl,5,6,20,0.3,1,0.2,117,23.4,14,0.7,0.0,0.0,0.0,0.0,0,4,4
org.apache.html.dom.HTMLUListElementImpl,4,5,12,0.4166666666666667,1,0.25,117,29.25,7,0.5833333333333334,0.0,0.0,0.0,0.0,0,3,3
org.apache.xerces.validators.datatype.TimeDurationDatatypeValidator,8,9,56,0.16071428571428573,1,0.125,37,4.625,47,0.8392857142857143,0.0,0.0,0.03014422547616426,0.0007277575792934163,1,7,8
org.apache.xerces.utils.URI,2,2,2,1.0,1,0.5,0,0.0,0,0.0,0.0,0.0,0.03424492169924169,0.0,3,2,5
org.apache.html.dom.HTMLOptGroupElementImpl,4,5,12,0.4166666666666667,1,0.25,117,29.25,7,0.5833333333333334,0.0,0.0,0.0,0.0,0,3,3
org.w3c.dom.html.HTMLTitleElement,1,0,0,0,1,1.0,-1,-1.0,0,0,0.0,0.0,0.048650325783431585,0.0,2,0,2
org.apache.xerces.validators.datatype.DatatypeValidatorFactoryImpl,20,74,380,0.19473684210526315,1,0.05,103,5.15,306,0.8052631578947368,0.0,0.0,0.03853329091224619,0.011237590307556177,6,20,26
org.w3c.dom.events.EventListener,2,1,2,0.5,1,0.5,15,7.5,1,0.5,0.0,0.0,0.09450086274390568,4.6673084215746334e-05,4,1,5
org.apache.wml.WMLBigElement,1,0,0,0,1,1.0,-1,-1.0,0,0,0.0,0.0,0.02219967407680718,0.0,1,0,1
org.apache.xerces.utils.StringHasher,1,0,0,0,1,1.0,-1,-1.0,0,0,0.0,0.0,0.0984966144765435,0.0,6,0,6
org.apache.html.dom.HTMLHtmlElementImpl,4,7,12,0.5833333333333334,1,0.25,115,28.75,5,0.4166666666666667,0.0,0.0,0.047358862761060834,0.0,1,3,4
org.xml.sax.ext.LexicalHandler,1,0,0,0,1,1.0,-1,-1.0,0,0,0.0,0.0,0.029777249291990413,0.0,3,0,3
org.apache.xml.serialize.LineSeparator,1,0,0,0,1,1.0,-1,-1.0,0,0,0.0,0.0,0.02579362245990832,0.0,1,0,1
org.xml.sax.helpers.AttributesImpl,2,1,2,0.5,1,0.5,0,0.0,1,0.5,0.0,0.0,0.023383451711096764,1.0452826152484857e-05,3,1,4
org.xml.sax.helpers.ParserAdapter,20,43,380,0.11315789473684211,1,0.05,20,1.0,337,0.8868421052631579,0.04678362573099415,0.0023391812865497076,0.0038395904436860067,0.00010234046070223546,2,19,21
org.w3c.dom.html.HTMLParagraphElement,1,0,0,0,1,1.0,-1,-1.0,0,0,0.0,0.0,0.0017064846416382253,0.0,1,0,1
org.apache.wml.WMLMetaElement,1,0,0,0,1,1.0,-1,-1.0,0,0,0.0,0.0,0.02219967407680718,0.0,1,0,1
org.apache.xerces.dom.AttrImpl,13,39,156,0.25,1,0.07692307692307693,87,6.6923076923076925,117,0.75,0.04166666666666667,0.0032051282051282055,0.1172098849327295,0.0006680610292669439,11,12,23
org.w3c.dom.CharacterData,1,0,0,0,1,1.0,-1,-1.0,0,0,0.0,0.0,0.12081600522044468,0.0,13,0,13
org.apache.wml.WMLStrongElement,1,0,0,0,1,1.0,-1,-1.0,0,0,0.0,0.0,0.02219967407680718,0.0,1,0,1
org.apache.xerces.validators.common.Grammar,22,70,462,0.15151515151515152,1,0.045454545454545456,266,12.090909090909092,392,0.8484848484848485,0.0,0.0,0.03552777663555245,0.005548408739535021,9,21,30
org.w3c.dom.events.Event,3,4,6,0.6666666666666666,1,0.3333333333333333,15,5.0,2,0.3333333333333333,0.5,0.16666666666666666,0.11467807397841527,0.00032331760431874136,7,2,9
org.apache.xerces.validators.datatype.XMLException,1,0,0,0,1,1.0,-1,-1.0,0,0,0.0,0.0,0.034299512906325595,0.0,2,0,2
org.apache.xml.serialize.SerializerFactoryImpl,9,24,72,0.3333333333333333,1,0.1111111111111111,46,5.111111111111111,48,0.6666666666666666,0.07142857142857142,0.007936507936507936,0.0017064846416382253,6.106395184893479e-05,1,8,9
org.apache.wml.dom.WMLOptionElementImpl,4,6,12,0.5,1,0.25,161,40.25,6,0.5,0.3333333333333333,0.08333333333333333,0.032002431156201785,0.0001079315072489134,1,3,4
org.apache.xerces.validators.datatype.InvalidDatatypeValueException,2,1,2,0.5,1,0.5,0,0.0,1,0.5,0.0,0.0,0.04096080256489813,0.0001239753799480762,17,1,18
org.apache.wml.WMLPrevElement,1,0,0,0,1,1.0,-1,-1.0,0,0,0.0,0.0,0.02219967407680718,0.0,1,0,1
org.w3c.dom.html.HTMLUListElement,1,0,0,0,1,1.0,-1,-1.0,0,0,0.0,0.0,0.0017064846416382253,0.0,1,0,1
org.apache.html.dom.HTMLDListElementImpl,4,5,12,0.4166666666666667,1,0.25,117,29.25,7,0.5833333333333334,0.0,0.0,0.0,0.0,0,3,3
org.apache.xerces.dom.DocumentTypeImpl,7,21,42,0.5,1,0.14285714285714285,87,12.428571428571429,21,0.5,0.06666666666666667,0.009523809523809523,0.11317396350032563,0.00017090526585582163,6,6,12
org.w3c.dom.html.HTMLCollection,2,2,2,1.0,1,0.5,13,6.5,0,0.0,0.0,0.0,0.061985112392609155,0.000659410113335028,15,1,16
org.apache.xerces.dom.TreeWalkerImpl,4,7,12,0.5833333333333334,1,0.25,15,3.75,5,0.4166666666666667,0.0,0.0,0.10832346590513339,0.0,1,3,4
org.apache.wml.dom.WMLOptgroupElementImpl,4,6,12,0.5,1,0.25,161,40.25,6,0.5,0.3333333333333333,0.08333333333333333,0.032002431156201785,0.0001079315072489134,1,3,4
org.apache.xml.serialize.Method,1,0,0,0,1,1.0,-1,-1.0,0,0,0.0,0.0,0.02612150749117834,0.0,7,0,7
org.apache.wml.WMLSetvarElement,1,0,0,0,1,1.0,-1,-1.0,0,0,0.0,0.0,0.02219967407680718,0.0,1,0,1
org.apache.html.dom.HTMLFieldSetElementImpl,5,6,20,0.3,1,0.2,117,23.4,14,0.7,0.0,0.0,0.0,0.0,0,4,4
org.apache.xerces.dom.EntityReferenceImpl,11,44,110,0.4,1,0.09090909090909091,87,7.909090909090909,66,0.6,0.0,0.0,0.11032482875486288,1.3199731629765759e-05,3,10,13
org.apache.xerces.dom.ElementImpl,18,76,306,0.24836601307189543,1,0.05555555555555555,87,4.833333333333333,230,0.7516339869281046,0.1216299019607843,0.006757216775599127,0.13324704824278202,0.0055929785900469394,12,17,29
org.w3c.dom.html.HTMLAnchorElement,1,0,0,0,1,1.0,-1,-1.0,0,0,0.0,0.0,0.034652303754266214,0.0,2,0,2
org.apache.xerces.dom.TextImpl,8,17,56,0.30357142857142855,1,0.125,87,10.875,39,0.6964285714285714,0.07142857142857142,0.008928571428571428,0.11157320022592217,0.0006066152180617923,8,7,15
org.apache.xerces.validators.schema.SchemaGrammar,12,39,132,0.29545454545454547,1,0.08333333333333333,266,22.166666666666668,93,0.7045454545454546,0.004545454545454545,0.0003787878787878788,0.029886541831934323,0.006313118053732388,3,11,14
org.xml.sax.helpers.XMLFilterImpl,15,29,210,0.1380952380952381,1,0.06666666666666667,13,0.8666666666666667,181,0.861904761904762,0.0,0.0,0.0,0.0,0,14,14
org.apache.xerces.utils.XMLMessages,2,1,2,0.5,1,0.5,0,0.0,1,0.5,0.0,0.0,0.04513017234084563,4.5280847328628906e-05,16,1,17
org.apache.wml.dom.WMLTimerElementImpl,4,6,12,0.5,1,0.25,161,40.25,6,0.5,0.3333333333333333,0.08333333333333333,0.032002431156201785,0.0001079315072489134,1,3,4
org.xml.sax.helpers.DefaultHandler,10,15,90,0.16666666666666666,1,0.1,8,0.8,75,0.8333333333333334,0.0,0.0,0.0034129692832764505,2.041947434438902e-05,2,9,11
org.w3c.dom.html.HTMLTableSectionElement,3,2,6,0.3333333333333333,1,0.3333333333333333,15,5.0,4,0.6666666666666666,0.0,0.0,0.03587883959044368,0.0,5,2,7
org.apache.xerces.dom.ChildNode,4,12,12,1.0,1,0.25,87,21.75,0,0.0,0.0,0.0,0.11549378120018589,5.832034098420727e-05,9,4,13
org.apache.html.dom.HTMLAnchorElementImpl,4,5,12,0.4166666666666667,1,0.25,116,29.0,7,0.5833333333333334,0.0,0.0,0.0,0.0,0,3,3
org.apache.wml.dom.WMLDocumentImpl,42,115,1722,0.06678281068524972,1,0.023809523809523808,161,3.8333333333333335,1607,0.9332171893147503,0.8567073170731707,0.02039779326364692,0.06313993174061433,0.014783018776192838,37,41,78
org.apache.xerces.utils.UTF8DataChunk,6,8,30,0.26666666666666666,1,0.16666666666666666,7,1.1666666666666667,22,0.7333333333333333,0.0,0.0,0.022753128555176336,8.751203290452438e-06,2,6,8
org.apache.wml.WMLDocument,1,0,0,0,1,1.0,-1,-1.0,0,0,0.0,0.0,0.03285551763367463,0.0,1,0,1
org.apache.html.dom.HTMLDirectoryElementImpl,4,5,12,0.4166666666666667,1,0.25,117,29.25,7,0.5833333333333334,0.0,0.0,0.0,0.0,0,3,3
org.w3c.dom.range.RangeException,1,0,0,0,1,1.0,-1,-1.0,0,0,0.0,0.0,0.084764404314454,0.0,3,0,3
org.w3c.dom.html.HTMLHeadElement,1,0,0,0,1,1.0,-1,-1.0,0,0,0.0,0.0,0.048650325783431585,0.0,2,0,2
org.w3c.dom.DOMException,1,0,0,0,1,1.0,-1,-1.0,0,0,0.0,0.0,0.16618642645330944,0.0,41,0,41
org.apache.html.dom.HTMLDocumentImpl,22,57,462,0.12337662337662338,1,0.045454545454545456,115,5.2272727272727275,405,0.8766233766233766,0.19523809523809527,0.008874458874458875,0.09385665529010238,0.014631456269681532,55,21,76
org.apache.xerces.framework.XMLErrorReporter,2,1,2,0.5,1,0.5,0,0.0,1,0.5,0.0,0.0,0.057429516208284084,6.855109244187742e-05,21,1,22
org.apache.xerces.validators.schema.SchemaSymbols,1,0,0,0,1,1.0,-1,-1.0,0,0,0.0,0.0,0.038104289972782646,0.0,13,0,13
org.w3c.dom.html.HTMLFontElement,1,0,0,0,1,1.0,-1,-1.0,0,0,0.0,0.0,0.0017064846416382253,0.0,1,0,1
org.apache.wml.WMLTemplateElement,1,0,0,0,1,1.0,-1,-1.0,0,0,0.0,0.0,0.02219967407680718,0.0,1,0,1
org.w3c.dom.events.EventTarget,3,4,6,0.6666666666666666,1,0.3333333333333333,15,5.0,2,0.3333333333333333,0.5,0.16666666666666666,0.09460621487628462,1.4099160856840038e-05,4,2,6
org.w3c.dom.html.HTMLTableRowElement,3,2,6,0.3333333333333333,1,0.3333333333333333,15,5.0,4,0.6666666666666666,0.0,0.0,0.035314449685876395,2.4308898029034546e-06,5,2,7
org.apache.xerces.validators.schema.SchemaMessageProvider,2,1,2,0.5,1,0.5,0,0.0,1,0.5,0.0,0.0,0.032711714587374464,3.160156743774491e-06,3,1,4
org.w3c.dom.NodeList,2,3,2,1.5,1,0.5,12,6.0,-1,-0.5,0.0,0.0,0.19883706231829096,0.0001697733438347773,20,1,21
org.apache.xml.serialize.Printer,2,1,2,0.5,1,0.5,21,10.5,1,0.5,0.0,0.0,0.024310175276219124,0.0,5,1,6
org.apache.xerces.readers.MIME2Java,1,0,0,0,1,1.0,-1,-1.0,0,0,0.0,0.0,0.03060754088284295,0.0,5,0,5
org.xml.sax.helpers.LocatorImpl,2,1,2,0.5,1,0.5,0,0.0,1,0.5,0.0,0.0,0.030516248276401616,0.0,2,1,3
org.w3c.dom.html.HTMLMetaElement,1,0,0,0,1,1.0,-1,-1.0,0,0,0.0,0.0,0.0017064846416382253,0.0,1,0,1
org.apache.wml.WMLIElement,1,0,0,0,1,1.0,-1,-1.0,0,0,0.0,0.0,0.02219967407680718,0.0,1,0,1
org.apache.html.dom.HTMLParagraphElementImpl,4,5,12,0.4166666666666667,1,0.25,117,29.25,7,0.5833333333333334,0.0,0.0,0.0,0.0,0,3,3
org.w3c.dom.range.DocumentRange,2,2,2,1.0,1,0.5,14,7.0,0,0.0,0.0,0.0,0.10832346590513339,0.0,1,1,2
javax.xml.parsers.ParserConfigurationException,1,0,0,0,1,1.0,-1,-1.0,0,0,0.0,0.0,0.010238907849829351,0.0,6,0,6
org.xml.sax.XMLReader,6,6,30,0.2,1,0.16666666666666666,8,1.3333333333333333,24,0.8,0.0,0.0,0.03926853862860689,0.00025368765983100456,11,5,16
org.xml.sax.helpers.XMLReaderFactory,6,10,30,0.3333333333333333,1,0.16666666666666666,21,3.5,20,0.6666666666666666,0.0,0.0,0.0017064846416382253,2.041947434438902e-05,1,5,6
org.apache.xerces.utils.QName,1,1,0,0,1,1.0,-1,-1.0,-1,0,0.0,0.0,0.10924254101067929,0.0,39,1,40
org.apache.xerces.utils.regex.RegularExpression,18,55,306,0.17973856209150327,1,0.05555555555555555,28,1.5555555555555556,251,0.8202614379084967,0.4997549019607843,0.027764161220043573,0.04390459025194616,0.00803438250537227,13,17,30
org.apache.xerces.domx.DOMException,2,1,2,0.5,1,0.5,0,0.0,1,0.5,0.0,0.0,0.10977685148921092,2.917067763484146e-06,3,1,4
org.apache.xerces.validators.datatype.DatatypeValidatorFactory,2,1,2,0.5,1,0.5,0,0.0,1,0.5,0.0,0.0,0.03014422547616426,0.0,1,1,2
org.apache.wml.WMLSmallElement,1,0,0,0,1,1.0,-1,-1.0,0,0,0.0,0.0,0.02219967407680718,0.0,1,0,1
org.apache.xerces.dom.AttrNSImpl,5,11,20,0.55,1,0.2,87,17.4,9,0.45,0.0,0.0,0.10791005822124072,7.923816797536932e-05,2,4,6
org.apache.html.dom.HTMLAreaElementImpl,4,5,12,0.4166666666666667,1,0.25,116,29.0,7,0.5833333333333334,0.0,0.0,0.0,0.0,0,3,3
org.apache.xerces.validators.common.CMAny,5,8,20,0.4,1,0.2,9,1.8,12,0.6,0.0,0.0,0.028418302047781566,3.865114786616489e-05,2,4,6
org.apache.wml.dom.WMLRefreshElementImpl,4,6,12,0.5,1,0.25,161,40.25,6,0.5,0.3333333333333333,0.08333333333333333,0.032002431156201785,0.0001079315072489134,1,3,4
org.apache.xerces.framework.XMLAttrList,4,4,12,0.3333333333333333,1,0.25,6,1.5,8,0.6666666666666666,0.0,0.0,0.09500924515545708,0.0009174178116157639,6,3,9
org.apache.xerces.dom.DeferredElementNSImpl,6,8,30,0.26666666666666666,1,0.16666666666666666,87,14.5,22,0.7333333333333333,0.1,0.016666666666666666,0.07904033322617932,1.3873435375141862e-05,1,5,6
org.apache.xerces.jaxp.SAXParserFactoryImpl,6,11,30,0.36666666666666664,1,0.16666666666666666,277,46.166666666666664,19,0.6333333333333333,0.0,0.0,0.0,0.0,0,5,5
org.apache.html.dom.HTMLDivElementImpl,4,5,12,0.4166666666666667,1,0.25,117,29.25,7,0.5833333333333334,0.0,0.0,0.0,0.0,0,3,3
org.apache.xerces.dom.AttributeMap,12,50,132,0.3787878787878788,1,0.08333333333333333,87,7.25,82,0.6212121212121212,0.030303030303030304,0.0025252525252525255,0.09786879970189451,0.00010657118843869514,1,11,12
javax.xml.parsers.DocumentBuilder,6,6,30,0.2,1,0.16666666666666666,19,3.1666666666666665,24,0.8,0.0,0.0,0.005119453924914676,7.632993981116848e-05,3,5,8
org.w3c.dom.html.HTMLFrameElement,1,0,0,0,1,1.0,-1,-1.0,0,0,0.0,0.0,0.0017064846416382253,0.0,1,0,1
org.apache.xerces.utils.regex.Match,2,2,2,1.0,1,0.5,28,14.0,0,0.0,0.0,0.0,0.03598074155085827,8.167789737755608e-05,3,1,4
org.w3c.dom.html.HTMLQuoteElement,1,0,0,0,1,1.0,-1,-1.0,0,0,0.0,0.0,0.0017064846416382253,0.0,1,0,1
org.w3c.dom.html.HTMLLinkElement,1,0,0,0,1,1.0,-1,-1.0,0,0,0.0,0.0,0.0017064846416382253,0.0,1,0,1
org.apache.xerces.dom.events.MutationEventImpl,4,6,12,0.5,1,0.25,18,4.5,6,0.5,0.0,0.0,0.11455790998600436,0.00010689397142534454,7,3,10
org.apache.wml.dom.WMLBElementImpl,4,6,12,0.5,1,0.25,161,40.25,6,0.5,0.3333333333333333,0.08333333333333333,0.032002431156201785,0.0001079315072489134,1,3,4
org.apache.xerces.validators.common.CMStateSet,3,3,6,0.5,1,0.3333333333333333,2,0.6666666666666666,3,0.5,0.0,0.0,0.02615176967185633,1.7502406580904875e-05,7,3,10
org.apache.xerces.validators.datatype.RecurringDurationDatatypeValidator,8,9,56,0.16071428571428573,1,0.125,37,4.625,47,0.8392857142857143,0.0,0.0,0.03014422547616426,0.0007277575792934163,1,7,8
org.xml.sax.SAXNotSupportedException,2,1,2,0.5,1,0.5,0,0.0,1,0.5,0.0,0.0,0.042771769672546846,9.723559211613819e-07,10,1,11
org.w3c.dom.html.HTMLObjectElement,2,1,2,0.5,1,0.5,15,7.5,1,0.5,0.0,0.0,0.034652303754266214,1.458533881742073e-06,2,1,3
org.w3c.dom.html.HTMLDocument,4,3,12,0.25,1,0.25,15,3.75,9,0.75,0.0,0.0,0.058519653595226484,0.0005583753877269237,5,3,8
org.apache.wml.dom.WMLDoElementImpl,4,6,12,0.5,1,0.25,161,40.25,6,0.5,0.3333333333333333,0.08333333333333333,0.032002431156201785,0.0001079315072489134,1,3,4
org.apache.xerces.readers.UTF8Reader,12,20,132,0.15151515151515152,1,0.08333333333333333,17,1.4166666666666667,112,0.8484848484848485,0.0,0.0,0.026625426621160412,0.0003126124286533843,1,11,12
org.apache.html.dom.HTMLAppletElementImpl,4,5,12,0.4166666666666667,1,0.25,116,29.0,7,0.5833333333333334,0.0,0.0,0.0,0.0,0,3,3
org.apache.xerces.validators.datatype.QNameDatatypeValidator,7,8,42,0.19047619047619047,1,0.14285714285714285,35,5.0,34,0.8095238095238095,0.0,0.0,0.03014422547616426,0.0007212936223175138,1,6,7
org.apache.xerces.dom.events.EventImpl,4,7,12,0.5833333333333334,1,0.25,16,4.0,5,0.4166666666666667,0.0,0.0,0.10977685148921092,0.0001361390894951761,3,3,6
org.w3c.dom.html.HTMLModElement,1,0,0,0,1,1.0,-1,-1.0,0,0,0.0,0.0,0.0017064846416382253,0.0,1,0,1
org.apache.xerces.dom.DOMImplementationImpl,10,31,90,0.34444444444444444,1,0.1,87,8.7,59,0.6555555555555556,0.0,0.0,0.10820610776368583,0.00016544635998560914,4,9,13
org.apache.xerces.validators.datatype.AbstractDatatypeValidator,3,2,6,0.3333333333333333,1,0.3333333333333333,2,0.6666666666666666,4,0.6666666666666666,0.0,0.0,0.0407870897063161,1.7502406580904874e-06,15,2,17
org.apache.xerces.utils.regex.Op,10,23,90,0.25555555555555554,1,0.1,28,2.8,67,0.7444444444444445,0.736111111111111,0.0736111111111111,0.03686328804172838,0.0016714798284764155,8,10,18
org.w3c.dom.traversal.DocumentTraversal,4,6,12,0.5,1,0.25,16,4.0,6,0.5,0.0,0.0,0.11073400200316139,1.2032904524372101e-05,3,3,6
org.xml.sax.InputSource,1,0,0,0,1,1.0,-1,-1.0,0,0,0.0,0.0,0.09330320081173324,0.0,26,0,26
org.apache.xerces.readers.DefaultEntityHandler,23,52,506,0.10276679841897234,1,0.043478260869565216,47,2.0434782608695654,454,0.8972332015810277,0.0367965367965368,0.0015998494259363825,0.04163682074186435,0.004606049998541466,8,22,30
org.w3c.dom.DOMImplementation,3,4,6,0.6666666666666666,1,0.3333333333333333,12,4.0,2,0.3333333333333333,0.0,0.0,0.1685792484872467,1.8058038535854237e-06,8,2,10
org.apache.wml.dom.WMLFieldsetElementImpl,4,6,12,0.5,1,0.25,161,40.25,6,0.5,0.3333333333333333,0.08333333333333333,0.032002431156201785,0.0001079315072489134,1,3,4
org.apache.xerces.validators.common.GrammarResolverImpl,3,3,6,0.5,1,0.3333333333333333,266,88.66666666666667,3,0.5,0.0,0.0,0.032168786844554764,0.00048277471485662615,2,2,4
org.xml.sax.HandlerBase,10,15,90,0.16666666666666666,1,0.1,8,0.8,75,0.8333333333333334,0.0,0.0,0.0068259385665529,4.686755539997861e-05,3,9,12
org.apache.xerces.dom.DeepNodeListImpl,4,8,12,0.6666666666666666,1,0.25,87,21.75,4,0.3333333333333333,0.16666666666666666,0.041666666666666664,0.10865324044039527,8.24881939785239e-06,3,3,6
org.apache.html.dom.HTMLDOMImplementationImpl,6,9,30,0.3,1,0.16666666666666666,117,19.5,21,0.7,0.0,0.0,0.0,0.0,0,5,5
org.w3c.dom.html.HTMLBaseFontElement,1,0,0,0,1,1.0,-1,-1.0,0,0,0.0,0.0,0.0017064846416382253,0.0,1,0,1
org.apache.xerces.utils.HexBin,1,0,0,0,1,1.0,-1,-1.0,0,0,0.0,0.0,0.024932405478480562,0.0,1,0,1
org.apache.xerces.readers.XCatalog,5,11,20,0.55,1,0.2,274,54.8,9,0.45,0.0,0.0,0.0034129692832764505,0.0007905253639042037,3,5,8
org.apache.wml.WMLTrElement,1,0,0,0,1,1.0,-1,-1.0,0,0,0.0,0.0,0.02219967407680718,0.0,1,0,1
org.w3c.dom.html.HTMLDivElement,1,0,0,0,1,1.0,-1,-1.0,0,0,0.0,0.0,0.0017064846416382253,0.0,1,0,1
org.apache.html.dom.HTMLCollectionImpl,17,25,272,0.09191176470588236,1,0.058823529411764705,27,1.588235294117647,247,0.9080882352941176,0.0,0.0,0.050967007963595,0.0017574430373065186,7,16,23
org.apache.xerces.framework.XMLDocumentScanner,19,53,342,0.15497076023391812,1,0.05263157894736842,266,14.0,289,0.8450292397660819,0.035403050108932466,0.0018633184267859192,0.035671033799405484,0.005464348570150618,7,18,25
org.apache.xerces.dom.DeferredNode,1,0,0,0,1,1.0,-1,-1.0,0,0,0.0,0.0,0.08066641078041847,0.0,14,0,14
org.apache.html.dom.HTMLBaseElementImpl,4,5,12,0.4166666666666667,1,0.25,117,29.25,7,0.5833333333333334,0.0,0.0,0.0,0.0,0,3,3
org.w3c.dom.EntityReference,1,0,0,0,1,1.0,-1,-1.0,0,0,0.0,0.0,0.16935112463505902,0.0,11,0,11
org.apache.wml.WMLTableElement,1,0,0,0,1,1.0,-1,-1.0,0,0,0.0,0.0,0.02219967407680718,0.0,1,0,1
org.apache.wml.dom.WMLAccessElementImpl,4,6,12,0.5,1,0.25,161,40.25,6,0.5,0.3333333333333333,0.08333333333333333,0.032002431156201785,0.0001079315072489134,1,3,4
org.apache.xerces.dom.DeferredDocumentImpl,23,71,506,0.14031620553359683,1,0.043478260869565216,87,3.782608695652174,435,0.8596837944664032,0.5216450216450217,0.022680218332392248,0.10061511806087622,0.01363170142771088,16,22,38
org.apache.html.dom.HTMLBRElementImpl,4,5,12,0.4166666666666667,1,0.25,117,29.25,7,0.5833333333333334,0.0,0.0,0.0,0.0,0,3,3
org.w3c.dom.html.HTMLSelectElement,4,4,12,0.3333333333333333,1,0.25,16,4.0,8,0.6666666666666666,0.0,0.0,0.0034129692832764505,4.132512664935873e-06,2,3,5
org.apache.wml.dom.WMLIElementImpl,4,6,12,0.5,1,0.25,161,40.25,6,0.5,0.3333333333333333,0.08333333333333333,0.032002431156201785,0.0001079315072489134,1,3,4
org.apache.wml.dom.WMLPElementImpl,4,6,12,0.5,1,0.25,161,40.25,6,0.5,0.3333333333333333,0.08333333333333333,0.032002431156201785,0.0001079315072489134,1,3,4
org.apache.xml.serialize.XHTMLSerializer,4,6,12,0.5,1,0.25,42,10.5,6,0.5,0.0,0.0,0.0022753128555176336,0.0,1,3,4
org.apache.xerces.utils.Hash2intTable,1,0,0,0,1,1.0,-1,-1.0,0,0,0.0,0.0,0.028241790854938206,0.0,1,0,1
org.apache.xerces.framework.XMLDTDScanner,18,47,306,0.15359477124183007,1,0.05555555555555555,266,14.777777777777779,259,0.8464052287581699,0.0,0.0,0.028263311125407538,0.0030953006038330275,1,17,18
org.w3c.dom.html.HTMLIFrameElement,1,0,0,0,1,1.0,-1,-1.0,0,0,0.0,0.0,0.0017064846416382253,0.0,1,0,1
org.apache.xerces.readers.XMLDeclRecognizer,10,33,90,0.36666666666666664,1,0.1,26,2.6,57,0.6333333333333333,0.1736111111111111,0.017361111111111112,0.04402986028556454,0.0018263275089213664,7,9,16
org.apache.wml.dom.WMLBigElementImpl,4,6,12,0.5,1,0.25,161,40.25,6,0.5,0.3333333333333333,0.08333333333333333,0.032002431156201785,0.0001079315072489134,1,3,4
org.w3c.dom.html.HTMLMapElement,2,1,2,0.5,1,0.5,14,7.0,1,0.5,0.0,0.0,0.0017064846416382253,0.0,1,1,2
org.w3c.dom.Attr,2,2,2,1.0,1,0.5,12,6.0,0,0.0,0.0,0.0,0.1914727266768728,8.858162441780189e-05,28,1,29
org.xml.sax.helpers.AttributeListImpl,2,1,2,0.5,1,0.5,0,0.0,1,0.5,0.0,0.0,0.0,0.0,0,1,1
org.apache.xerces.dom.DeferredElementDefinitionImpl,6,13,30,0.43333333333333335,1,0.16666666666666666,87,14.5,17,0.5666666666666667,0.07500000000000001,0.012500000000000002,0.07904033322617932,1.4953444987574682e-05,1,5,6
org.apache.wml.dom.WMLTdElementImpl,4,6,12,0.5,1,0.25,161,40.25,6,0.5,0.3333333333333333,0.08333333333333333,0.032002431156201785,0.0001079315072489134,1,3,4
org.apache.xml.serialize.Encodings,2,1,2,0.5,1,0.5,0,0.0,1,0.5,0.0,0.0,0.020356810425069812,0.00023628248884221582,1,1,2
org.apache.xerces.utils.NamespacesScope,2,1,2,0.5,1,0.5,0,0.0,1,0.5,0.0,0.0,0.02905385512872237,2.479507598961524e-05,3,1,4
org.apache.xerces.validators.datatype.StringDatatypeValidator,7,8,42,0.19047619047619047,1,0.14285714285714285,35,5.0,34,0.8095238095238095,0.0,0.0,0.03014422547616426,0.0007212936223175138,1,6,7
org.w3c.dom.html.HTMLFormElement,2,1,2,0.5,1,0.5,14,7.0,1,0.5,0.0,0.0,0.06227975249035766,0.0003952626819521018,13,1,14
org.apache.wml.WMLNoopElement,1,0,0,0,1,1.0,-1,-1.0,0,0,0.0,0.0,0.02219967407680718,0.0,1,0,1
org.apache.xerces.dom.RangeImpl,12,31,132,0.23484848484848486,1,0.08333333333333333,87,7.25,101,0.7651515151515151,0.06818181818181818,0.005681818181818181,0.1076156242288226,0.0013976309368800832,1,11,12
org.xml.sax.SAXNotRecognizedException,2,1,2,0.5,1,0.5,0,0.0,1,0.5,0.0,0.0,0.04243095875882137,9.723559211613819e-07,9,1,10
org.apache.xerces.dom.DeferredAttrNSImpl,5,7,20,0.35,1,0.2,87,17.4,13,0.65,0.08333333333333333,0.016666666666666666,0.07904033322617932,1.0209737172194511e-05,1,4,5
org.apache.xerces.framework.XMLContentSpec,3,4,6,0.6666666666666666,1,0.3333333333333333,5,1.6666666666666667,2,0.3333333333333333,0.5,0.16666666666666666,0.053533055239539884,0.00010428517254455825,16,3,19
org.w3c.dom.html.HTMLHeadingElement,1,0,0,0,1,1.0,-1,-1.0,0,0,0.0,0.0,0.0017064846416382253,0.0,1,0,1
org.apache.xerces.jaxp.SAXParserImpl,5,6,20,0.3,1,0.2,13,2.6,14,0.7,0.0,0.0,0.0017064846416382253,3.6463347043551823e-06,1,4,5
javax.xml.parsers.SAXParserFactory,6,7,30,0.23333333333333334,1,0.16666666666666666,275,45.833333333333336,23,0.7666666666666667,0.0,0.0,0.0017064846416382253,3.8894236846455275e-06,2,6,8
org.apache.xerces.utils.regex.ParseException,1,0,0,0,1,1.0,-1,-1.0,0,0,0.0,0.0,0.03658903834571371,0.0,4,0,4
org.apache.xml.serialize.ElementState,1,0,0,0,1,1.0,-1,-1.0,0,0,0.0,0.0,0.0237712223647312,0.0,4,0,4
org.apache.xerces.validators.datatype.DatatypeMessageProvider,2,1,2,0.5,1,0.5,0,0.0,1,0.5,0.0,0.0,0.040402826515406436,2.2540978172377493e-05,9,1,10
org.w3c.dom.html.HTMLImageElement,1,0,0,0,1,1.0,-1,-1.0,0,0,0.0,0.0,0.034652303754266214,0.0,2,0,2
org.apache.wml.dom.WMLSetvarElementImpl,4,6,12,0.5,1,0.25,161,40.25,6,0.5,0.3333333333333333,0.08333333333333333,0.032002431156201785,0.0001079315072489134,1,3,4
org.apache.wml.WMLAnchorElement,1,0,0,0,1,1.0,-1,-1.0,0,0,0.0,0.0,0.02219967407680718,0.0,1,0,1
org.apache.xerces.validators.common.SimpleContentModel,9,18,72,0.25,1,0.1111111111111111,266,29.555555555555557,54,0.75,0.0,0.0,0.02773171279702997,0.0008084653306496311,1,8,9
org.apache.wml.dom.WMLWmlElementImpl,4,6,12,0.5,1,0.25,161,40.25,6,0.5,0.3333333333333333,0.08333333333333333,0.032002431156201785,0.0001079315072489134,1,3,4
org.apache.xerces.dom.DeferredEntityImpl,5,7,20,0.35,1,0.2,87,17.4,13,0.65,0.08333333333333333,0.016666666666666666,0.07904033322617932,1.0209737172194511e-05,1,4,5
org.w3c.dom.html.HTMLFieldSetElement,2,1,2,0.5,1,0.5,15,7.5,1,0.5,0.0,0.0,0.0017064846416382253,1.458533881742073e-06,1,1,2
org.apache.wml.WMLFieldsetElement,1,0,0,0,1,1.0,-1,-1.0,0,0,0.0,0.0,0.02219967407680718,0.0,1,0,1
org.apache.xerces.dom.DocumentFragmentImpl,4,7,12,0.5833333333333334,1,0.25,87,21.75,5,0.4166666666666667,0.0,0.0,0.1076156242288226,0.0,1,3,4
org.apache.xerces.validators.common.CMNode,3,4,6,0.6666666666666666,1,0.3333333333333333,3,1.0,2,0.3333333333333333,0.0,0.0,0.031227615556398268,3.500481316180972e-05,6,2,8
org.apache.html.dom.HTMLScriptElementImpl,7,10,42,0.23809523809523808,1,0.14285714285714285,117,16.714285714285715,32,0.7619047619047619,0.0,0.0,0.0,0.0,0,6,6
org.w3c.dom.html.HTMLDListElement,1,0,0,0,1,1.0,-1,-1.0,0,0,0.0,0.0,0.0017064846416382253,0.0,1,0,1
org.apache.xerces.validators.common.XMLContentModel,5,9,20,0.45,1,0.2,266,53.2,11,0.55,0.0,0.0,0.03300901635168865,0.0008198418949272192,6,4,10
org.apache.xml.serialize.XMLSerializer,11,19,110,0.17272727272727273,1,0.09090909090909091,40,3.6363636363636362,91,0.8272727272727273,0.0,0.0,0.025338445475841614,0.0025575877794307834,3,10,13
org.apache.html.dom.HTMLFontElementImpl,4,5,12,0.4166666666666667,1,0.25,117,29.25,7,0.5833333333333334,0.0,0.0,0.0,0.0,0,3,3
org.w3c.dom.CDATASection,1,0,0,0,1,1.0,-1,-1.0,0,0,0.0,0.0,0.16853888902529854,0.0,8,0,8
org.apache.xerces.validators.datatype.IDDatatypeValidator,9,10,72,0.1388888888888889,1,0.1111111111111111,9,1.0,62,0.8611111111111112,0.0,0.0,0.03014422547616426,6.098660535520603e-05,1,8,9
org.apache.html.dom.HTMLTableCaptionElementImpl,4,5,12,0.4166666666666667,1,0.25,117,29.25,7,0.5833333333333334,0.0,0.0,0.002559726962457338,0.0,1,3,4
org.apache.xerces.validators.common.DFAContentModel,15,47,210,0.22380952380952382,1,0.06666666666666667,266,17.733333333333334,163,0.7761904761904762,0.0,0.0,0.02773171279702997,0.0008434701438114411,1,14,15
org.apache.html.dom.HTMLLIElementImpl,4,5,12,0.4166666666666667,1,0.25,117,29.25,7,0.5833333333333334,0.0,0.0,0.0,0.0,0,3,3
org.apache.wml.WMLOptionElement,1,0,0,0,1,1.0,-1,-1.0,0,0,0.0,0.0,0.02219967407680718,0.0,1,0,1
org.apache.xerces.utils.ChunkyCharArray,4,7,12,0.5833333333333334,1,0.25,8,2.0,5,0.4166666666666667,0.0,0.0,0.040825667337205884,0.00033983839444590294,4,4,8
org.apache.html.dom.HTMLHRElementImpl,4,5,12,0.4166666666666667,1,0.25,117,29.25,7,0.5833333333333334,0.0,0.0,0.0,0.0,0,3,3
org.apache.wml.dom.WMLAnchorElementImpl,4,6,12,0.5,1,0.25,161,40.25,6,0.5,0.3333333333333333,0.08333333333333333,0.032002431156201785,0.0001079315072489134,1,3,4
org.apache.wml.WMLImgElement,1,0,0,0,1,1.0,-1,-1.0,0,0,0.0,0.0,0.02219967407680718,0.0,1,0,1
org.w3c.dom.html.HTMLHRElement,1,0,0,0,1,1.0,-1,-1.0,0,0,0.0,0.0,0.0017064846416382253,0.0,1,0,1
org.apache.html.dom.HTMLTableRowElementImpl,14,57,182,0.3131868131868132,1,0.07142857142857142,122,8.714285714285714,125,0.6868131868131868,0.035256410256410256,0.0025183150183150185,0.0034129692832764505,2.3683812079716515e-05,2,13,15
org.w3c.dom.html.HTMLButtonElement,2,1,2,0.5,1,0.5,15,7.5,1,0.5,0.0,0.0,0.0017064846416382253,1.458533881742073e-06,1,1,2
org.apache.xerces.readers.XMLEntityReaderFactory,3,4,6,0.6666666666666666,1,0.3333333333333333,26,8.666666666666666,2,0.3333333333333333,0.0,0.0,0.04402986028556454,4.959015197923048e-06,7,2,9
org.apache.html.dom.HTMLTextAreaElementImpl,5,6,20,0.3,1,0.2,117,23.4,14,0.7,0.0,0.0,0.0,0.0,0,4,4
org.apache.xerces.readers.EBCDICRecognizer,9,18,72,0.25,1,0.1111111111111111,26,2.888888888888889,54,0.75,0.03571428571428571,0.003968253968253968,0.03368473551932875,0.00011084857501239754,1,8,9
org.apache.wml.WMLDoElement,1,0,0,0,1,1.0,-1,-1.0,0,0,0.0,0.0,0.02219967407680718,0.0,1,0,1
org.apache.xerces.dom.DeferredDocumentTypeImpl,7,16,42,0.38095238095238093,1,0.14285714285714285,87,12.428571428571429,26,0.6190476190476191,0.016666666666666666,0.0023809523809523807,0.07904033322617932,7.563539986748179e-06,1,6,7
org.w3c.dom.html.HTMLTableElement,5,6,20,0.3,1,0.2,17,3.4,14,0.7,0.0,0.0,0.0038395904436860067,2.917067763484146e-06,2,4,6
org.w3c.dom.html.HTMLTableCellElement,1,0,0,0,1,1.0,-1,-1.0,0,0,0.0,0.0,0.03487024277158864,0.0,3,0,3
org.apache.wml.WMLRefreshElement,1,0,0,0,1,1.0,-1,-1.0,0,0,0.0,0.0,0.02219967407680718,0.0,1,0,1
org.apache.xerces.validators.common.XMLValidator,53,202,2756,0.07329462989840348,1,0.018867924528301886,266,5.018867924528302,2554,0.9267053701015965,0.0755718954248366,0.0014258848193365395,0.030192547379701565,0.011707011334428854,3,52,55
org.apache.html.dom.HTMLPreElementImpl,4,5,12,0.4166666666666667,1,0.25,117,29.25,7,0.5833333333333334,0.0,0.0,0.0,0.0,0,3,3
org.apache.xerces.validators.common.MixedContentModel,8,17,56,0.30357142857142855,1,0.125,266,33.25,39,0.6964285714285714,0.0,0.0,0.02773171279702997,0.0008084653306496311,1,7,8
org.apache.wml.WMLBElement,1,0,0,0,1,1.0,-1,-1.0,0,0,0.0,0.0,0.02219967407680718,0.0,1,0,1
org.apache.xml.serialize.BaseMarkupSerializer,24,49,552,0.08876811594202899,1,0.041666666666666664,39,1.625,503,0.9112318840579711,0.0,0.0,0.023286784022355313,0.001946753789757203,4,23,27
org.apache.xml.serialize.HTMLdtd,1,0,0,0,1,1.0,-1,-1.0,0,0,0.0,0.0,0.0034129692832764505,0.0,1,0,1
org.apache.html.dom.HTMLTableSectionElementImpl,9,30,72,0.4166666666666667,1,0.1111111111111111,122,13.555555555555555,42,0.5833333333333334,0.0,0.0,0.0034129692832764505,0.0,2,8,10
org.apache.wml.dom.WMLEmElementImpl,4,6,12,0.5,1,0.25,161,40.25,6,0.5,0.3333333333333333,0.08333333333333333,0.032002431156201785,0.0001079315072489134,1,3,4
org.apache.wml.WMLUElement,1,0,0,0,1,1.0,-1,-1.0,0,0,0.0,0.0,0.02219967407680718,0.0,1,0,1
org.apache.xerces.dom.ProcessingInstructionImpl,4,6,12,0.5,1,0.25,87,21.75,6,0.5,0.16666666666666666,0.041666666666666664,0.10820610776368583,0.00021692986994465967,4,3,7
org.w3c.dom.html.HTMLHtmlElement,1,0,0,0,1,1.0,-1,-1.0,0,0,0.0,0.0,0.048650325783431585,0.0,2,0,2
org.apache.xerces.dom.ElementNSImpl,5,11,20,0.55,1,0.2,87,17.4,9,0.45,0.0,0.0,0.10791005822124072,7.848111943675084e-05,2,4,6
org.w3c.dom.html.HTMLScriptElement,1,0,0,0,1,1.0,-1,-1.0,0,0,0.0,0.0,0.0017064846416382253,0.0,1,0,1
org.apache.xerces.readers.XMLEntityReader,5,5,20,0.25,1,0.2,6,1.2,15,0.75,0.0,0.0,0.028658107156400672,1.458533881742073e-05,6,4,10
org.apache.wml.dom.WMLTemplateElementImpl,4,6,12,0.5,1,0.25,161,40.25,6,0.5,0.3333333333333333,0.08333333333333333,0.032002431156201785,0.0001079315072489134,1,3,4
org.w3c.dom.Document,13,22,156,0.14102564102564102,1,0.07692307692307693,12,0.9230769230769231,134,0.8589743589743589,0.3484848484848485,0.026806526806526808,0.20171043027086744,0.003364768211184594,48,12,60
org.apache.html.dom.HTMLElementImpl,7,12,42,0.2857142857142857,1,0.14285714285714285,115,16.428571428571427,30,0.7142857142857143,0.06666666666666667,0.009523809523809523,0.09056343931501107,0.0026872514415176556,53,6,59
org.w3c.dom.html.HTMLPreElement,1,0,0,0,1,1.0,-1,-1.0,0,0,0.0,0.0,0.0017064846416382253,0.0,1,0,1
org.apache.html.dom.HTMLBodyElementImpl,4,7,12,0.5833333333333334,1,0.25,115,28.75,5,0.4166666666666667,0.0,0.0,0.047358862761060834,0.0,1,3,4
org.apache.xerces.utils.CharDataChunk,6,8,30,0.26666666666666666,1,0.16666666666666666,7,1.1666666666666667,22,0.7333333333333333,0.0,0.0,0.03686006825938567,5.736899934852154e-05,6,6,12
org.apache.xerces.utils.SymbolCache,1,0,0,0,1,1.0,-1,-1.0,0,0,0.0,0.0,0.09812527945495428,0.0,2,0,2
org.apache.xerces.readers.UCSRecognizer,9,22,72,0.3055555555555556,1,0.1111111111111111,26,2.888888888888889,50,0.6944444444444444,0.03571428571428571,0.003968253968253968,0.03368473551932875,0.00037980222280563575,1,8,9
org.xml.sax.AttributeList,1,0,0,0,1,1.0,-1,-1.0,0,0,0.0,0.0,0.09524565441701723,0.0,18,0,18
org.apache.wml.WMLPElement,1,0,0,0,1,1.0,-1,-1.0,0,0,0.0,0.0,0.02219967407680718,0.0,1,0,1
org.w3c.dom.html.HTMLLegendElement,2,1,2,0.5,1,0.5,15,7.5,1,0.5,0.0,0.0,0.0017064846416382253,1.458533881742073e-06,1,1,2
org.apache.xerces.validators.datatype.DoubleDatatypeValidator,8,9,56,0.16071428571428573,1,0.125,37,4.625,47,0.8392857142857143,0.0,0.0,0.03014422547616426,0.0007277575792934163,1,7,8
org.apache.html.dom.HTMLModElementImpl,4,5,12,0.4166666666666667,1,0.25,117,29.25,7,0.5833333333333334,0.0,0.0,0.0,0.0,0,3,3
org.apache.wml.dom.WMLTrElementImpl,4,6,12,0.5,1,0.25,161,40.25,6,0.5,0.3333333333333333,0.08333333333333333,0.032002431156201785,0.0001079315072489134,1,3,4
org.apache.xerces.utils.XMLCharacterProperties,1,0,0,0,1,1.0,-1,-1.0,0,0,0.0,0.0,0.04432247947606309,0.0,10,0,10
org.apache.wml.dom.WMLOneventElementImpl,4,6,12,0.5,1,0.25,161,40.25,6,0.5,0.3333333333333333,0.08333333333333333,0.032002431156201785,0.0001079315072489134,1,3,4
org.w3c.dom.traversal.NodeIterator,3,4,6,0.6666666666666666,1,0.3333333333333333,14,4.666666666666667,2,0.3333333333333333,0.0,0.0,0.11145167169223631,1.8231673521775912e-06,4,2,6
org.apache.xerces.dom.EntityImpl,5,11,20,0.55,1,0.2,87,17.4,9,0.45,0.0,0.0,0.11078968056141428,0.0001041790973531588,5,4,9
org.apache.xerces.dom.DeferredEntityReferenceImpl,8,18,56,0.32142857142857145,1,0.125,87,10.875,38,0.6785714285714286,0.047619047619047616,0.005952380952380952,0.07904033322617932,3.293161142990495e-05,1,7,8
org.apache.wml.WMLSelectElement,1,0,0,0,1,1.0,-1,-1.0,0,0,0.0,0.0,0.02219967407680718,0.0,1,0,1
org.w3c.dom.html.HTMLTableColElement,1,0,0,0,1,1.0,-1,-1.0,0,0,0.0,0.0,0.0017064846416382253,0.0,1,0,1
org.apache.xerces.validators.common.InsertableElementsInfo,2,2,2,1.0,1,0.5,0,0.0,0,0.0,0.0,0.0,0.03168591169090628,0.0,5,1,6
org.apache.wml.dom.WMLNoopElementImpl,4,6,12,0.5,1,0.25,161,40.25,6,0.5,0.3333333333333333,0.08333333333333333,0.032002431156201785,0.0001079315072489134,1,3,4
org.xml.sax.XMLFilter,2,1,2,0.5,1,0.5,9,4.5,1,0.5,0.0,0.0,0.0017064846416382253,0.0,1,1,2
org.apache.wml.dom.WMLAElementImpl,4,6,12,0.5,1,0.25,161,40.25,6,0.5,0.3333333333333333,0.08333333333333333,0.032002431156201785,0.0001079315072489134,1,3,4
org.xml.sax.ext.DeclHandler,1,0,0,0,1,1.0,-1,-1.0,0,0,0.0,0.0,0.029777249291990413,0.0,3,0,3
org.apache.xerces.validators.schema.TraverseSchema,33,107,1056,0.10132575757575757,1,0.030303030303030304,266,8.06060606060606,949,0.8986742424242424,0.019993279569892473,0.0006058569566634083,0.0283538986610659,0.009922424518556487,2,32,34
org.xml.sax.ContentHandler,3,2,6,0.3333333333333333,1,0.3333333333333333,1,0.3333333333333333,4,0.6666666666666666,0.0,0.0,0.038367680136171395,3.826220549770038e-05,9,2,11
org.w3c.dom.html.HTMLTextAreaElement,2,1,2,0.5,1,0.5,15,7.5,1,0.5,0.0,0.0,0.0017064846416382253,1.458533881742073e-06,1,1,2
org.apache.xerces.validators.common.CMBinOp,6,11,30,0.36666666666666664,1,0.16666666666666666,11,1.8333333333333333,19,0.6333333333333333,0.0,0.0,0.028418302047781566,3.500481316180972e-05,2,5,7
org.apache.wml.WMLPostfieldElement,1,0,0,0,1,1.0,-1,-1.0,0,0,0.0,0.0,0.02219967407680718,0.0,1,0,1
org.w3c.dom.Node,4,8,12,0.6666666666666666,1,0.25,12,3.0,4,0.3333333333333333,0.8333333333333333,0.20833333333333331,0.22733488232482127,0.002110640907569238,79,4,83
org.apache.xerces.dom.DeferredCommentImpl,4,5,12,0.4166666666666667,1,0.25,87,21.75,7,0.5833333333333334,0.16666666666666666,0.041666666666666664,0.07904033322617932,1.2217589009397883e-05,1,3,4
org.apache.html.dom.HTMLMetaElementImpl,4,5,12,0.4166666666666667,1,0.25,117,29.25,7,0.5833333333333334,0.0,0.0,0.0,0.0,0,3,3
org.w3c.dom.Entity,1,0,0,0,1,1.0,-1,-1.0,0,0,0.0,0.0,0.12140454183694893,0.0,7,0,7
org.apache.html.dom.HTMLInputElementImpl,5,6,20,0.3,1,0.2,117,23.4,14,0.7,0.0,0.0,0.0,0.0,0,4,4
org.apache.wml.dom.WMLInputElementImpl,4,6,12,0.5,1,0.25,161,40.25,6,0.5,0.3333333333333333,0.08333333333333333,0.032002431156201785,0.0001079315072489134,1,3,4
org.apache.wml.dom.WMLHeadElementImpl,4,6,12,0.5,1,0.25,161,40.25,6,0.5,0.3333333333333333,0.08333333333333333,0.032002431156201785,0.0001079315072489134,1,3,4
org.apache.html.dom.HTMLSelectElementImpl,10,25,90,0.2777777777777778,1,0.1,118,11.8,65,0.7222222222222222,0.0,0.0,0.0,0.0,0,9,9
org.apache.wml.WMLInputElement,1,0,0,0,1,1.0,-1,-1.0,0,0,0.0,0.0,0.02219967407680718,0.0,1,0,1
org.apache.xerces.jaxp.DocumentBuilderImpl,11,25,110,0.22727272727272727,1,0.09090909090909091,269,24.454545454545453,85,0.7727272727272727,0.0,0.0,0.0017064846416382253,0.0007637855760722656,1,10,11
org.apache.xerces.dom.ElementDefinitionImpl,6,18,30,0.6,1,0.16666666666666666,87,14.5,12,0.4,0.1,0.016666666666666666,0.11125846623374748,8.972761532488487e-05,4,5,9
org.apache.xerces.utils.ImplementationMessages,2,1,2,0.5,1,0.5,0,0.0,1,0.5,0.0,0.0,0.05994715402400088,9.504779129352508e-05,14,1,15
org.w3c.dom.html.HTMLTableCaptionElement,1,0,0,0,1,1.0,-1,-1.0,0,0,0.0,0.0,0.005332764505119454,0.0,3,0,3
org.apache.wml.WMLTdElement,1,0,0,0,1,1.0,-1,-1.0,0,0,0.0,0.0,0.02219967407680718,0.0,1,0,1
org.apache.html.dom.HTMLFrameSetElementImpl,4,6,12,0.5,1,0.25,116,29.0,6,0.5,0.0,0.0,0.0,0.0,0,3,3
org.apache.wml.dom.WMLCardElementImpl,4,6,12,0.5,1,0.25,161,40.25,6,0.5,0.3333333333333333,0.08333333333333333,0.032002431156201785,0.0001079315072489134,1,3,4
org.w3c.dom.Text,1,1,0,0,1,1.0,-1,-1.0,-1,0,0.0,0.0,0.1716256818645897,0.0,15,1,16
org.xml.sax.SAXParseException,3,2,6,0.3333333333333333,1,0.3333333333333333,1,0.3333333333333333,4,0.6666666666666666,0.0,0.0,0.053911442428597085,5.834135526968292e-05,20,2,22
org.apache.wml.dom.WMLUElementImpl,4,6,12,0.5,1,0.25,161,40.25,6,0.5,0.3333333333333333,0.08333333333333333,0.032002431156201785,0.0001079315072489134,1,3,4
org.w3c.dom.html.HTMLBaseElement,1,0,0,0,1,1.0,-1,-1.0,0,0,0.0,0.0,0.0017064846416382253,0.0,1,0,1
org.w3c.dom.html.HTMLOptionElement,2,1,2,0.5,1,0.5,15,7.5,1,0.5,0.0,0.0,0.03487024277158864,1.7016228620324181e-06,3,1,4
org.apache.html.dom.HTMLBaseFontElementImpl,4,5,12,0.4166666666666667,1,0.25,117,29.25,7,0.5833333333333334,0.0,0.0,0.0,0.0,0,3,3
org.apache.xml.serialize.HTMLSerializer,13,22,156,0.14102564102564102,1,0.07692307692307693,41,3.1538461538461537,134,0.8589743589743589,0.0,0.0,0.0038395904436860067,0.0001172175062960046,2,12,14
org.apache.xerces.validators.common.CMLeaf,7,13,42,0.30952380952380953,1,0.14285714285714285,12,1.7142857142857142,29,0.6904761904761905,0.0,0.0,0.028418302047781566,3.865114786616489e-05,2,6,8
org.apache.html.dom.HTMLLinkElementImpl,4,5,12,0.4166666666666667,1,0.25,117,29.25,7,0.5833333333333334,0.0,0.0,0.0,0.0,0,3,3
org.apache.xerces.domx.XGrammarWriter,14,42,182,0.23076923076923078,1,0.07142857142857142,268,19.142857142857142,140,0.7692307692307693,0.0,0.0,0.0,0.0,0,13,13
org.w3c.dom.traversal.NodeFilter,2,2,2,1.0,1,0.5,13,6.5,0,0.0,0.0,0.0,0.11511935964399526,3.6463347043551823e-07,8,1,9
org.apache.html.dom.HTMLOptionElementImpl,8,11,56,0.19642857142857142,1,0.125,117,14.625,45,0.8035714285714286,0.0,0.0,0.0017064846416382253,1.896094046264695e-05,1,7,8
org.apache.wml.WMLOptgroupElement,1,0,0,0,1,1.0,-1,-1.0,0,0,0.0,0.0,0.02219967407680718,0.0,1,0,1
org.w3c.dom.Notation,1,0,0,0,1,1.0,-1,-1.0,0,0,0.0,0.0,0.12219347239453346,0.0,7,0,7
org.apache.wml.WMLGoElement,1,0,0,0,1,1.0,-1,-1.0,0,0,0.0,0.0,0.02219967407680718,0.0,1,0,1
org.apache.xerces.utils.ChunkyByteArray,1,0,0,0,1,1.0,-1,-1.0,0,0,0.0,0.0,0.03616378340847081,0.0,7,0,7
org.apache.wml.dom.WMLPrevElementImpl,4,6,12,0.5,1,0.25,161,40.25,6,0.5,0.3333333333333333,0.08333333333333333,0.032002431156201785,0.0001079315072489134,1,3,4
org.apache.html.dom.HTMLParamElementImpl,4,5,12,0.4166666666666667,1,0.25,117,29.25,7,0.5833333333333334,0.0,0.0,0.0,0.0,0,3,3
org.w3c.dom.html.HTMLLabelElement,2,1,2,0.5,1,0.5,15,7.5,1,0.5,0.0,0.0,0.0017064846416382253,1.458533881742073e-06,1,1,2
org.apache.xerces.dom.CharacterDataImpl,10,18,90,0.2,1,0.1,87,8.7,72,0.8,0.0,0.0,0.08668379402167799,0.00010822187837152393,4,9,13
org.w3c.dom.html.HTMLInputElement,2,1,2,0.5,1,0.5,15,7.5,1,0.5,0.0,0.0,0.0017064846416382253,1.458533881742073e-06,1,1,2
org.apache.xerces.utils.StringPool,5,4,20,0.2,1,0.2,3,0.6,16,0.8,0.0,0.0,0.12671119579555684,0.002749919780636504,49,4,53
org.apache.xerces.jaxp.DocumentBuilderFactoryImpl,5,9,20,0.45,1,0.2,272,54.4,11,0.55,0.0,0.0,0.0,0.0,0,4,4
org.apache.xerces.readers.XMLCatalogHandler,4,4,12,0.3333333333333333,1,0.25,2,0.5,8,0.6666666666666666,0.0,0.0,0.0038395904436860067,3.8894236846455275e-06,2,3,5
org.apache.xerces.utils.regex.Token,13,36,156,0.23076923076923078,1,0.07692307692307693,28,2.1538461538461537,120,0.7692307692307693,0.8598484848484849,0.06614219114219114,0.038084878483657,0.0026031912721332525,16,13,29
org.apache.xerces.parsers.SAXParser,23,44,506,0.08695652173913043,1,0.043478260869565216,270,11.73913043478261,462,0.9130434782608695,0.0,0.0,0.02858980066280853,0.011171445796019176,5,22,27
org.apache.xerces.validators.common.CMUniOp,6,11,30,0.36666666666666664,1,0.16666666666666666,11,1.8333333333333333,19,0.6333333333333333,0.0,0.0,0.028418302047781566,3.500481316180972e-05,2,5,7
org.w3c.dom.DocumentType,2,1,2,0.5,1,0.5,12,6.0,1,0.5,0.0,0.0,0.18034059140496161,6.811353227735476e-05,18,1,19
org.apache.html.dom.HTMLTableElementImpl,13,51,156,0.3269230769230769,1,0.07692307692307693,122,9.384615384615385,105,0.6730769230769231,0.022727272727272728,0.0017482517482517483,0.0022753128555176336,8.751203290452438e-06,1,12,13
org.w3c.dom.range.Range,3,4,6,0.6666666666666666,1,0.3333333333333333,13,4.333333333333333,2,0.3333333333333333,0.0,0.0,0.10947773200286429,4.083894868877804e-05,5,3,8
org.apache.wml.WMLAccessElement,1,0,0,0,1,1.0,-1,-1.0,0,0,0.0,0.0,0.02219967407680718,0.0,1,0,1
org.apache.xerces.dom.DOMExceptionImpl,2,1,2,0.5,1,0.5,1,0.5,1,0.5,0.0,0.0,0.1177777328998122,5.7855177309102236e-05,16,1,17
org.apache.xerces.validators.datatype.BinaryDatatypeValidator,8,9,56,0.16071428571428573,1,0.125,7,0.875,47,0.8392857142857143,0.0,0.0,0.03014422547616426,0.00043347626965374396,1,7,8
org.apache.html.dom.HTMLBuilder,14,36,182,0.1978021978021978,1,0.07142857142857142,119,8.5,146,0.8021978021978022,0.0,0.0,0.0,0.0,0,13,13
org.apache.wml.dom.WMLSelectElementImpl,4,6,12,0.5,1,0.25,161,40.25,6,0.5,0.3333333333333333,0.08333333333333333,0.032002431156201785,0.0001079315072489134,1,3,4
org.apache.html.dom.HTMLLegendElementImpl,4,5,12,0.4166666666666667,1,0.25,117,29.25,7,0.5833333333333334,0.0,0.0,0.0,0.0,0,3,3
org.apache.xerces.validators.common.GrammarResolver,2,1,2,0.5,1,0.5,266,133.0,1,0.5,0.0,0.0,0.04253084799159884,0.0011009013739389166,8,1,9
org.w3c.dom.html.HTMLMenuElement,1,0,0,0,1,1.0,-1,-1.0,0,0,0.0,0.0,0.0017064846416382253,0.0,1,0,1
org.apache.html.dom.HTMLTableColElementImpl,4,5,12,0.4166666666666667,1,0.25,117,29.25,7,0.5833333333333334,0.0,0.0,0.0,0.0,0,3,3
org.apache.xerces.validators.datatype.NOTATIONDatatypeValidator,5,6,20,0.3,1,0.2,4,0.8,14,0.7,0.0,0.0,0.03014422547616426,1.7502406580904874e-06,1,4,5
org.w3c.dom.Comment,1,0,0,0,1,1.0,-1,-1.0,0,0,0.0,0.0,0.16914733266798915,0.0,9,0,9
org.apache.html.dom.HTMLMenuElementImpl,4,5,12,0.4166666666666667,1,0.25,117,29.25,7,0.5833333333333334,0.0,0.0,0.0,0.0,0,3,3
org.apache.xerces.validators.datatype.StateMessageDatatype,1,0,0,0,1,1.0,-1,-1.0,0,0,0.0,0.0,0.030050778323482893,0.0,3,0,3
org.apache.html.dom.HTMLFormElementImpl,6,13,30,0.43333333333333335,1,0.16666666666666666,116,19.333333333333332,17,0.5666666666666667,0.0,0.0,0.0,0.0,0,5,5
org.apache.xml.serialize.IndentPrinter,3,3,6,0.5,1,0.3333333333333333,22,7.333333333333333,3,0.5,0.0,0.0,0.020356810425069812,0.0,1,2,3
org.apache.xerces.dom.DeferredCDATASectionImpl,4,5,12,0.4166666666666667,1,0.25,87,21.75,7,0.5833333333333334,0.16666666666666666,0.041666666666666664,0.07904033322617932,1.0209737172194511e-05,1,3,4
org.apache.xml.serialize.DOMSerializer,4,5,12,0.4166666666666667,1,0.25,13,3.25,7,0.5833333333333334,0.0,0.0,0.020938691113823772,2.3531013292105442e-05,2,3,5
org.apache.wml.dom.WMLPostfieldElementImpl,4,6,12,0.5,1,0.25,161,40.25,6,0.5,0.3333333333333333,0.08333333333333333,0.032002431156201785,0.0001079315072489134,1,3,4
org.apache.html.dom.HTMLQuoteElementImpl,4,5,12,0.4166666666666667,1,0.25,117,29.25,7,0.5833333333333334,0.0,0.0,0.0,0.0,0,3,3
org.apache.xerces.validators.common.XMLAttributeDecl,3,4,6,0.6666666666666666,1,0.3333333333333333,1,0.3333333333333333,2,0.3333333333333333,0.0,0.0,0.04761181494916284,6.257110352673492e-05,9,3,12
org.apache.xerces.validators.datatype.URIReferenceDatatypeValidator,9,12,72,0.16666666666666666,1,0.1111111111111111,37,4.111111111111111,60,0.8333333333333334,0.0,0.0,0.03014422547616426,0.000788386180877649,1,8,9
org.w3c.dom.html.HTMLElement,1,0,0,0,1,1.0,-1,-1.0,0,0,0.0,0.0,0.055212466160182695,0.0,12,0,12
org.xml.sax.Parser,6,6,30,0.2,1,0.16666666666666666,8,1.3333333333333333,24,0.8,0.0,0.0,0.029763551947852292,9.397819978024758e-05,10,5,15
org.apache.wml.dom.WMLDOMImplementationImpl,11,38,110,0.34545454545454546,1,0.09090909090909091,163,14.818181818181818,72,0.6545454545454545,0.0,0.0,0.0,0.0,0,10,10
org.w3c.dom.traversal.TreeWalker,3,4,6,0.6666666666666666,1,0.3333333333333333,14,4.666666666666667,2,0.3333333333333333,0.0,0.0,0.11217009143736516,1.458533881742073e-06,4,2,6
org.w3c.dom.html.HTMLDirectoryElement,1,0,0,0,1,1.0,-1,-1.0,0,0,0.0,0.0,0.0017064846416382253,0.0,1,0,1
org.apache.xerces.utils.regex.RegexParser,7,20,42,0.47619047619047616,1,0.14285714285714285,28,4.0,22,0.5238095238095238,0.13333333333333333,0.019047619047619046,0.03558750940276146,0.00032739223865503733,2,6,8
org.apache.wml.WMLDOMImplementation,1,0,0,0,1,1.0,-1,-1.0,0,0,0.0,0.0,0.0017064846416382253,0.0,1,0,1
org.xml.sax.EntityResolver,2,1,2,0.5,1,0.5,0,0.0,1,0.5,0.0,0.0,0.06588743790108978,0.0,17,1,18
org.apache.html.dom.HTMLHeadingElementImpl,4,5,12,0.4166666666666667,1,0.25,117,29.25,7,0.5833333333333334,0.0,0.0,0.0,0.0,0,3,3
org.apache.xerces.readers.StringReader,10,15,90,0.16666666666666666,1,0.1,14,1.4,75,0.8333333333333334,0.0,0.0,0.026625426621160412,8.07055414563947e-05,2,10,12
org.w3c.dom.html.HTMLDOMImplementation,2,1,2,0.5,1,0.5,16,8.0,1,0.5,0.0,0.0,0.0017064846416382253,0.0,1,1,2
org.apache.wml.WMLTimerElement,1,0,0,0,1,1.0,-1,-1.0,0,0,0.0,0.0,0.02219967407680718,0.0,1,0,1
org.apache.wml.WMLHeadElement,1,0,0,0,1,1.0,-1,-1.0,0,0,0.0,0.0,0.02219967407680718,0.0,1,0,1
org.apache.html.dom.HTMLFrameElementImpl,4,5,12,0.4166666666666667,1,0.25,117,29.25,7,0.5833333333333334,0.0,0.0,0.0,0.0,0,3,3
org.apache.xerces.dom.DocumentImpl,53,242,2756,0.08780841799709724,1,0.018867924528301886,87,1.6415094339622642,2514,0.9121915820029027,0.32797978165625225,0.006188297767099099,0.15198892593396332,0.032171106551302606,43,52,95
org.apache.xerces.dom.DeferredAttrImpl,5,7,20,0.35,1,0.2,87,17.4,13,0.65,0.08333333333333333,0.016666666666666666,0.07904033322617932,9.0892127297133e-06,1,4,5
org.apache.html.dom.HTMLStyleElementImpl,4,5,12,0.4166666666666667,1,0.25,117,29.25,7,0.5833333333333334,0.0,0.0,0.0,0.0,0,3,3
org.apache.xerces.readers.UCSReader,14,23,182,0.12637362637362637,1,0.07142857142857142,19,1.3571428571428572,159,0.8736263736263736,0.0,0.0,0.027808211619859857,0.00016685627607129316,1,13,14
org.xml.sax.helpers.ParserFactory,2,1,2,0.5,1,0.5,9,4.5,1,0.5,0.0,0.0,0.007679180887372013,0.0,4,1,5
org.w3c.dom.html.HTMLAppletElement,1,0,0,0,1,1.0,-1,-1.0,0,0,0.0,0.0,0.034652303754266214,0.0,2,0,2
org.apache.html.dom.HTMLMapElementImpl,6,11,30,0.36666666666666664,1,0.16666666666666666,117,19.5,19,0.6333333333333333,0.0,0.0,0.0,0.0,0,5,5
org.xml.sax.Locator,1,0,0,0,1,1.0,-1,-1.0,0,0,0.0,0.0,0.09510912108213046,0.0,23,0,23
org.w3c.dom.ProcessingInstruction,1,0,0,0,1,1.0,-1,-1.0,0,0,0.0,0.0,0.17037749508739272,0.0,9,0,9
org.apache.xerces.validators.datatype.InvalidDatatypeFacetException,2,1,2,0.5,1,0.5,0,0.0,1,0.5,0.0,0.0,0.0407870897063161,0.00013564365100201278,15,1,16
org.w3c.dom.html.HTMLAreaElement,1,0,0,0,1,1.0,-1,-1.0,0,0,0.0,0.0,0.034652303754266214,0.0,2,0,2
org.apache.xerces.dom.NodeImpl,21,73,420,0.1738095238095238,1,0.047619047619047616,87,4.142857142857143,347,0.8261904761904761,0.055614035087719296,0.0026482873851294904,0.11773470531302532,0.0025991519880992123,16,21,37
org.apache.xerces.dom.DeferredElementImpl,6,10,30,0.3333333333333333,1,0.16666666666666666,87,14.5,20,0.6666666666666666,0.025,0.004166666666666667,0.07904033322617932,3.663698202947349e-06,1,5,6
org.apache.xerces.dom.CDATASectionImpl,4,7,12,0.5833333333333334,1,0.25,87,21.75,5,0.4166666666666667,0.0,0.0,0.10791005822124072,7.583361088218005e-05,2,3,5
org.apache.html.dom.HTMLHeadElementImpl,4,7,12,0.5833333333333334,1,0.25,115,28.75,5,0.4166666666666667,0.0,0.0,0.047358862761060834,0.0,1,3,4
org.xml.sax.DocumentHandler,3,2,6,0.3333333333333333,1,0.3333333333333333,1,0.3333333333333333,4,0.6666666666666666,0.0,0.0,0.03866281613721887,2.5135400562021726e-05,10,2,12
org.apache.xerces.dom.DeferredNotationImpl,5,7,20,0.35,1,0.2,87,17.4,13,0.65,0.08333333333333333,0.016666666666666666,0.07904033322617932,1.0209737172194511e-05,1,4,5
org.xml.sax.DTDHandler,1,0,0,0,1,1.0,-1,-1.0,0,0,0.0,0.0,0.037885674104309944,0.0,8,0,8
org.apache.wml.WMLEmElement,1,0,0,0,1,1.0,-1,-1.0,0,0,0.0,0.0,0.02219967407680718,0.0,1,0,1
org.apache.xerces.validators.datatype.DecimalDatatypeValidator,8,9,56,0.16071428571428573,1,0.125,37,4.625,47,0.8392857142857143,0.0,0.0,0.03014422547616426,0.0007277575792934163,1,7,8
org.w3c.dom.html.HTMLOptGroupElement,1,0,0,0,1,1.0,-1,-1.0,0,0,0.0,0.0,0.0017064846416382253,0.0,1,0,1
org.apache.xerces.dom.CommentImpl,5,7,20,0.35,1,0.2,87,17.4,13,0.65,0.25,0.05,0.10791005822124072,0.00022893615043785716,2,4,6
org.apache.xerces.dom.DeferredTextImpl,4,5,12,0.4166666666666667,1,0.25,87,21.75,7,0.5833333333333334,0.16666666666666666,0.041666666666666664,0.07904033322617932,1.1245233088236502e-05,1,3,4
org.apache.wml.dom.WMLImgElementImpl,4,6,12,0.5,1,0.25,161,40.25,6,0.5,0.3333333333333333,0.08333333333333333,0.032002431156201785,0.0001079315072489134,1,3,4
org.apache.wml.dom.WMLTableElementImpl,4,6,12,0.5,1,0.25,161,40.25,6,0.5,0.3333333333333333,0.08333333333333333,0.032002431156201785,0.0001079315072489134,1,3,4
javax.xml.parsers.FactoryConfigurationError,1,0,0,0,1,1.0,-1,-1.0,0,0,0.0,0.0,0.004550625711035267,0.0,2,0,2
org.w3c.dom.html.HTMLParamElement,1,0,0,0,1,1.0,-1,-1.0,0,0,0.0,0.0,0.0017064846416382253,0.0,1,0,1
org.apache.html.dom.HTMLImageElementImpl,4,5,12,0.4166666666666667,1,0.25,116,29.0,7,0.5833333333333334,0.0,0.0,0.0,0.0,0,3,3
org.xml.sax.helpers.XMLReaderAdapter,16,35,240,0.14583333333333334,1,0.0625,23,1.4375,205,0.8541666666666666,0.0,0.0,0.0,0.0,0,15,15
org.apache.xerces.dom.LCount,1,1,0,0,1,1.0,-1,-1.0,-1,0,0.0,0.0,0.09662347990324398,0.0,7,1,8
org.w3c.dom.DocumentFragment,1,0,0,0,1,1.0,-1,-1.0,0,0,0.0,0.0,0.17037749508739272,0.0,12,0,12
org.apache.xerces.readers.UTF8CharReader,7,14,42,0.3333333333333333,1,0.14285714285714285,19,2.7142857142857144,28,0.6666666666666666,0.0,0.0,0.026625426621160412,0.00025086782765963657,1,6,7
org.apache.html.dom.HTMLTableCellElementImpl,5,6,20,0.3,1,0.2,116,23.2,14,0.7,0.0,0.0,0.0030716723549488053,0.0,1,4,5
org.apache.wml.WMLWmlElement,1,0,0,0,1,1.0,-1,-1.0,0,0,0.0,0.0,0.02219967407680718,0.0,1,0,1
org.apache.xml.serialize.Serializer,5,4,20,0.2,1,0.2,27,5.4,16,0.8,0.0,0.0,0.020543570153740177,2.5670196318660486e-05,3,4,7
org.apache.xerces.utils.XMLMessageProvider,1,0,0,0,1,1.0,-1,-1.0,0,0,0.0,0.0,0.06352144190218903,0.0,5,0,5
org.apache.xerces.utils.regex.ParserForXMLSchema,5,11,20,0.55,1,0.2,28,5.6,9,0.45,0.0,0.0,0.03552280484021098,0.0,1,4,5
org.xml.sax.ErrorHandler,2,1,2,0.5,1,0.5,2,1.0,1,0.5,0.0,0.0,0.05385946047033521,5.858444424997326e-05,19,1,20
org.apache.xerces.utils.regex.BMPattern,1,0,0,0,1,1.0,-1,-1.0,0,0,0.0,0.0,0.035993556708984194,0.0,1,0,1
org.apache.wml.WMLAElement,1,0,0,0,1,1.0,-1,-1.0,0,0,0.0,0.0,0.02219967407680718,0.0,1,0,1
org.apache.wml.dom.WMLElementImpl,4,4,12,0.3333333333333333,1,0.25,161,40.25,8,0.6666666666666666,0.3333333333333333,0.08333333333333333,0.061478354589545536,0.0019413085965986987,36,3,39
org.apache.xerces.validators.datatype.FloatDatatypeValidator,8,9,56,0.16071428571428573,1,0.125,37,4.625,47,0.8392857142857143,0.0,0.0,0.03014422547616426,0.0007277575792934163,1,7,8
org.apache.wml.WMLBrElement,1,0,0,0,1,1.0,-1,-1.0,0,0,0.0,0.0,0.02219967407680718,0.0,1,0,1
org.apache.html.dom.CollectionIndex,1,0,0,0,1,1.0,-1,-1.0,0,0,0.0,0.0,0.03422449753507774,0.0,1,0,1
org.apache.html.dom.NameNodeListImpl,5,12,20,0.6,1,0.2,88,17.6,8,0.4,0.0,0.0,0.04821203456015743,0.000404861223973852,1,4,5
org.xml.sax.helpers.NamespaceSupport,2,3,2,1.5,1,0.5,0,0.0,-1,-0.5,0.0,0.0,0.03252254087922164,1.1668271053936583e-05,2,1,3
org.w3c.dom.events.MutationEvent,2,2,2,1.0,1,0.5,13,6.5,0,0.0,0.0,0.0,0.09759202901229243,2.100288789708585e-05,7,1,8
org.apache.xml.serialize.SerializerFactory,5,11,20,0.55,1,0.2,46,9.2,9,0.45,0.0,0.0,0.0017064846416382253,0.0,2,5,7
org.apache.wml.WMLElement,1,0,0,0,1,1.0,-1,-1.0,0,0,0.0,0.0,0.032423208191126277,0.0,1,0,1
org.apache.xerces.validators.datatype.ENTITYDatatypeValidator,9,12,72,0.16666666666666666,1,0.1111111111111111,54,6.0,60,0.8333333333333334,0.0,0.0,0.03014422547616426,0.0004926662264546223,1,8,9
org.apache.xerces.validators.schema.EquivClassComparator,7,12,42,0.2857142857142857,1,0.14285714285714285,266,38.0,30,0.7142857142857143,0.0,0.0,0.031149353458635773,0.0060793150724891346,5,6,11
org.w3c.dom.html.HTMLOListElement,1,0,0,0,1,1.0,-1,-1.0,0,0,0.0,0.0,0.0017064846416382253,0.0,1,0,1
org.apache.xerces.dom.NodeIteratorImpl,7,16,42,0.38095238095238093,1,0.14285714285714285,87,12.428571428571429,26,0.6190476190476191,0.0,0.0,0.1076156242288226,0.0,1,6,7
org.apache.wml.dom.WMLGoElementImpl,4,6,12,0.5,1,0.25,161,40.25,6,0.5,0.3333333333333333,0.08333333333333333,0.032002431156201785,0.0001079315072489134,1,3,4
org.apache.xerces.dom.DeferredProcessingInstructionImpl,4,5,12,0.4166666666666667,1,0.25,87,21.75,7,0.5833333333333334,0.16666666666666666,0.041666666666666664,0.07904033322617932,1.2217589009397886e-05,1,3,4
org.w3c.dom.html.HTMLIsIndexElement,2,1,2,0.5,1,0.5,15,7.5,1,0.5,0.0,0.0,0.0017064846416382253,1.458533881742073e-06,1,1,2
org.apache.wml.dom.WMLMetaElementImpl,4,6,12,0.5,1,0.25,161,40.25,6,0.5,0.3333333333333333,0.08333333333333333,0.032002431156201785,0.0001079315072489134,1,3,4
org.apache.xerces.readers.AbstractCharReader,14,24,182,0.13186813186813187,1,0.07142857142857142,18,1.2857142857142858,158,0.8681318681318682,0.0,0.0,0.023277018157564236,0.00027031494608286414,2,13,15
