name,Size,Ties,Pairs,Density,WeakComp,nWeakComp,2StepReach,ReachEffic,Broker,nBroker,EgoBetween,nEgoBetween,Closeness_Centrality,Betweenness_Centrality,in_degree,out_degree,degree
org.apache.xerces.readers.StreamingCharReader,14,24,182,0.13186813186813187,1,0.07142857142857142,18,1.2857142857142858,158,0.8681318681318682,0.0,0.0,0.0,0.0,0,13,13
org.apache.xml.serialize.OutputFormat,10,11,90,0.12222222222222222,1,0.1,24,2.4,79,0.8777777777777778,0.0,0.0,0.03134937460250159,0.002619271271498592,11,9,20
org.w3c.dom.html.HTMLFrameSetElement,1,0,0,0,1,1.0,-1,-1.0,0,0,0.0,0.0,0.04615122373897357,0.0,2,0,2
org.w3c.dom.html.HTMLLIElement,1,0,0,0,1,1.0,-1,-1.0,0,0,0.0,0.0,0.0016051364365971107,0.0,1,0,1
org.apache.xerces.validators.dtd.DTDGrammar,12,30,132,0.22727272727272727,1,0.08333333333333333,296,24.666666666666668,102,0.7727272727272727,0.0,0.0,0.031129918770368206,0.0028175692763466884,2,11,13
javax.xml.parsers.SAXParser,9,16,72,0.2222222222222222,1,0.1111111111111111,17,1.8888888888888888,56,0.7777777777777778,0.0,0.0,0.004815409309791332,4.825322110731885e-05,3,8,11
org.apache.wml.WMLOneventElement,1,0,0,0,1,1.0,-1,-1.0,0,0,0.0,0.0,0.02088123436438043,0.0,1,0,1
org.w3c.dom.html.HTMLHtmlElement,1,0,0,0,1,1.0,-1,-1.0,0,0,0.0,0.0,0.04615122373897357,0.0,2,0,2
org.apache.wml.WMLFieldsetElement,1,0,0,0,1,1.0,-1,-1.0,0,0,0.0,0.0,0.02088123436438043,0.0,1,0,1
org.apache.xerces.dom.DocumentFragmentImpl,4,7,12,0.5833333333333334,1,0.25,85,21.25,5,0.4166666666666667,0.0,0.0,0.09845883354852888,0.0,1,3,4
org.apache.xerces.validators.common.CMNode,3,4,6,0.6666666666666666,1,0.3333333333333333,3,1.0,2,0.3333333333333333,0.0,0.0,0.03371253126283176,3.440806938043107e-05,6,2,8
org.apache.xerces.validators.datatype.DatatypeValidator,1,0,0,0,1,1.0,-1,-1.0,0,0,0.0,0.0,0.06698035019251147,0.0,27,0,27
org.w3c.dom.events.DocumentEvent,2,1,2,0.5,1,0.5,2,1.0,1,0.5,0.0,0.0,0.09909760012527895,0.0,1,1,2
org.apache.html.dom.HTMLTitleElementImpl,7,12,42,0.2857142857142857,1,0.14285714285714285,113,16.142857142857142,30,0.7142857142857143,0.2,0.028571428571428574,0.0449438202247191,0.0001428242094193074,1,6,7
org.apache.wml.dom.WMLSmallElementImpl,4,6,12,0.5,1,0.25,159,39.75,6,0.5,0.3333333333333333,0.08333333333333333,0.030101805228786915,9.54823925306963e-05,1,3,4
org.apache.html.dom.HTMLButtonElementImpl,5,6,20,0.3,1,0.2,115,23.0,14,0.7,0.0,0.0,0.0,0.0,0,4,4
org.apache.xerces.utils.regex.REUtil,4,7,12,0.5833333333333334,1,0.25,28,7.0,5,0.4166666666666667,0.3333333333333333,0.08333333333333333,0.034066221210198214,0.0002535014511603262,7,3,10
org.apache.xerces.dom.ParentNode,14,54,182,0.2967032967032967,1,0.07142857142857142,85,6.071428571428571,128,0.7032967032967034,0.08119658119658117,0.005799755799755798,0.09992472188920178,0.00561393278606045,7,13,20
javax.xml.parsers.DocumentBuilderFactory,4,4,12,0.3333333333333333,1,0.25,22,5.5,8,0.6666666666666666,0.0,0.0,0.0016051364365971107,2.5806052035323325e-06,2,4,6
org.apache.xerces.utils.regex.RangeToken,3,8,6,1.3333333333333333,1,0.3333333333333333,28,9.333333333333334,-2,-0.3333333333333333,0.0,0.0,0.034172181462796034,0.00010804133785455365,7,3,10
org.apache.xerces.validators.common.CMException,1,0,0,0,1,1.0,-1,-1.0,0,0,0.0,0.0,0.04104485705609301,0.0,11,0,11
org.apache.html.dom.HTMLFormControl,1,0,0,0,1,1.0,-1,-1.0,0,0,0.0,0.0,0.03529201942949464,0.0,8,0,8
org.apache.xerces.validators.datatype.BooleanDatatypeValidator,8,9,56,0.16071428571428573,1,0.125,37,4.625,47,0.8392857142857143,0.0,0.0,0.026196449999220807,0.0005467305738561,1,7,8
org.apache.wml.WMLPrevElement,1,0,0,0,1,1.0,-1,-1.0,0,0,0.0,0.0,0.02088123436438043,0.0,1,0,1
org.w3c.dom.html.HTMLUListElement,1,0,0,0,1,1.0,-1,-1.0,0,0,0.0,0.0,0.0016051364365971107,0.0,1,0,1
org.apache.html.dom.HTMLDListElementImpl,4,5,12,0.4166666666666667,1,0.25,115,28.75,7,0.5833333333333334,0.0,0.0,0.0,0.0,0,3,3
org.apache.xerces.validators.schema.SubstitutionGroupComparator,7,12,42,0.2857142857142857,1,0.14285714285714285,296,42.285714285714285,30,0.7142857142857143,0.0,0.0,0.03368155145646396,0.007659881395384846,5,6,11
org.apache.xerces.dom.DocumentTypeImpl,7,21,42,0.5,1,0.14285714285714285,85,12.142857142857142,21,0.5,0.06666666666666667,0.009523809523809523,0.11047918496940554,0.0002391421620414204,6,6,12
org.apache.xerces.validators.schema.identity.Unique,2,1,2,0.5,1,0.5,29,14.5,1,0.5,0.0,0.0,0.025686097952472304,0.0,3,1,4
org.apache.html.dom.HTMLMetaElementImpl,4,5,12,0.4166666666666667,1,0.25,115,28.75,7,0.5833333333333334,0.0,0.0,0.0,0.0,0,3,3
org.apache.xerces.dom.TreeWalkerImpl,4,7,12,0.5833333333333334,1,0.25,15,3.75,5,0.4166666666666667,0.0,0.0,0.09909760012527895,0.0,1,3,4
org.apache.wml.dom.WMLOptgroupElementImpl,4,6,12,0.5,1,0.25,159,39.75,6,0.5,0.3333333333333333,0.08333333333333333,0.030101805228786915,9.54823925306963e-05,1,3,4
org.apache.xml.serialize.Method,1,0,0,0,1,1.0,-1,-1.0,0,0,0.0,0.0,0.026638970194819502,0.0,7,0,7
org.apache.wml.WMLSetvarElement,1,0,0,0,1,1.0,-1,-1.0,0,0,0.0,0.0,0.02088123436438043,0.0,1,0,1
org.apache.html.dom.HTMLFieldSetElementImpl,5,6,20,0.3,1,0.2,115,23.0,14,0.7,0.0,0.0,0.0,0.0,0,4,4
org.apache.xerces.dom.EntityReferenceImpl,10,36,90,0.4,1,0.1,85,8.5,54,0.6,0.0,0.0,0.1076728955116265,4.149244509393767e-05,3,9,12
org.apache.xerces.dom.ElementImpl,17,72,272,0.2647058823529412,1,0.058823529411764705,85,5.0,200,0.7352941176470589,0.13368055555555552,0.007863562091503266,0.11424017850027891,0.004630427406107005,12,16,28
org.w3c.dom.html.HTMLAnchorElement,1,0,0,0,1,1.0,-1,-1.0,0,0,0.0,0.0,0.032924871784833415,0.0,2,0,2
org.apache.xerces.dom.TextImpl,7,14,42,0.3333333333333333,1,0.14285714285714285,85,12.142857142857142,28,0.6666666666666666,0.1,0.014285714285714287,0.10913187783563229,0.0004676474448232826,8,6,14
org.apache.xerces.validators.schema.SchemaGrammar,12,38,132,0.2878787878787879,1,0.08333333333333333,296,24.666666666666668,94,0.7121212121212122,0.004545454545454545,0.0003787878787878788,0.0324065400448628,0.007926070822129207,3,11,14
org.xml.sax.helpers.XMLFilterImpl,15,29,210,0.1380952380952381,1,0.06666666666666667,13,0.8666666666666667,181,0.861904761904762,0.0,0.0,0.0,0.0,0,14,14
org.apache.xerces.validators.datatype.IDREFDatatypeValidator,8,9,56,0.16071428571428573,1,0.125,8,1.0,47,0.8392857142857143,0.0,0.0,0.0,0.0,0,7,7
org.apache.xerces.dom.ElementNSImpl,4,8,12,0.6666666666666666,1,0.25,85,21.25,4,0.3333333333333333,0.0,0.0,0.09870015421899098,6.76610107173763e-05,2,3,5
org.w3c.dom.html.HTMLScriptElement,1,0,0,0,1,1.0,-1,-1.0,0,0,0.0,0.0,0.0016051364365971107,0.0,1,0,1
org.apache.xerces.readers.XMLEntityReader,5,5,20,0.25,1,0.2,6,1.2,15,0.75,0.0,0.0,0.028865949018510615,1.2903026017661663e-05,6,4,10
org.apache.wml.dom.WMLTemplateElementImpl,4,6,12,0.5,1,0.25,159,39.75,6,0.5,0.3333333333333333,0.08333333333333333,0.030101805228786915,9.54823925306963e-05,1,3,4
org.w3c.dom.Document,13,22,156,0.14102564102564102,1,0.07692307692307693,12,0.9230769230769231,134,0.8589743589743589,0.3484848484848485,0.026806526806526808,0.19261867862216564,0.0028330723645118784,48,12,60
org.apache.html.dom.HTMLElementImpl,7,12,42,0.2857142857142857,1,0.14285714285714285,113,16.142857142857142,30,0.7142857142857143,0.06666666666666667,0.009523809523809523,0.08389513108614233,0.002341905366503693,53,6,59
org.w3c.dom.html.HTMLPreElement,1,0,0,0,1,1.0,-1,-1.0,0,0,0.0,0.0,0.0016051364365971107,0.0,1,0,1
org.apache.html.dom.HTMLBodyElementImpl,4,7,12,0.5833333333333334,1,0.25,113,28.25,5,0.4166666666666667,0.0,0.0,0.0449438202247191,0.0,1,3,4
org.apache.xerces.utils.CharDataChunk,6,8,30,0.26666666666666666,1,0.16666666666666666,7,1.1666666666666667,22,0.7333333333333333,0.0,0.0,0.03747575367727597,5.075190233613587e-05,6,6,12
org.apache.xerces.utils.SymbolCache,1,0,0,0,1,1.0,-1,-1.0,0,0,0.0,0.0,0.10561544532336957,0.0,2,0,2
org.apache.xerces.readers.XMLEntityHandler,3,2,6,0.3333333333333333,1,0.3333333333333333,2,0.6666666666666666,4,0.6666666666666666,0.0,0.0,0.06346510383615164,0.00018231975762955942,22,2,24
org.apache.xerces.dom.NamedNodeMapImpl,6,18,30,0.6,1,0.16666666666666666,85,14.166666666666666,12,0.4,0.0,0.0,0.09520014875023242,4.5131917670665455e-05,7,6,13
org.apache.wml.dom.WMLStrongElementImpl,4,6,12,0.5,1,0.25,159,39.75,6,0.5,0.3333333333333333,0.08333333333333333,0.030101805228786915,9.54823925306963e-05,1,3,4
org.apache.xerces.utils.Base64,1,0,0,0,1,1.0,-1,-1.0,0,0,0.0,0.0,0.022338959417611104,0.0,1,0,1
org.apache.xml.serialize.SieveEncodingInfo,3,2,6,0.3333333333333333,1,0.3333333333333333,1,0.3333333333333333,4,0.6666666666666666,0.0,0.0,0.022796100230095914,0.00023999628392850692,1,2,3
org.w3c.dom.html.HTMLHRElement,1,0,0,0,1,1.0,-1,-1.0,0,0,0.0,0.0,0.0016051364365971107,0.0,1,0,1
org.apache.xerces.readers.CharReader,6,11,30,0.36666666666666664,1,0.16666666666666666,19,3.1666666666666665,19,0.6333333333333333,0.0,0.0,0.02735389190108809,0.0002322544683179099,1,5,6
org.apache.xerces.framework.XMLDocumentHandler,2,2,2,1.0,1,0.5,0,0.0,0,0.0,0.0,0.0,0.03843540204567024,1.1612723415895497e-06,4,1,5
org.apache.html.dom.HTMLObjectElementImpl,5,6,20,0.3,1,0.2,114,22.8,14,0.7,0.0,0.0,0.0,0.0,0,4,4
org.apache.wml.WMLCardElement,1,0,0,0,1,1.0,-1,-1.0,0,0,0.0,0.0,0.02088123436438043,0.0,1,0,1
org.apache.xerces.readers.DefaultReaderFactory,13,35,156,0.22435897435897437,1,0.07692307692307693,34,2.6153846153846154,121,0.7756410256410257,0.0,0.0,0.03332503090348887,0.0017165325612162564,1,12,13
org.w3c.dom.NamedNodeMap,2,3,2,1.5,1,0.5,12,6.0,-1,-0.5,0.0,0.0,0.1766305669578752,4.447242967420719e-05,36,1,37
org.apache.xerces.validators.common.XMLElementDecl,3,4,6,0.6666666666666666,1,0.3333333333333333,1,0.3333333333333333,2,0.3333333333333333,0.0,0.0,0.052921106334239416,6.357505247845008e-05,10,3,13
org.apache.html.dom.HTMLOListElementImpl,4,5,12,0.4166666666666667,1,0.25,115,28.75,7,0.5833333333333334,0.0,0.0,0.0,0.0,0,3,3
org.apache.xerces.validators.schema.XUtil,9,29,72,0.4027777777777778,1,0.1111111111111111,86,9.555555555555555,43,0.5972222222222222,0.0,0.0,0.02830994666804743,0.000468121783920765,3,8,11
org.apache.xerces.readers.UTF8Recognizer,10,23,90,0.25555555555555554,1,0.1,26,2.6,67,0.7444444444444445,0.05555555555555555,0.005555555555555555,0.034305026745215295,0.0003864456292289668,1,9,10
org.apache.html.dom.HTMLIsIndexElementImpl,4,5,12,0.4166666666666667,1,0.25,115,28.75,7,0.5833333333333334,0.0,0.0,0.0,0.0,0,3,3
org.apache.xerces.framework.XMLParser,26,76,650,0.11692307692307692,1,0.038461538461538464,296,11.384615384615385,574,0.8830769230769231,0.009583333333333334,0.0003685897435897436,0.04262602985154153,0.03389980587294953,15,25,40
org.w3c.dom.html.HTMLBodyElement,1,0,0,0,1,1.0,-1,-1.0,0,0,0.0,0.0,0.04615122373897357,0.0,2,0,2
org.apache.xerces.validators.datatype.ListDatatypeValidator,10,29,90,0.32222222222222224,1,0.1,40,4.0,61,0.6777777777777778,0.0,0.0,0.026774297607064155,0.0005395417450748314,2,9,11
org.apache.wml.WMLDOMImplementation,1,0,0,0,1,1.0,-1,-1.0,0,0,0.0,0.0,0.0016051364365971107,0.0,1,0,1
org.apache.wml.dom.WMLAElementImpl,4,6,12,0.5,1,0.25,159,39.75,6,0.5,0.3333333333333333,0.08333333333333333,0.030101805228786915,9.54823925306963e-05,1,3,4
org.xml.sax.EntityResolver,2,1,2,0.5,1,0.5,0,0.0,1,0.5,0.0,0.0,0.06934795117962386,0.0,18,1,19
org.xml.sax.ext.DeclHandler,1,0,0,0,1,1.0,-1,-1.0,0,0,0.0,0.0,0.03101045296167247,0.0,5,0,5
org.apache.html.dom.HTMLHeadingElementImpl,4,5,12,0.4166666666666667,1,0.25,115,28.75,7,0.5833333333333334,0.0,0.0,0.0,0.0,0,3,3
org.apache.xerces.validators.schema.TraverseSchema,46,143,2070,0.06908212560386473,1,0.021739130434782608,296,6.434782608695652,1927,0.9309178743961353,0.016582491582491584,0.0003604889474454692,0.03084946905171624,0.011623131456167985,2,45,47
org.apache.xerces.readers.StringReader,10,15,90,0.16666666666666666,1,0.1,14,1.4,75,0.8333333333333334,0.0,0.0,0.02735389190108809,7.59128030705761e-05,2,10,12
org.xml.sax.ContentHandler,3,2,6,0.3333333333333333,1,0.3333333333333333,1,0.3333333333333333,4,0.6666666666666666,0.0,0.0,0.04018786041257951,3.57413820689228e-05,10,2,12
org.w3c.dom.html.HTMLDOMImplementation,2,1,2,0.5,1,0.5,16,8.0,1,0.5,0.0,0.0,0.0032102728731942215,0.0,2,1,3
org.w3c.dom.DocumentType,2,1,2,0.5,1,0.5,12,6.0,1,0.5,0.0,0.0,0.17231696699360835,5.8776355659500705e-05,18,1,19
org.apache.wml.WMLTimerElement,1,0,0,0,1,1.0,-1,-1.0,0,0,0.0,0.0,0.02088123436438043,0.0,1,0,1
org.apache.html.dom.HTMLTableElementImpl,13,51,156,0.3269230769230769,1,0.07692307692307693,120,9.23076923076923,105,0.6730769230769231,0.022727272727272728,0.0017482517482517483,0.002140181915462814,7.741815610596997e-06,1,12,13
org.apache.wml.WMLHeadElement,1,0,0,0,1,1.0,-1,-1.0,0,0,0.0,0.0,0.02088123436438043,0.0,1,0,1
org.apache.wml.WMLAccessElement,1,0,0,0,1,1.0,-1,-1.0,0,0,0.0,0.0,0.02088123436438043,0.0,1,0,1
org.apache.html.dom.HTMLFrameElementImpl,4,5,12,0.4166666666666667,1,0.25,115,28.75,7,0.5833333333333334,0.0,0.0,0.0,0.0,0,3,3
org.apache.wml.WMLSmallElement,1,0,0,0,1,1.0,-1,-1.0,0,0,0.0,0.0,0.02088123436438043,0.0,1,0,1
org.apache.xerces.dom.DocumentImpl,49,205,2352,0.08715986394557823,1,0.02040816326530612,85,1.7346938775510203,2147,0.9128401360544217,0.3318051334008781,0.006771533334711798,0.13536021150033045,0.027090333361010455,43,48,91
org.apache.xerces.dom.AttrNSImpl,4,8,12,0.6666666666666666,1,0.25,85,21.25,4,0.3333333333333333,0.0,0.0,0.09870015421899098,7.698191094061095e-05,2,3,5
org.apache.xerces.dom.DeferredAttrImpl,5,8,20,0.4,1,0.2,85,17.0,12,0.6,0.08333333333333333,0.016666666666666666,0.07555283850159158,1.1790331585379922e-05,1,4,5
org.apache.html.dom.HTMLAreaElementImpl,4,5,12,0.4166666666666667,1,0.25,114,28.5,7,0.5833333333333334,0.0,0.0,0.0,0.0,0,3,3
org.apache.html.dom.HTMLStyleElementImpl,4,5,12,0.4166666666666667,1,0.25,115,28.75,7,0.5833333333333334,0.0,0.0,0.0,0.0,0,3,3
org.apache.xerces.validators.common.CMAny,5,8,20,0.4,1,0.2,9,1.8,12,0.6,0.0,0.0,0.030974412236804832,3.7633825884846464e-05,2,4,6
org.apache.xerces.readers.UCSReader,14,23,182,0.12637362637362637,1,0.07142857142857142,19,1.3571428571428572,159,0.8736263736263736,0.0,0.0,0.028281137939278028,0.0001490299505039922,1,13,14
org.apache.wml.dom.WMLRefreshElementImpl,4,6,12,0.5,1,0.25,159,39.75,6,0.5,0.3333333333333333,0.08333333333333333,0.030101805228786915,9.54823925306963e-05,1,3,4
org.xml.sax.helpers.ParserFactory,2,1,2,0.5,1,0.5,9,4.5,1,0.5,0.0,0.0,0.0072231139646869984,0.0,4,1,5
org.apache.xerces.framework.XMLAttrList,4,4,12,0.3333333333333333,1,0.25,6,1.5,8,0.6666666666666666,0.0,0.0,0.10256986178296146,0.0008632124405815652,8,3,11
org.apache.xerces.dom.DeepNodeListImpl,4,8,12,0.6666666666666666,1,0.25,85,21.25,4,0.3333333333333333,0.16666666666666666,0.041666666666666664,0.09930866318458276,9.691606208821425e-06,3,3,6
org.apache.xerces.dom.DeferredElementNSImpl,6,8,30,0.26666666666666666,1,0.16666666666666666,85,14.166666666666666,22,0.7333333333333333,0.1,0.016666666666666666,0.07555283850159158,1.2208720331949392e-05,1,5,6
org.apache.html.dom.HTMLDOMImplementationImpl,6,9,30,0.3,1,0.16666666666666666,115,19.166666666666668,21,0.7,0.0,0.0,0.0016051364365971107,0.0002503187047426363,1,5,6
org.apache.xerces.jaxp.SAXParserFactoryImpl,8,21,56,0.375,1,0.125,308,38.5,35,0.625,0.0,0.0,0.0,0.0,0,7,7
org.w3c.dom.html.HTMLBaseFontElement,1,0,0,0,1,1.0,-1,-1.0,0,0,0.0,0.0,0.0016051364365971107,0.0,1,0,1
org.apache.html.dom.HTMLDivElementImpl,4,5,12,0.4166666666666667,1,0.25,115,28.75,7,0.5833333333333334,0.0,0.0,0.0,0.0,0,3,3
org.apache.xerces.utils.HexBin,1,0,0,0,1,1.0,-1,-1.0,0,0,0.0,0.0,0.022338959417611104,0.0,1,0,1
org.apache.xerces.dom.AttributeMap,11,47,110,0.42727272727272725,1,0.09090909090909091,85,7.7272727272727275,63,0.5727272727272728,0.03703703703703704,0.0033670033670033673,0.08678806664083688,0.00010395889933884196,1,10,11
org.apache.xerces.readers.XCatalog,5,11,20,0.55,1,0.2,304,60.8,9,0.45,0.0,0.0,0.0032102728731942215,0.0007767621662632321,3,5,8
javax.xml.parsers.DocumentBuilder,6,6,30,0.2,1,0.16666666666666666,19,3.1666666666666665,24,0.8,0.0,0.0,0.004815409309791332,6.752583615909604e-05,3,5,8
org.apache.wml.WMLTrElement,1,0,0,0,1,1.0,-1,-1.0,0,0,0.0,0.0,0.02088123436438043,0.0,1,0,1
org.w3c.dom.html.HTMLFrameElement,1,0,0,0,1,1.0,-1,-1.0,0,0,0.0,0.0,0.0016051364365971107,0.0,1,0,1
org.w3c.dom.html.HTMLDivElement,1,0,0,0,1,1.0,-1,-1.0,0,0,0.0,0.0,0.0016051364365971107,0.0,1,0,1
org.apache.xerces.utils.regex.Match,2,2,2,1.0,1,0.5,28,14.0,0,0.0,0.0,0.0,0.0330914347599064,7.225694569890532e-05,3,1,4
org.apache.wml.WMLNoopElement,1,0,0,0,1,1.0,-1,-1.0,0,0,0.0,0.0,0.02088123436438043,0.0,1,0,1
org.apache.xerces.utils.XMLMessages,2,1,2,0.5,1,0.5,0,0.0,1,0.5,0.0,0.0,0.04601999124471034,3.709619980077728e-05,15,1,16
org.apache.xerces.dom.RangeImpl,11,27,110,0.24545454545454545,1,0.09090909090909091,85,7.7272727272727275,83,0.7545454545454545,0.08333333333333334,0.007575757575757577,0.09845883354852888,0.0012324226619618156,1,10,11
org.apache.wml.dom.WMLTimerElementImpl,4,6,12,0.5,1,0.25,159,39.75,6,0.5,0.3333333333333333,0.08333333333333333,0.030101805228786915,9.54823925306963e-05,1,3,4
org.xml.sax.SAXNotRecognizedException,2,1,2,0.5,1,0.5,0,0.0,1,0.5,0.0,0.0,0.047978436657681936,1.376322775217244e-06,13,1,14
org.xml.sax.helpers.DefaultHandler,10,15,90,0.16666666666666666,1,0.1,8,0.8,75,0.8333333333333334,0.0,0.0,0.007865168539325841,3.911664982719366e-05,4,9,13
org.apache.xerces.dom.DeferredAttrNSImpl,5,7,20,0.35,1,0.2,85,17.0,13,0.65,0.08333333333333333,0.016666666666666666,0.07555283850159158,9.032118212363164e-06,1,4,5
org.w3c.dom.html.HTMLTableSectionElement,3,2,6,0.3333333333333333,1,0.3333333333333333,15,5.0,4,0.6666666666666666,0.0,0.0,0.03406999960850331,0.0,5,2,7
org.apache.xerces.framework.XMLContentSpec,3,4,6,0.6666666666666666,1,0.3333333333333333,5,1.6666666666666667,2,0.3333333333333333,0.5,0.16666666666666666,0.05857126643643498,9.191255533247662e-05,16,3,19
org.apache.xerces.dom.ChildNode,4,11,12,0.9166666666666666,1,0.25,85,21.25,1,0.08333333333333333,0.0,0.0,0.08735284798557118,1.0580481334482565e-05,6,4,10
org.apache.xerces.validators.schema.identity.KeyRef,2,1,2,0.5,1,0.5,29,14.5,1,0.5,0.0,0.0,0.02593916295693016,0.0,4,1,5
org.apache.html.dom.HTMLAnchorElementImpl,4,5,12,0.4166666666666667,1,0.25,114,28.5,7,0.5833333333333334,0.0,0.0,0.0,0.0,0,3,3
org.xml.sax.helpers.NamespaceSupport,2,3,2,1.5,1,0.5,0,0.0,-1,-0.5,0.0,0.0,0.030317239886738685,1.032242081412933e-05,2,1,3
org.apache.wml.dom.WMLDocumentImpl,42,115,1722,0.06678281068524972,1,0.023809523809523808,159,3.7857142857142856,1607,0.9332171893147503,0.8567073170731707,0.02039779326364692,0.0593900481540931,0.012911757065266935,37,41,78
org.w3c.dom.events.MutationEvent,2,2,2,1.0,1,0.5,13,6.5,0,0.0,0.0,0.0,0.0894173788555811,3.664459389015912e-05,7,1,8
org.apache.xerces.utils.UTF8DataChunk,6,8,30,0.26666666666666666,1,0.16666666666666666,7,1.1666666666666667,22,0.7333333333333333,0.0,0.0,0.023319151033787965,7.741815610596997e-06,2,6,8
org.apache.xml.serialize.SerializerFactory,6,13,30,0.43333333333333335,1,0.16666666666666666,49,8.166666666666666,17,0.5666666666666667,0.0,0.0,0.0016051364365971107,0.0,2,6,8
org.apache.wml.WMLDocument,1,0,0,0,1,1.0,-1,-1.0,0,0,0.0,0.0,0.03090422685928304,0.0,1,0,1
org.apache.wml.WMLElement,1,0,0,0,1,1.0,-1,-1.0,0,0,0.0,0.0,0.030497592295345103,0.0,1,0,1
org.apache.xerces.validators.datatype.ENTITYDatatypeValidator,8,11,56,0.19642857142857142,1,0.125,53,6.625,45,0.8035714285714286,0.0,0.0,0.0,0.0,0,7,7
org.apache.xml.serialize.ElementState,1,0,0,0,1,1.0,-1,-1.0,0,0,0.0,0.0,0.025028121484814397,0.0,4,0,4
org.apache.xerces.readers.UCSRecognizer,9,22,72,0.3055555555555556,1,0.1111111111111111,26,2.888888888888889,50,0.6944444444444444,0.03571428571428571,0.003968253968253968,0.034305026745215295,0.0003554783667865788,1,8,9
org.apache.xerces.validators.schema.identity.IdentityConstraint,3,4,6,0.6666666666666666,1,0.3333333333333333,28,9.333333333333334,2,0.3333333333333333,1.0,0.3333333333333333,0.0364190620068252,0.00029182343843278126,14,2,16
org.xml.sax.AttributeList,1,0,0,0,1,1.0,-1,-1.0,0,0,0.0,0.0,0.10022318899856258,0.0,18,0,18
org.w3c.dom.html.HTMLImageElement,1,0,0,0,1,1.0,-1,-1.0,0,0,0.0,0.0,0.032924871784833415,0.0,2,0,2
org.apache.wml.WMLPElement,1,0,0,0,1,1.0,-1,-1.0,0,0,0.0,0.0,0.02088123436438043,0.0,1,0,1
org.apache.wml.dom.WMLSetvarElementImpl,4,6,12,0.5,1,0.25,159,39.75,6,0.5,0.3333333333333333,0.08333333333333333,0.030101805228786915,9.54823925306963e-05,1,3,4
org.w3c.dom.html.HTMLLegendElement,2,1,2,0.5,1,0.5,15,7.5,1,0.5,0.0,0.0,0.0016051364365971107,1.2903026017661663e-06,1,1,2
org.apache.wml.WMLAnchorElement,1,0,0,0,1,1.0,-1,-1.0,0,0,0.0,0.0,0.02088123436438043,0.0,1,0,1
org.apache.xerces.validators.datatype.DoubleDatatypeValidator,8,9,56,0.16071428571428573,1,0.125,37,4.625,47,0.8392857142857143,0.0,0.0,0.0273571079628725,0.0005501713807941431,3,7,10
org.apache.xerces.validators.common.SimpleContentModel,9,18,72,0.25,1,0.1111111111111111,296,32.888888888888886,54,0.75,0.0,0.0,0.030303460749915953,0.00121236832461949,1,8,9
org.apache.html.dom.HTMLModElementImpl,4,5,12,0.4166666666666667,1,0.25,115,28.75,7,0.5833333333333334,0.0,0.0,0.0,0.0,0,3,3
org.apache.wml.dom.WMLWmlElementImpl,4,6,12,0.5,1,0.25,159,39.75,6,0.5,0.3333333333333333,0.08333333333333333,0.030101805228786915,9.54823925306963e-05,1,3,4
org.w3c.dom.ranges.Range,3,4,6,0.6666666666666666,1,0.3333333333333333,13,4.333333333333333,2,0.3333333333333333,0.0,0.0,0.10022487608268218,3.82789771857296e-05,6,3,9
org.apache.xerces.dom.DeferredEntityImpl,5,7,20,0.35,1,0.2,85,17.0,13,0.65,0.08333333333333333,0.016666666666666666,0.07555283850159158,9.032118212363164e-06,1,4,5
org.apache.xerces.utils.StringHasher,1,0,0,0,1,1.0,-1,-1.0,0,0,0.0,0.0,0.1059870036182627,0.0,6,0,6
org.w3c.dom.html.HTMLFieldSetElement,2,1,2,0.5,1,0.5,15,7.5,1,0.5,0.0,0.0,0.0016051364365971107,1.2903026017661663e-06,1,1,2
org.apache.html.dom.HTMLHtmlElementImpl,4,7,12,0.5833333333333334,1,0.25,113,28.25,5,0.4166666666666667,0.0,0.0,0.0449438202247191,0.0,1,3,4
org.w3c.dom.html.HTMLMapElement,2,1,2,0.5,1,0.5,14,7.0,1,0.5,0.0,0.0,0.0016051364365971107,0.0,1,1,2
org.xml.sax.ext.LexicalHandler,1,0,0,0,1,1.0,-1,-1.0,0,0,0.0,0.0,0.030935001737921446,0.0,4,0,4
org.w3c.dom.Attr,2,2,2,1.0,1,0.5,12,6.0,0,0.0,0.0,0.0,0.18339617006980477,7.836437801393183e-05,29,1,30
org.apache.xml.serialize.LineSeparator,1,0,0,0,1,1.0,-1,-1.0,0,0,0.0,0.0,0.02632921472743788,0.0,1,0,1
org.xml.sax.helpers.AttributeListImpl,2,1,2,0.5,1,0.5,0,0.0,1,0.5,0.0,0.0,0.0,0.0,0,1,1
org.xml.sax.helpers.AttributesImpl,2,1,2,0.5,1,0.5,0,0.0,1,0.5,0.0,0.0,0.023462907390606462,9.677269513246246e-06,3,1,4
org.apache.xerces.dom.DeferredElementDefinitionImpl,6,13,30,0.43333333333333335,1,0.16666666666666666,85,14.166666666666666,17,0.5666666666666667,0.07500000000000001,0.012500000000000002,0.07555283850159158,1.2970613296801795e-05,1,5,6
org.w3c.dom.events.EventException,1,0,0,0,1,1.0,-1,-1.0,0,0,0.0,0.0,0.08526760976152017,0.0,1,0,1
org.apache.wml.dom.WMLTdElementImpl,4,6,12,0.5,1,0.25,159,39.75,6,0.5,0.3333333333333333,0.08333333333333333,0.030101805228786915,9.54823925306963e-05,1,3,4
org.apache.xerces.dom.DeferredEntityReferenceImpl,8,18,56,0.32142857142857145,1,0.125,85,10.625,38,0.6785714285714286,0.047619047619047616,0.005952380952380952,0.07555283850159158,2.9068674328360627e-05,1,7,8
org.apache.wml.WMLSelectElement,1,0,0,0,1,1.0,-1,-1.0,0,0,0.0,0.0,0.02088123436438043,0.0,1,0,1
org.w3c.dom.html.HTMLTableColElement,1,0,0,0,1,1.0,-1,-1.0,0,0,0.0,0.0,0.0016051364365971107,0.0,1,0,1
org.xml.sax.Parser,6,6,30,0.2,1,0.16666666666666666,8,1.3333333333333333,24,0.8,0.0,0.0,0.02953451043338684,7.308642594289785e-05,10,5,15
org.apache.wml.dom.WMLDOMImplementationImpl,11,38,110,0.34545454545454546,1,0.09090909090909091,161,14.636363636363637,72,0.6545454545454545,0.0,0.0,0.0,0.0,0,10,10
org.apache.xerces.validators.common.InsertableElementsInfo,2,2,2,1.0,1,0.5,0,0.0,0,0.0,0.0,0.0,0.03419253298868066,0.0,5,1,6
org.w3c.dom.traversal.TreeWalker,3,4,6,0.6666666666666666,1,0.3333333333333333,14,4.666666666666667,2,0.3333333333333333,0.0,0.0,0.101113784158206,1.2903026017661663e-06,4,2,6
org.apache.wml.dom.WMLNoopElementImpl,4,6,12,0.5,1,0.25,159,39.75,6,0.5,0.3333333333333333,0.08333333333333333,0.030101805228786915,9.54823925306963e-05,1,3,4
org.w3c.dom.html.HTMLDirectoryElement,1,0,0,0,1,1.0,-1,-1.0,0,0,0.0,0.0,0.0016051364365971107,0.0,1,0,1
org.apache.xerces.validators.common.Grammar,22,70,462,0.15151515151515152,1,0.045454545454545456,296,13.454545454545455,392,0.8484848484848485,0.0,0.0,0.03935966741081037,0.007066950484084669,9,21,30
org.apache.xerces.utils.regex.RegexParser,7,20,42,0.47619047619047616,1,0.14285714285714285,28,4.0,22,0.5238095238095238,0.13333333333333333,0.019047619047619046,0.032795093553101264,0.0003154359760451021,2,6,8
org.apache.xerces.parsers.SAXParser,23,44,506,0.08695652173913043,1,0.043478260869565216,300,13.043478260869565,462,0.9130434782608695,0.0,0.0,0.02929939185675853,0.014183755802982345,7,22,29
org.apache.xerces.validators.common.CMUniOp,6,11,30,0.36666666666666664,1,0.16666666666666666,11,1.8333333333333333,19,0.6333333333333333,0.0,0.0,0.030974412236804832,3.440806938043107e-05,2,5,7
org.apache.xerces.dom.NodeImpl,20,68,380,0.17894736842105263,1,0.05,85,4.25,312,0.8210526315789474,0.08235867446393762,0.004117933723196881,0.11063094209161625,0.0036453844728426307,17,20,37
org.apache.xerces.dom.DeferredElementImpl,6,10,30,0.3333333333333333,1,0.16666666666666666,85,14.166666666666666,20,0.6666666666666666,0.025,0.004166666666666667,0.07555283850159158,3.176602119586228e-06,1,5,6
org.apache.xerces.dom.CDATASectionImpl,4,7,12,0.5833333333333334,1,0.25,85,21.25,5,0.4166666666666667,0.0,0.0,0.09870015421899098,6.715881102342216e-05,2,3,5
org.apache.html.dom.HTMLHeadElementImpl,4,7,12,0.5833333333333334,1,0.25,113,28.25,5,0.4166666666666667,0.0,0.0,0.0449438202247191,0.0,1,3,4
org.apache.xerces.validators.schema.identity.XPathException,1,0,0,0,1,1.0,-1,-1.0,0,0,0.0,0.0,0.03261928451823373,0.0,3,0,3
org.w3c.dom.EntityReference,1,0,0,0,1,1.0,-1,-1.0,0,0,0.0,0.0,0.1616670351111581,0.0,9,0,9
org.apache.wml.WMLTableElement,1,0,0,0,1,1.0,-1,-1.0,0,0,0.0,0.0,0.02088123436438043,0.0,1,0,1
org.apache.wml.dom.WMLAccessElementImpl,4,6,12,0.5,1,0.25,159,39.75,6,0.5,0.3333333333333333,0.08333333333333333,0.030101805228786915,9.54823925306963e-05,1,3,4
org.apache.xerces.dom.DeferredDocumentImpl,22,67,462,0.14502164502164502,1,0.045454545454545456,85,3.8636363636363638,395,0.854978354978355,0.5464285714285715,0.02483766233766234,0.09553893931517986,0.012382990962387154,16,21,37
org.apache.html.dom.HTMLBRElementImpl,4,5,12,0.4166666666666667,1,0.25,115,28.75,7,0.5833333333333334,0.0,0.0,0.0,0.0,0,3,3
org.w3c.dom.html.HTMLSelectElement,4,4,12,0.3333333333333333,1,0.25,16,4.0,8,0.6666666666666666,0.0,0.0,0.004815409309791332,4.516059106181581e-06,3,3,6
org.apache.wml.dom.WMLIElementImpl,4,6,12,0.5,1,0.25,159,39.75,6,0.5,0.3333333333333333,0.08333333333333333,0.030101805228786915,9.54823925306963e-05,1,3,4
org.apache.wml.dom.WMLPElementImpl,4,6,12,0.5,1,0.25,159,39.75,6,0.5,0.3333333333333333,0.08333333333333333,0.030101805228786915,9.54823925306963e-05,1,3,4
org.apache.xml.serialize.XHTMLSerializer,5,8,20,0.4,1,0.2,45,9.0,12,0.6,0.0,0.0,0.002140181915462814,0.0,1,4,5
org.apache.xerces.utils.Hash2intTable,1,0,0,0,1,1.0,-1,-1.0,0,0,0.0,0.0,0.03079327532313931,0.0,1,0,1
org.apache.xerces.framework.XMLDTDScanner,18,48,306,0.1568627450980392,1,0.05555555555555555,296,16.444444444444443,258,0.8431372549019608,0.0,0.0,0.030303460749915953,0.0024314462227681636,1,17,18
org.w3c.dom.html.HTMLIFrameElement,1,0,0,0,1,1.0,-1,-1.0,0,0,0.0,0.0,0.0016051364365971107,0.0,1,0,1
org.apache.xml.serialize.EncodingInfo,1,0,0,0,1,1.0,-1,-1.0,0,0,0.0,0.0,0.02743324091638698,0.0,4,0,4
org.xml.sax.helpers.XMLReaderAdapter,16,35,240,0.14583333333333334,1,0.0625,23,1.4375,205,0.8541666666666666,0.0,0.0,0.0,0.0,0,15,15
org.apache.xml.serialize.IndentPrinter,4,5,12,0.4166666666666667,1,0.25,27,6.75,7,0.5833333333333334,0.0,0.0,0.021368547418967584,0.0,1,3,4
org.apache.xerces.dom.DeferredCDATASectionImpl,4,5,12,0.4166666666666667,1,0.25,85,21.25,7,0.5833333333333334,0.16666666666666666,0.041666666666666664,0.07555283850159158,9.032118212363164e-06,1,3,4
org.apache.xml.serialize.DOMSerializer,4,5,12,0.4166666666666667,1,0.25,13,3.25,7,0.5833333333333334,0.0,0.0,0.021925135137329844,3.8451017532631754e-05,2,3,5
org.apache.wml.dom.WMLPostfieldElementImpl,4,6,12,0.5,1,0.25,159,39.75,6,0.5,0.3333333333333333,0.08333333333333333,0.030101805228786915,9.54823925306963e-05,1,3,4
org.apache.html.dom.HTMLQuoteElementImpl,4,5,12,0.4166666666666667,1,0.25,115,28.75,7,0.5833333333333334,0.0,0.0,0.0,0.0,0,3,3
org.apache.xerces.validators.datatype.RecurringDurationDatatypeValidator,8,9,56,0.16071428571428573,1,0.125,37,4.625,47,0.8392857142857143,0.0,0.0,0.026196449999220807,0.0005467305738561,1,7,8
org.apache.xerces.validators.datatype.URIReferenceDatatypeValidator,9,12,72,0.16666666666666666,1,0.1111111111111111,37,4.111111111111111,60,0.8333333333333334,0.0,0.0,0.026196449999220807,0.0005988956647560751,1,8,9
org.w3c.dom.html.HTMLElement,1,0,0,0,1,1.0,-1,-1.0,0,0,0.0,0.0,0.054028492836828895,0.0,13,0,13
org.apache.html.dom.HTMLDirectoryElementImpl,4,5,12,0.4166666666666667,1,0.25,115,28.75,7,0.5833333333333334,0.0,0.0,0.0,0.0,0,3,3
org.apache.xerces.validators.common.CMLeaf,7,13,42,0.30952380952380953,1,0.14285714285714285,12,1.7142857142857142,29,0.6904761904761905,0.0,0.0,0.030974412236804832,3.7633825884846464e-05,2,6,8
org.apache.html.dom.HTMLLinkElementImpl,4,5,12,0.4166666666666667,1,0.25,115,28.75,7,0.5833333333333334,0.0,0.0,0.0,0.0,0,3,3
org.apache.xerces.domx.XGrammarWriter,13,39,156,0.25,1,0.07692307692307693,297,22.846153846153847,117,0.75,0.0,0.0,0.0,0.0,0,12,12
org.w3c.dom.traversal.NodeFilter,2,2,2,1.0,1,0.5,13,6.5,0,0.0,0.0,0.0,0.10367731073991106,2.867339115035925e-07,8,1,9
org.apache.html.dom.HTMLOptionElementImpl,8,11,56,0.19642857142857142,1,0.125,115,14.375,45,0.8035714285714286,0.0,0.0,0.0016051364365971107,1.677393382296016e-05,1,7,8
org.apache.wml.WMLOptgroupElement,1,0,0,0,1,1.0,-1,-1.0,0,0,0.0,0.0,0.02088123436438043,0.0,1,0,1
org.w3c.dom.Notation,1,0,0,0,1,1.0,-1,-1.0,0,0,0.0,0.0,0.11797429627155892,0.0,7,0,7
org.apache.wml.WMLGoElement,1,0,0,0,1,1.0,-1,-1.0,0,0,0.0,0.0,0.02088123436438043,0.0,1,0,1
org.apache.xerces.utils.ChunkyByteArray,1,0,0,0,1,1.0,-1,-1.0,0,0,0.0,0.0,0.03663014522461322,0.0,7,0,7
org.apache.xerces.validators.schema.identity.Selector,6,13,30,0.43333333333333335,1,0.16666666666666666,28,4.666666666666667,17,0.5666666666666667,0.30000000000000004,0.05000000000000001,0.035234702266765845,0.0005747867990001013,4,5,9
org.apache.xerces.validators.schema.SchemaMessageProvider,2,1,2,0.5,1,0.5,0,0.0,1,0.5,0.0,0.0,0.03606609644011522,1.4730954703497066e-05,7,1,8
org.w3c.dom.NodeList,2,3,2,1.5,1,0.5,12,6.0,-1,-0.5,0.0,0.0,0.18776274554765726,0.00015271038506807762,19,1,20
org.apache.xml.serialize.Printer,3,2,6,0.3333333333333333,1,0.3333333333333333,26,8.666666666666666,4,0.6666666666666666,0.0,0.0,0.025543428558814536,0.0,5,2,7
org.apache.xerces.readers.MIME2Java,1,0,0,0,1,1.0,-1,-1.0,0,0,0.0,0.0,0.030578909780018527,0.0,5,0,5
org.apache.xml.serialize.Encodings,3,3,6,0.5,1,0.3333333333333333,2,0.6666666666666666,3,0.5,0.0,0.0,0.02632921472743788,0.0004748313574499492,1,2,3
org.xml.sax.helpers.LocatorImpl,2,1,2,0.5,1,0.5,0,0.0,1,0.5,0.0,0.0,0.032347654182758125,0.0,2,1,3
org.apache.xerces.utils.NamespacesScope,2,1,2,0.5,1,0.5,0,0.0,1,0.5,0.0,0.0,0.04092880415160492,0.00025031870474263624,8,1,9
org.w3c.dom.html.HTMLMetaElement,1,0,0,0,1,1.0,-1,-1.0,0,0,0.0,0.0,0.0016051364365971107,0.0,1,0,1
org.apache.xerces.validators.datatype.StringDatatypeValidator,7,8,42,0.19047619047619047,1,0.14285714285714285,35,5.0,34,0.8095238095238095,0.0,0.0,0.026196449999220807,0.0005395417450748314,1,6,7
org.apache.wml.WMLIElement,1,0,0,0,1,1.0,-1,-1.0,0,0,0.0,0.0,0.02088123436438043,0.0,1,0,1
org.w3c.dom.html.HTMLFormElement,2,1,2,0.5,1,0.5,14,7.0,1,0.5,0.0,0.0,0.05985605550665355,0.00035053220681314183,14,1,15
org.apache.html.dom.HTMLParagraphElementImpl,4,5,12,0.4166666666666667,1,0.25,115,28.75,7,0.5833333333333334,0.0,0.0,0.0,0.0,0,3,3
org.apache.xerces.utils.regex.BMPattern,1,0,0,0,1,1.0,-1,-1.0,0,0,0.0,0.0,0.033160118313320726,0.0,1,0,1
org.apache.xerces.utils.regex.Token,13,36,156,0.23076923076923078,1,0.07692307692307693,28,2.1538461538461537,120,0.7692307692307693,0.8598484848484849,0.06614219114219114,0.03465727552141616,0.002457768395844194,16,13,29
org.apache.xml.serialize.BaseMarkupSerializer,25,53,600,0.08833333333333333,1,0.04,42,1.68,547,0.9116666666666666,0.0,0.0,0.024565566334007957,0.0014551172540984312,4,24,28
org.apache.xml.serialize.HTMLdtd,1,0,0,0,1,1.0,-1,-1.0,0,0,0.0,0.0,0.0032102728731942215,0.0,1,0,1
org.apache.html.dom.HTMLTableSectionElementImpl,9,30,72,0.4166666666666667,1,0.1111111111111111,120,13.333333333333334,42,0.5833333333333334,0.0,0.0,0.0032102728731942215,0.0,2,8,10
org.apache.wml.dom.WMLEmElementImpl,4,6,12,0.5,1,0.25,159,39.75,6,0.5,0.3333333333333333,0.08333333333333333,0.030101805228786915,9.54823925306963e-05,1,3,4
org.apache.wml.WMLUElement,1,0,0,0,1,1.0,-1,-1.0,0,0,0.0,0.0,0.02088123436438043,0.0,1,0,1
org.apache.xerces.dom.ProcessingInstructionImpl,4,6,12,0.5,1,0.25,85,21.25,6,0.5,0.16666666666666666,0.041666666666666664,0.09894266074041355,0.00014045749095658043,4,3,7
org.apache.xerces.validators.schema.identity.Field,7,12,42,0.2857142857142857,1,0.14285714285714285,28,4.0,30,0.7142857142857143,0.4,0.05714285714285715,0.03591603628849889,0.0006706562823113275,9,6,15
org.xml.sax.SAXException,1,0,0,0,1,1.0,-1,-1.0,0,0,0.0,0.0,0.09631476462384549,0.0,46,0,46
org.apache.xerces.parsers.DOMParser,40,152,1560,0.09743589743589744,1,0.025,296,7.4,1408,0.9025641025641026,0.0,0.0,0.03313830062652099,0.013253377991730432,16,39,55
org.apache.xerces.dom.RangeExceptionImpl,2,1,2,0.5,1,0.5,0,0.0,1,0.5,0.0,0.0,0.07790990613876196,0.0,1,1,2
org.apache.html.dom.HTMLIFrameElementImpl,4,5,12,0.4166666666666667,1,0.25,115,28.75,7,0.5833333333333334,0.0,0.0,0.0,0.0,0,3,3
org.apache.html.dom.HTMLScriptElementImpl,7,10,42,0.23809523809523808,1,0.14285714285714285,115,16.428571428571427,32,0.7619047619047619,0.0,0.0,0.0,0.0,0,6,6
org.w3c.dom.html.HTMLDListElement,1,0,0,0,1,1.0,-1,-1.0,0,0,0.0,0.0,0.0016051364365971107,0.0,1,0,1
org.apache.xerces.validators.common.XMLContentModel,5,9,20,0.45,1,0.2,296,59.2,11,0.55,0.0,0.0,0.03591913704273255,0.001222432684913266,6,4,10
org.apache.xml.serialize.XMLSerializer,12,22,132,0.16666666666666666,1,0.08333333333333333,43,3.5833333333333335,110,0.8333333333333334,0.0,0.0,0.02709531745605075,0.002318501735026899,3,11,14
org.apache.html.dom.HTMLFontElementImpl,4,5,12,0.4166666666666667,1,0.25,115,28.75,7,0.5833333333333334,0.0,0.0,0.0,0.0,0,3,3
org.w3c.dom.CDATASection,1,0,0,0,1,1.0,-1,-1.0,0,0,0.0,0.0,0.16070473133073454,0.0,8,0,8
org.apache.xerces.validators.datatype.IDDatatypeValidator,8,9,56,0.16071428571428573,1,0.125,8,1.0,47,0.8392857142857143,0.0,0.0,0.0,0.0,0,7,7
org.apache.html.dom.HTMLTableCaptionElementImpl,4,5,12,0.4166666666666667,1,0.25,115,28.75,7,0.5833333333333334,0.0,0.0,0.002407704654895666,0.0,1,3,4
org.apache.xerces.validators.common.DFAContentModel,15,47,210,0.22380952380952382,1,0.06666666666666667,296,19.733333333333334,163,0.7761904761904762,0.0,0.0,0.030303460749915953,0.0012467763939999208,1,14,15
org.apache.html.dom.HTMLLIElementImpl,4,5,12,0.4166666666666667,1,0.25,115,28.75,7,0.5833333333333334,0.0,0.0,0.0,0.0,0,3,3
org.apache.wml.WMLBElement,1,0,0,0,1,1.0,-1,-1.0,0,0,0.0,0.0,0.02088123436438043,0.0,1,0,1
org.w3c.dom.html.HTMLTextAreaElement,2,1,2,0.5,1,0.5,15,7.5,1,0.5,0.0,0.0,0.0016051364365971107,1.2903026017661663e-06,1,1,2
org.apache.xerces.validators.common.CMBinOp,6,11,30,0.36666666666666664,1,0.16666666666666666,11,1.8333333333333333,19,0.6333333333333333,0.0,0.0,0.030974412236804832,3.440806938043107e-05,2,5,7
org.apache.wml.WMLPostfieldElement,1,0,0,0,1,1.0,-1,-1.0,0,0,0.0,0.0,0.02088123436438043,0.0,1,0,1
org.w3c.dom.ranges.RangeException,1,0,0,0,1,1.0,-1,-1.0,0,0,0.0,0.0,0.07867941327795973,0.0,3,0,3
org.w3c.dom.Node,4,8,12,0.6666666666666666,1,0.25,12,3.0,4,0.3333333333333333,0.8333333333333333,0.20833333333333331,0.21178925801110154,0.0016359347308416503,75,4,79
org.apache.xerces.dom.DeferredCommentImpl,4,5,12,0.4166666666666667,1,0.25,85,21.25,7,0.5833333333333334,0.16666666666666666,0.041666666666666664,0.07555283850159158,1.0008549586001293e-05,1,3,4
org.w3c.dom.html.HTMLCollection,2,2,2,1.0,1,0.5,13,6.5,0,0.0,0.0,0.0,0.06024986551851524,0.0005826883663613934,15,1,16
org.apache.xerces.validators.schema.identity.XPathMatcher,11,29,110,0.2636363636363636,1,0.09090909090909091,18,1.6363636363636365,81,0.7363636363636363,0.0,0.0,0.035015141235458624,0.0016298242263775697,7,10,17
org.w3c.dom.Entity,1,0,0,0,1,1.0,-1,-1.0,0,0,0.0,0.0,0.12271997665256092,0.0,7,0,7
org.apache.html.dom.HTMLInputElementImpl,5,6,20,0.3,1,0.2,115,23.0,14,0.7,0.0,0.0,0.0,0.0,0,4,4
org.apache.wml.dom.WMLInputElementImpl,4,6,12,0.5,1,0.25,159,39.75,6,0.5,0.3333333333333333,0.08333333333333333,0.030101805228786915,9.54823925306963e-05,1,3,4
org.apache.wml.dom.WMLHeadElementImpl,4,6,12,0.5,1,0.25,159,39.75,6,0.5,0.3333333333333333,0.08333333333333333,0.030101805228786915,9.54823925306963e-05,1,3,4
org.apache.html.dom.HTMLSelectElementImpl,11,28,110,0.2545454545454545,1,0.09090909090909091,116,10.545454545454545,82,0.7454545454545455,0.0,0.0,0.0,0.0,0,10,10
org.apache.wml.WMLInputElement,1,0,0,0,1,1.0,-1,-1.0,0,0,0.0,0.0,0.02088123436438043,0.0,1,0,1
org.apache.xerces.jaxp.DocumentBuilderImpl,11,25,110,0.22727272727272727,1,0.09090909090909091,299,27.181818181818183,85,0.7727272727272727,0.0,0.0,0.0016051364365971107,0.0007531066185641857,1,10,11
org.apache.xerces.dom.ElementDefinitionImpl,6,18,30,0.6,1,0.16666666666666666,85,14.166666666666666,12,0.4,0.1,0.016666666666666666,0.1085435658257367,0.00015589313148576758,4,5,9
org.apache.xerces.utils.ImplementationMessages,2,1,2,0.5,1,0.5,0,0.0,1,0.5,0.0,0.0,0.06134460204627598,8.440729519887003e-05,14,1,15
org.w3c.dom.html.HTMLTableCaptionElement,1,0,0,0,1,1.0,-1,-1.0,0,0,0.0,0.0,0.00501605136436597,0.0,3,0,3
org.apache.xerces.validators.schema.identity.XPath,11,25,110,0.22727272727272727,1,0.09090909090909091,14,1.2727272727272727,85,0.7727272727272727,0.06666666666666667,0.006060606060606061,0.0317445008576802,0.0005798619892337153,4,10,14
org.w3c.dom.Element,3,3,6,0.5,1,0.3333333333333333,12,4.0,3,0.5,0.5,0.16666666666666666,0.20312515200155648,0.00025648143574059565,35,2,37
org.apache.xerces.dom.NotationImpl,5,11,20,0.55,1,0.2,85,17.0,9,0.45,0.0,0.0,0.10796156279181852,0.00012148198995628462,4,4,8
org.apache.xml.serialize.TextSerializer,11,20,110,0.18181818181818182,1,0.09090909090909091,43,3.909090909090909,90,0.8181818181818182,0.0,0.0,0.002140181915462814,2.7999566458325807e-05,1,10,11
org.apache.xerces.validators.common.ContentLeafNameTypeVector,2,3,2,1.5,1,0.5,0,0.0,-1,-0.5,0.0,0.0,0.03419253298868066,0.0,6,2,8
org.apache.wml.dom.WMLBrElementImpl,4,6,12,0.5,1,0.25,159,39.75,6,0.5,0.3333333333333333,0.08333333333333333,0.030101805228786915,9.54823925306963e-05,1,3,4
org.w3c.dom.html.HTMLStyleElement,1,0,0,0,1,1.0,-1,-1.0,0,0,0.0,0.0,0.0016051364365971107,0.0,1,0,1
org.w3c.dom.html.HTMLBRElement,1,0,0,0,1,1.0,-1,-1.0,0,0,0.0,0.0,0.0016051364365971107,0.0,1,0,1
org.apache.html.dom.HTMLLabelElementImpl,5,6,20,0.3,1,0.2,115,23.0,14,0.7,0.0,0.0,0.0,0.0,0,4,4
org.apache.html.dom.HTMLUListElementImpl,4,5,12,0.4166666666666667,1,0.25,115,28.75,7,0.5833333333333334,0.0,0.0,0.0,0.0,0,3,3
org.apache.wml.WMLOptionElement,1,0,0,0,1,1.0,-1,-1.0,0,0,0.0,0.0,0.02088123436438043,0.0,1,0,1
org.apache.xerces.utils.ChunkyCharArray,4,7,12,0.5833333333333334,1,0.25,8,2.0,5,0.4166666666666667,0.0,0.0,0.042588949214288234,0.0003290271634503724,4,4,8
org.apache.html.dom.HTMLHRElementImpl,4,5,12,0.4166666666666667,1,0.25,115,28.75,7,0.5833333333333334,0.0,0.0,0.0,0.0,0,3,3
org.apache.wml.dom.WMLAnchorElementImpl,4,6,12,0.5,1,0.25,159,39.75,6,0.5,0.3333333333333333,0.08333333333333333,0.030101805228786915,9.54823925306963e-05,1,3,4
org.apache.wml.WMLImgElement,1,0,0,0,1,1.0,-1,-1.0,0,0,0.0,0.0,0.02088123436438043,0.0,1,0,1
org.xml.sax.Attributes,1,0,0,0,1,1.0,-1,-1.0,0,0,0.0,0.0,0.04692308620668847,0.0,16,0,16
org.apache.xerces.validators.datatype.UnionDatatypeValidator,11,39,110,0.35454545454545455,1,0.09090909090909091,41,3.727272727272727,71,0.6454545454545455,0.0,0.0,0.026260188320386794,0.000964668402300224,2,10,12
org.apache.html.dom.HTMLTableRowElementImpl,14,57,182,0.3131868131868132,1,0.07142857142857142,120,8.571428571428571,125,0.6868131868131868,0.035256410256410256,0.0025183150183150185,0.0032102728731942215,2.095205653344108e-05,2,13,15
org.w3c.dom.html.HTMLButtonElement,2,1,2,0.5,1,0.5,15,7.5,1,0.5,0.0,0.0,0.0016051364365971107,1.2903026017661663e-06,1,1,2
org.apache.xerces.readers.XMLEntityReaderFactory,3,4,6,0.6666666666666666,1,0.3333333333333333,26,8.666666666666666,2,0.3333333333333333,0.0,0.0,0.0448331211601262,1.1612723415895497e-06,7,2,9
org.apache.html.dom.HTMLTextAreaElementImpl,5,6,20,0.3,1,0.2,115,23.0,14,0.7,0.0,0.0,0.0,0.0,0,4,4
org.apache.xerces.readers.EBCDICRecognizer,9,18,72,0.25,1,0.1111111111111111,26,2.888888888888889,54,0.75,0.03571428571428571,0.003968253968253968,0.034305026745215295,0.00010580481334482563,1,8,9
org.apache.wml.WMLDoElement,1,0,0,0,1,1.0,-1,-1.0,0,0,0.0,0.0,0.02088123436438043,0.0,1,0,1
org.apache.xerces.dom.DeferredDocumentTypeImpl,7,16,42,0.38095238095238093,1,0.14285714285714285,85,12.142857142857142,26,0.6190476190476191,0.016666666666666666,0.0023809523809523807,0.07555283850159158,6.5621103746965025e-06,1,6,7
org.w3c.dom.html.HTMLTableElement,5,6,20,0.3,1,0.2,17,3.4,14,0.7,0.0,0.0,0.0036115569823434992,2.5806052035323325e-06,2,4,6
org.w3c.dom.html.HTMLTableCellElement,1,0,0,0,1,1.0,-1,-1.0,0,0,0.0,0.0,0.03312686486326798,0.0,3,0,3
org.apache.wml.WMLRefreshElement,1,0,0,0,1,1.0,-1,-1.0,0,0,0.0,0.0,0.02088123436438043,0.0,1,0,1
org.apache.xerces.validators.common.XMLValidator,62,257,3782,0.06795346377578002,1,0.016129032258064516,296,4.774193548387097,3525,0.93204653622422,0.10457650273224045,0.0016867177860038782,0.033571481026867675,0.027028387747183913,8,61,69
org.apache.html.dom.HTMLPreElementImpl,4,5,12,0.4166666666666667,1,0.25,115,28.75,7,0.5833333333333334,0.0,0.0,0.0,0.0,0,3,3
org.apache.xerces.validators.common.MixedContentModel,8,17,56,0.30357142857142855,1,0.125,296,37.0,39,0.6964285714285714,0.0,0.0,0.030303460749915953,0.00121236832461949,1,7,8
org.w3c.dom.events.Event,2,2,2,1.0,1,0.5,1,0.5,0,0.0,0.0,0.0,0.10472104674351865,0.00011375348699157881,7,1,8
org.apache.xerces.dom.events.EventImpl,3,4,6,0.6666666666666666,1,0.3333333333333333,2,0.6666666666666666,2,0.3333333333333333,0.0,0.0,0.10034755034961325,0.000109538498492476,3,2,5
org.apache.xerces.validators.datatype.XMLException,1,0,0,0,1,1.0,-1,-1.0,0,0,0.0,0.0,0.0351373321667964,0.0,2,0,2
org.w3c.dom.html.HTMLModElement,1,0,0,0,1,1.0,-1,-1.0,0,0,0.0,0.0,0.0016051364365971107,0.0,1,0,1
org.apache.xml.serialize.SerializerFactoryImpl,10,30,90,0.3333333333333333,1,0.1,49,4.9,60,0.6666666666666666,0.05555555555555555,0.005555555555555555,0.0016051364365971107,4.8859458520212156e-05,1,9,10
org.apache.xerces.dom.DOMImplementationImpl,10,35,90,0.3888888888888889,1,0.1,85,8.5,55,0.6111111111111112,0.0,0.0,0.09918636187524214,0.0002662458425724027,4,9,13
org.apache.wml.dom.WMLOptionElementImpl,4,6,12,0.5,1,0.25,159,39.75,6,0.5,0.3333333333333333,0.08333333333333333,0.030101805228786915,9.54823925306963e-05,1,3,4
org.apache.xerces.validators.datatype.AbstractDatatypeValidator,3,2,6,0.3333333333333333,1,0.3333333333333333,2,0.6666666666666666,4,0.6666666666666666,0.0,0.0,0.036018061535230496,3.6865788621890463e-07,17,2,19
org.apache.xerces.validators.datatype.InvalidDatatypeValueException,2,1,2,0.5,1,0.5,0,0.0,1,0.5,0.0,0.0,0.042866327561548456,0.00020902902148611894,19,1,20
org.apache.xerces.utils.regex.Op,10,23,90,0.25555555555555554,1,0.1,28,2.8,67,0.7444444444444445,0.736111111111111,0.0736111111111111,0.03375224682116413,0.0015819109897653198,8,10,18
org.apache.xerces.utils.QName,1,1,0,0,1,1.0,-1,-1.0,-1,0,0.0,0.0,0.11990923739074442,0.0,44,1,45
org.w3c.dom.traversal.DocumentTraversal,4,6,12,0.5,1,0.25,16,4.0,6,0.5,0.0,0.0,0.0998280492662515,8.02854952210059e-06,3,3,6
org.apache.xerces.utils.regex.RegularExpression,18,55,306,0.17973856209150327,1,0.05555555555555555,28,1.5555555555555556,251,0.8202614379084967,0.4997549019607843,0.027764161220043573,0.03951926741111124,0.007856050400940031,15,17,32
org.xml.sax.InputSource,1,0,0,0,1,1.0,-1,-1.0,0,0,0.0,0.0,0.0961628153487386,0.0,27,0,27
org.apache.xerces.validators.datatype.DatatypeValidatorFactory,2,1,2,0.5,1,0.5,0,0.0,1,0.5,0.0,0.0,0.035620255444485056,5.247230580515742e-06,3,1,4
org.apache.xerces.readers.DefaultEntityHandler,23,52,506,0.10276679841897234,1,0.043478260869565216,47,2.0434782608695654,454,0.8972332015810277,0.0367965367965368,0.0015998494259363825,0.043064040671593966,0.004442554867967638,8,22,30
org.w3c.dom.DOMImplementation,3,4,6,0.6666666666666666,1,0.3333333333333333,12,4.0,2,0.3333333333333333,0.0,0.0,0.16074652316669938,1.5975175069485868e-06,8,2,10
org.apache.xerces.validators.datatype.BinaryDatatypeValidator,8,9,56,0.16071428571428573,1,0.125,7,0.875,47,0.8392857142857143,0.0,0.0,0.026196449999220807,0.00042358791126552144,1,7,8
org.apache.wml.dom.WMLFieldsetElementImpl,4,6,12,0.5,1,0.25,159,39.75,6,0.5,0.3333333333333333,0.08333333333333333,0.030101805228786915,9.54823925306963e-05,1,3,4
org.apache.html.dom.HTMLBuilder,13,29,156,0.1858974358974359,1,0.07692307692307693,117,9.0,127,0.8141025641025641,0.0,0.0,0.0,0.0,0,12,12
org.apache.xerces.validators.common.GrammarResolverImpl,5,7,20,0.35,1,0.2,296,59.2,13,0.65,0.0,0.0,0.03447272883966949,0.0037412249138059164,2,4,6
org.apache.wml.dom.WMLSelectElementImpl,4,6,12,0.5,1,0.25,159,39.75,6,0.5,0.3333333333333333,0.08333333333333333,0.030101805228786915,9.54823925306963e-05,1,3,4
org.xml.sax.HandlerBase,10,15,90,0.16666666666666666,1,0.1,8,0.8,75,0.8333333333333334,0.0,0.0,0.006420545746388442,3.2235035951107446e-05,3,9,12
org.apache.html.dom.HTMLLegendElementImpl,4,5,12,0.4166666666666667,1,0.25,115,28.75,7,0.5833333333333334,0.0,0.0,0.0,0.0,0,3,3
org.apache.xerces.validators.schema.identity.FieldActivator,4,6,12,0.5,1,0.25,28,7.0,6,0.5,0.0,0.0,0.03308296472375725,4.301008672553888e-06,3,3,6
org.apache.xerces.validators.common.GrammarResolver,3,2,6,0.3333333333333333,1,0.3333333333333333,296,98.66666666666667,4,0.6666666666666666,0.0,0.0,0.04606669593821304,0.0017395429576144196,8,2,10
org.w3c.dom.html.HTMLAppletElement,1,0,0,0,1,1.0,-1,-1.0,0,0,0.0,0.0,0.032924871784833415,0.0,2,0,2
org.w3c.dom.html.HTMLMenuElement,1,0,0,0,1,1.0,-1,-1.0,0,0,0.0,0.0,0.0016051364365971107,0.0,1,0,1
org.apache.html.dom.HTMLMapElementImpl,6,11,30,0.36666666666666664,1,0.16666666666666666,115,19.166666666666668,19,0.6333333333333333,0.0,0.0,0.0,0.0,0,5,5
org.apache.html.dom.HTMLTableColElementImpl,4,5,12,0.4166666666666667,1,0.25,115,28.75,7,0.5833333333333334,0.0,0.0,0.0,0.0,0,3,3
org.xml.sax.Locator,1,0,0,0,1,1.0,-1,-1.0,0,0,0.0,0.0,0.09436143180042023,0.0,24,0,24
org.apache.xerces.validators.datatype.NOTATIONDatatypeValidator,5,6,20,0.3,1,0.2,4,0.8,14,0.7,0.0,0.0,0.026196449999220807,3.6865788621890463e-07,1,4,5
org.w3c.dom.ProcessingInstruction,1,0,0,0,1,1.0,-1,-1.0,0,0,0.0,0.0,0.16303378540799154,0.0,9,0,9
org.w3c.dom.Comment,1,0,0,0,1,1.0,-1,-1.0,0,0,0.0,0.0,0.16186088047699881,0.0,9,0,9
org.apache.xerces.validators.datatype.InvalidDatatypeFacetException,2,1,2,0.5,1,0.5,0,0.0,1,0.5,0.0,0.0,0.036018061535230496,4.645089366358198e-05,17,1,18
org.apache.html.dom.HTMLMenuElementImpl,4,5,12,0.4166666666666667,1,0.25,115,28.75,7,0.5833333333333334,0.0,0.0,0.0,0.0,0,3,3
org.w3c.dom.html.HTMLAreaElement,1,0,0,0,1,1.0,-1,-1.0,0,0,0.0,0.0,0.032924871784833415,0.0,2,0,2
org.apache.xerces.validators.datatype.StateMessageDatatype,1,0,0,0,1,1.0,-1,-1.0,0,0,0.0,0.0,0.02721266191347195,0.0,1,0,1
org.apache.wml.WMLAElement,1,0,0,0,1,1.0,-1,-1.0,0,0,0.0,0.0,0.02088123436438043,0.0,1,0,1
org.apache.html.dom.HTMLFormElementImpl,7,16,42,0.38095238095238093,1,0.14285714285714285,114,16.285714285714285,26,0.6190476190476191,0.0,0.0,0.0,0.0,0,6,6
org.apache.wml.dom.WMLElementImpl,4,4,12,0.3333333333333333,1,0.25,159,39.75,8,0.6666666666666666,0.3333333333333333,0.08333333333333333,0.05782715215003802,0.0017008338795614357,36,3,39
org.apache.wml.WMLTdElement,1,0,0,0,1,1.0,-1,-1.0,0,0,0.0,0.0,0.02088123436438043,0.0,1,0,1
org.apache.xerces.validators.datatype.FloatDatatypeValidator,8,9,56,0.16071428571428573,1,0.125,37,4.625,47,0.8392857142857143,0.0,0.0,0.0273571079628725,0.0005501713807941431,3,7,10
org.apache.html.dom.HTMLFrameSetElementImpl,4,6,12,0.5,1,0.25,114,28.5,6,0.5,0.0,0.0,0.0,0.0,0,3,3
org.apache.wml.WMLBrElement,1,0,0,0,1,1.0,-1,-1.0,0,0,0.0,0.0,0.02088123436438043,0.0,1,0,1
org.apache.wml.dom.WMLCardElementImpl,4,6,12,0.5,1,0.25,159,39.75,6,0.5,0.3333333333333333,0.08333333333333333,0.030101805228786915,9.54823925306963e-05,1,3,4
org.apache.html.dom.CollectionIndex,1,0,0,0,1,1.0,-1,-1.0,0,0,0.0,0.0,0.03252818658260651,0.0,1,0,1
org.w3c.dom.Text,1,1,0,0,1,1.0,-1,-1.0,-1,0,0.0,0.0,0.1644238420436261,0.0,16,1,17
org.apache.html.dom.NameNodeListImpl,5,12,20,0.6,1,0.2,86,17.2,8,0.4,0.0,0.0,0.045746388443017656,0.00045993757884670565,1,4,5
org.xml.sax.SAXParseException,3,2,6,0.3333333333333333,1,0.3333333333333333,1,0.3333333333333333,4,0.6666666666666666,0.0,0.0,0.05549327077416965,5.161210407064665e-05,21,2,23
org.apache.wml.dom.WMLUElementImpl,4,6,12,0.5,1,0.25,159,39.75,6,0.5,0.3333333333333333,0.08333333333333333,0.030101805228786915,9.54823925306963e-05,1,3,4
org.w3c.dom.html.HTMLHeadingElement,1,0,0,0,1,1.0,-1,-1.0,0,0,0.0,0.0,0.0016051364365971107,0.0,1,0,1
org.w3c.dom.html.HTMLBaseElement,1,0,0,0,1,1.0,-1,-1.0,0,0,0.0,0.0,0.0016051364365971107,0.0,1,0,1
org.apache.xerces.jaxp.SAXParserImpl,8,14,56,0.25,1,0.125,19,2.375,42,0.75,0.0,0.0,0.0016051364365971107,4.243661890253169e-06,1,7,8
org.w3c.dom.html.HTMLOptionElement,2,1,2,0.5,1,0.5,15,7.5,1,0.5,0.0,0.0,0.03312686486326798,1.5053530353938604e-06,3,1,4
javax.xml.parsers.SAXParserFactory,8,15,56,0.26785714285714285,1,0.125,306,38.25,41,0.7321428571428571,0.0,0.0,0.0016051364365971107,3.0967262442387988e-06,2,8,10
org.apache.xerces.utils.regex.ParseException,1,0,0,0,1,1.0,-1,-1.0,0,0,0.0,0.0,0.03360890186944086,0.0,4,0,4
org.w3c.dom.ranges.DocumentRange,2,2,2,1.0,1,0.5,14,7.0,0,0.0,0.0,0.0,0.09909760012527895,0.0,1,1,2
org.apache.xerces.validators.datatype.TimeDurationDatatypeValidator,8,9,56,0.16071428571428573,1,0.125,37,4.625,47,0.8392857142857143,0.0,0.0,0.026196449999220807,0.0005467305738561,1,7,8
org.apache.xerces.validators.datatype.DatatypeMessageProvider,2,1,2,0.5,1,0.5,0,0.0,1,0.5,0.0,0.0,0.04092130963662032,2.5806052035323326e-05,9,1,10
org.apache.xerces.utils.URI,2,2,2,1.0,1,0.5,0,0.0,0,0.0,0.0,0.0,0.03605126910564845,0.0,3,2,5
org.w3c.dom.html.HTMLOListElement,1,0,0,0,1,1.0,-1,-1.0,0,0,0.0,0.0,0.0016051364365971107,0.0,1,0,1
org.apache.html.dom.HTMLOptGroupElementImpl,4,5,12,0.4166666666666667,1,0.25,115,28.75,7,0.5833333333333334,0.0,0.0,0.0,0.0,0,3,3
org.apache.xerces.dom.NodeIteratorImpl,6,14,30,0.4666666666666667,1,0.16666666666666666,85,14.166666666666666,16,0.5333333333333333,0.0,0.0,0.09845883354852888,0.0,1,5,6
org.w3c.dom.html.HTMLTitleElement,1,0,0,0,1,1.0,-1,-1.0,0,0,0.0,0.0,0.04615122373897357,0.0,2,0,2
org.apache.wml.dom.WMLGoElementImpl,4,6,12,0.5,1,0.25,159,39.75,6,0.5,0.3333333333333333,0.08333333333333333,0.030101805228786915,9.54823925306963e-05,1,3,4
org.apache.xerces.validators.datatype.DatatypeValidatorFactoryImpl,19,78,342,0.22807017543859648,1,0.05263157894736842,55,2.8947368421052633,264,0.7719298245614035,0.0,0.0,0.03191303078943528,0.009474197789486698,4,18,22
org.apache.xerces.dom.DeferredProcessingInstructionImpl,4,5,12,0.4166666666666667,1,0.25,85,21.25,7,0.5833333333333334,0.16666666666666666,0.041666666666666664,0.07555283850159158,1.0008549586001291e-05,1,3,4
org.w3c.dom.events.EventListener,2,1,2,0.5,1,0.5,1,0.5,1,0.5,0.0,0.0,0.0895283560242517,5.161210407064665e-06,4,1,5
org.w3c.dom.html.HTMLIsIndexElement,2,1,2,0.5,1,0.5,15,7.5,1,0.5,0.0,0.0,0.0016051364365971107,1.2903026017661663e-06,1,1,2
org.apache.wml.WMLBigElement,1,0,0,0,1,1.0,-1,-1.0,0,0,0.0,0.0,0.02088123436438043,0.0,1,0,1
org.apache.wml.dom.WMLMetaElementImpl,4,6,12,0.5,1,0.25,159,39.75,6,0.5,0.3333333333333333,0.08333333333333333,0.030101805228786915,9.54823925306963e-05,1,3,4
org.apache.wml.dom.WMLTrElementImpl,4,6,12,0.5,1,0.25,159,39.75,6,0.5,0.3333333333333333,0.08333333333333333,0.030101805228786915,9.54823925306963e-05,1,3,4
org.apache.xerces.readers.AbstractCharReader,14,24,182,0.13186813186813187,1,0.07142857142857142,18,1.2857142857142858,158,0.8681318681318682,0.0,0.0,0.023812598783540282,0.00025720031861872246,2,13,15
org.apache.xerces.utils.XMLCharacterProperties,1,0,0,0,1,1.0,-1,-1.0,0,0,0.0,0.0,0.043265133061916726,0.0,10,0,10
org.apache.xerces.dom.LCount,1,1,0,0,1,1.0,-1,-1.0,-1,0,0.0,0.0,0.08794375768693585,0.0,6,1,7
org.apache.wml.dom.WMLOneventElementImpl,4,6,12,0.5,1,0.25,159,39.75,6,0.5,0.3333333333333333,0.08333333333333333,0.030101805228786915,9.54823925306963e-05,1,3,4
org.w3c.dom.DocumentFragment,1,0,0,0,1,1.0,-1,-1.0,0,0,0.0,0.0,0.16244521578558002,0.0,12,0,12
org.w3c.dom.traversal.NodeIterator,3,4,6,0.6666666666666666,1,0.3333333333333333,14,4.666666666666667,2,0.3333333333333333,0.0,0.0,0.10047052528876721,1.577036513269759e-06,4,2,6
org.apache.xerces.readers.UTF8CharReader,7,14,42,0.3333333333333333,1,0.14285714285714285,19,2.7142857142857144,28,0.6666666666666666,0.0,0.0,0.02735389190108809,0.0002374156787249746,1,6,7
org.apache.xerces.dom.EntityImpl,5,11,20,0.55,1,0.2,85,17.0,9,0.45,0.0,0.0,0.10810647764120351,0.00010804133785455347,5,4,9
org.apache.html.dom.HTMLTableCellElementImpl,5,6,20,0.3,1,0.2,114,22.8,14,0.7,0.0,0.0,0.002889245585874799,0.0,1,4,5
org.apache.xerces.validators.schema.identity.ValueStore,2,2,2,1.0,1,0.5,28,14.0,0,0.0,0.0,0.0,0.03350929158875412,0.0,4,1,5
org.apache.wml.WMLWmlElement,1,0,0,0,1,1.0,-1,-1.0,0,0,0.0,0.0,0.02088123436438043,0.0,1,0,1
org.xml.sax.helpers.ParserAdapter,20,43,380,0.11315789473684211,1,0.05,20,1.0,337,0.8868421052631579,0.04678362573099415,0.0023391812865497076,0.0036115569823434992,9.053623255725934e-05,2,19,21
org.w3c.dom.html.HTMLParagraphElement,1,0,0,0,1,1.0,-1,-1.0,0,0,0.0,0.0,0.0016051364365971107,0.0,1,0,1
org.apache.wml.WMLMetaElement,1,0,0,0,1,1.0,-1,-1.0,0,0,0.0,0.0,0.02088123436438043,0.0,1,0,1
org.w3c.dom.html.HTMLObjectElement,2,1,2,0.5,1,0.5,15,7.5,1,0.5,0.0,0.0,0.032924871784833415,1.2903026017661663e-06,2,1,3
org.apache.xerces.dom.AttrImpl,19,80,342,0.23391812865497075,1,0.05263157894736842,85,4.473684210526316,262,0.7660818713450293,0.119281045751634,0.006277949776401789,0.10942843185149,0.004602052507536547,10,18,28
org.w3c.dom.html.HTMLDocument,4,3,12,0.25,1,0.25,15,3.75,9,0.75,0.0,0.0,0.057600589830039864,0.0005312605912338561,6,3,9
org.w3c.dom.CharacterData,1,0,0,0,1,1.0,-1,-1.0,0,0,0.0,0.0,0.12256415098450789,0.0,13,0,13
org.apache.wml.dom.WMLDoElementImpl,4,6,12,0.5,1,0.25,159,39.75,6,0.5,0.3333333333333333,0.08333333333333333,0.030101805228786915,9.54823925306963e-05,1,3,4
org.apache.wml.WMLStrongElement,1,0,0,0,1,1.0,-1,-1.0,0,0,0.0,0.0,0.02088123436438043,0.0,1,0,1
org.apache.xerces.readers.UTF8Reader,12,20,132,0.15151515151515152,1,0.08333333333333333,17,1.4166666666666667,112,0.8484848484848485,0.0,0.0,0.02735389190108809,0.0002991351531761229,1,11,12
org.apache.xerces.validators.schema.identity.Key,2,1,2,0.5,1,0.5,29,14.5,1,0.5,0.0,0.0,0.02593916295693016,0.0,4,1,5
org.apache.html.dom.HTMLAppletElementImpl,4,5,12,0.4166666666666667,1,0.25,114,28.5,7,0.5833333333333334,0.0,0.0,0.0,0.0,0,3,3
org.xml.sax.XMLFilter,2,1,2,0.5,1,0.5,9,4.5,1,0.5,0.0,0.0,0.0016051364365971107,0.0,1,1,2
org.apache.xerces.validators.datatype.QNameDatatypeValidator,7,8,42,0.19047619047619047,1,0.14285714285714285,35,5.0,34,0.8095238095238095,0.0,0.0,0.026196449999220807,0.0005395417450748314,1,6,7
org.xml.sax.XMLReader,6,6,30,0.2,1,0.16666666666666666,8,1.3333333333333333,24,0.8,0.0,0.0,0.04144013531472755,0.00024680416622734937,14,5,19
org.xml.sax.helpers.XMLReaderFactory,6,10,30,0.3333333333333333,1,0.16666666666666666,21,3.5,20,0.6666666666666666,0.0,0.0,0.0016051364365971107,1.806423642472633e-05,1,5,6
org.apache.html.dom.HTMLCollectionImpl,17,25,272,0.09191176470588236,1,0.058823529411764705,27,1.588235294117647,247,0.9080882352941176,0.0,0.0,0.04828785446762975,0.0015824578322965444,7,16,23
org.apache.xerces.framework.XMLDocumentScanner,19,52,342,0.15204678362573099,1,0.05263157894736842,296,15.578947368421053,290,0.847953216374269,0.035403050108932466,0.0018633184267859192,0.03861982403842672,0.005360218078343732,7,18,25
org.apache.xerces.dom.DeferredNode,1,0,0,0,1,1.0,-1,-1.0,0,0,0.0,0.0,0.07702372711159121,0.0,14,0,14
org.apache.html.dom.HTMLBaseElementImpl,4,5,12,0.4166666666666667,1,0.25,115,28.75,7,0.5833333333333334,0.0,0.0,0.0,0.0,0,3,3
org.xml.sax.DocumentHandler,3,2,6,0.3333333333333333,1,0.3333333333333333,1,0.3333333333333333,4,0.6666666666666666,0.0,0.0,0.03920150114168155,2.1548053449494977e-05,10,2,12
org.apache.xerces.dom.DeferredNotationImpl,5,7,20,0.35,1,0.2,85,17.0,13,0.65,0.08333333333333333,0.016666666666666666,0.07555283850159158,9.032118212363164e-06,1,4,5
org.xml.sax.DTDHandler,1,0,0,0,1,1.0,-1,-1.0,0,0,0.0,0.0,0.03856775862899848,0.0,9,0,9
org.apache.wml.WMLEmElement,1,0,0,0,1,1.0,-1,-1.0,0,0,0.0,0.0,0.02088123436438043,0.0,1,0,1
org.apache.xerces.validators.datatype.DecimalDatatypeValidator,8,9,56,0.16071428571428573,1,0.125,37,4.625,47,0.8392857142857143,0.0,0.0,0.0273571079628725,0.0005501713807941431,3,7,10
org.w3c.dom.html.HTMLOptGroupElement,1,0,0,0,1,1.0,-1,-1.0,0,0,0.0,0.0,0.0016051364365971107,0.0,1,0,1
org.apache.xerces.dom.CommentImpl,5,7,20,0.35,1,0.2,85,17.0,13,0.65,0.25,0.05,0.09870015421899098,0.00015288126172215748,2,4,6
org.apache.xerces.dom.DeferredTextImpl,4,5,12,0.4166666666666667,1,0.25,85,21.25,7,0.5833333333333334,0.16666666666666666,0.041666666666666664,0.07555283850159158,8.07309568335204e-06,1,3,4
org.apache.wml.dom.WMLImgElementImpl,4,6,12,0.5,1,0.25,159,39.75,6,0.5,0.3333333333333333,0.08333333333333333,0.030101805228786915,9.54823925306963e-05,1,3,4
org.apache.wml.dom.WMLTableElementImpl,4,6,12,0.5,1,0.25,159,39.75,6,0.5,0.3333333333333333,0.08333333333333333,0.030101805228786915,9.54823925306963e-05,1,3,4
javax.xml.parsers.FactoryConfigurationError,1,0,0,0,1,1.0,-1,-1.0,0,0,0.0,0.0,0.004280363830925628,0.0,2,0,2
org.w3c.dom.html.HTMLParamElement,1,0,0,0,1,1.0,-1,-1.0,0,0,0.0,0.0,0.0016051364365971107,0.0,1,0,1
org.apache.html.dom.HTMLImageElementImpl,4,5,12,0.4166666666666667,1,0.25,114,28.5,7,0.5833333333333334,0.0,0.0,0.0,0.0,0,3,3
org.apache.xerces.readers.XMLDeclRecognizer,10,33,90,0.36666666666666664,1,0.1,26,2.6,57,0.6333333333333333,0.1736111111111111,0.017361111111111112,0.0448331211601262,0.0017406612198692837,7,9,16
org.apache.wml.dom.WMLBigElementImpl,4,6,12,0.5,1,0.25,159,39.75,6,0.5,0.3333333333333333,0.08333333333333333,0.030101805228786915,9.54823925306963e-05,1,3,4
org.w3c.dom.html.HTMLQuoteElement,1,0,0,0,1,1.0,-1,-1.0,0,0,0.0,0.0,0.0016051364365971107,0.0,1,0,1
org.w3c.dom.html.HTMLLinkElement,1,0,0,0,1,1.0,-1,-1.0,0,0,0.0,0.0,0.0016051364365971107,0.0,1,0,1
org.apache.xerces.dom.events.MutationEventImpl,4,5,12,0.4166666666666667,1,0.25,18,4.5,7,0.5833333333333334,0.0,0.0,0.10032102728731943,5.533625767893103e-05,6,3,9
org.apache.wml.dom.WMLBElementImpl,4,6,12,0.5,1,0.25,159,39.75,6,0.5,0.3333333333333333,0.08333333333333333,0.030101805228786915,9.54823925306963e-05,1,3,4
org.apache.xerces.validators.common.CMStateSet,3,3,6,0.5,1,0.3333333333333333,2,0.6666666666666666,3,0.5,0.0,0.0,0.02793315078840525,1.5483631221193994e-05,7,3,10
org.apache.xerces.validators.common.XMLAttributeDecl,3,4,6,0.6666666666666666,1,0.3333333333333333,1,0.3333333333333333,2,0.3333333333333333,0.0,0.0,0.05265650080256822,6.271485074393931e-05,9,3,12
org.xml.sax.SAXNotSupportedException,2,1,2,0.5,1,0.5,0,0.0,1,0.5,0.0,0.0,0.048343291689299295,1.376322775217244e-06,14,1,15
org.apache.html.dom.HTMLBaseFontElementImpl,4,5,12,0.4166666666666667,1,0.25,115,28.75,7,0.5833333333333334,0.0,0.0,0.0,0.0,0,3,3
org.apache.xml.serialize.HTMLSerializer,14,25,182,0.13736263736263737,1,0.07142857142857142,44,3.142857142857143,157,0.8626373626373627,0.0,0.0,0.0036115569823434992,9.509530175016646e-05,2,13,15
org.w3c.dom.html.HTMLHeadElement,1,0,0,0,1,1.0,-1,-1.0,0,0,0.0,0.0,0.04615122373897357,0.0,2,0,2
org.w3c.dom.DOMException,1,0,0,0,1,1.0,-1,-1.0,0,0,0.0,0.0,0.15596935144477683,0.0,39,0,39
org.apache.html.dom.HTMLDocumentImpl,22,57,462,0.12337662337662338,1,0.045454545454545456,113,5.136363636363637,405,0.8766233766233766,0.19523809523809527,0.008874458874458875,0.08831066430120244,0.01282304457210136,55,21,76
org.apache.xerces.framework.XMLErrorReporter,2,1,2,0.5,1,0.5,0,0.0,1,0.5,0.0,0.0,0.05858162177361718,6.193452488477598e-05,21,1,22
org.apache.xerces.validators.schema.SchemaSymbols,1,0,0,0,1,1.0,-1,-1.0,0,0,0.0,0.0,0.04221126652908354,0.0,16,0,16
org.w3c.dom.html.HTMLFontElement,1,0,0,0,1,1.0,-1,-1.0,0,0,0.0,0.0,0.0016051364365971107,0.0,1,0,1
org.apache.wml.WMLTemplateElement,1,0,0,0,1,1.0,-1,-1.0,0,0,0.0,0.0,0.02088123436438043,0.0,1,0,1
org.w3c.dom.events.EventTarget,3,4,6,0.6666666666666666,1,0.3333333333333333,1,0.3333333333333333,2,0.3333333333333333,0.5,0.16666666666666666,0.08962122776286607,1.2472925150406274e-05,4,2,6
org.w3c.dom.html.HTMLTableRowElement,3,2,6,0.3333333333333333,1,0.3333333333333333,15,5.0,4,0.6666666666666666,0.0,0.0,0.03353837871250112,2.1505043362769434e-06,5,2,7
org.apache.wml.dom.WMLPrevElementImpl,4,6,12,0.5,1,0.25,159,39.75,6,0.5,0.3333333333333333,0.08333333333333333,0.030101805228786915,9.54823925306963e-05,1,3,4
org.apache.html.dom.HTMLParamElementImpl,4,5,12,0.4166666666666667,1,0.25,115,28.75,7,0.5833333333333334,0.0,0.0,0.0,0.0,0,3,3
org.w3c.dom.html.HTMLLabelElement,2,1,2,0.5,1,0.5,15,7.5,1,0.5,0.0,0.0,0.0016051364365971107,1.2903026017661663e-06,1,1,2
org.apache.xerces.dom.CharacterDataImpl,9,15,72,0.20833333333333334,1,0.1111111111111111,85,9.444444444444445,57,0.7916666666666666,0.0,0.0,0.08577138002417106,0.0001046465487016085,5,8,13
org.apache.xml.serialize.Serializer,5,4,20,0.2,1,0.2,20,4.0,16,0.8,0.0,0.0,0.021549636803874093,2.270932579108453e-05,3,4,7
org.w3c.dom.html.HTMLInputElement,2,1,2,0.5,1,0.5,15,7.5,1,0.5,0.0,0.0,0.0016051364365971107,1.2903026017661663e-06,1,1,2
org.apache.xerces.utils.XMLMessageProvider,1,0,0,0,1,1.0,-1,-1.0,0,0,0.0,0.0,0.06582857862246022,0.0,5,0,5
org.apache.xerces.utils.StringPool,5,4,20,0.2,1,0.2,3,0.6,16,0.8,0.0,0.0,0.13782167451975355,0.0027032699708735694,57,4,61
org.apache.xerces.utils.regex.ParserForXMLSchema,5,11,20,0.55,1,0.2,28,5.6,9,0.45,0.0,0.0,0.032746218599966986,0.0,1,4,5
org.apache.xerces.jaxp.DocumentBuilderFactoryImpl,5,9,20,0.45,1,0.2,302,60.4,11,0.55,0.0,0.0,0.0,0.0,0,4,4
org.xml.sax.ErrorHandler,2,1,2,0.5,1,0.5,2,1.0,1,0.5,0.0,0.0,0.05546695111256981,5.182715450427434e-05,20,1,21
org.apache.xerces.readers.XMLCatalogHandler,4,4,12,0.3333333333333333,1,0.25,2,0.5,8,0.6666666666666666,0.0,0.0,0.0036115569823434992,3.44080693804311e-06,2,3,5
org.apache.xerces.utils.IntStack,1,0,0,0,1,1.0,-1,-1.0,0,0,0.0,0.0,0.02892255216693419,0.0,2,0,2
javax.xml.parsers.ParserConfigurationException,1,0,0,0,1,1.0,-1,-1.0,0,0,0.0,0.0,0.009630818619582664,0.0,6,0,6
