name,Size,Ties,Pairs,Density,WeakComp,nWeakComp,2StepReach,ReachEffic,Broker,nBroker,EgoBetween,nEgoBetween,Closeness_Centrality,Betweenness_Centrality,in_degree,out_degree,degree
org.apache.tools.ant.input.PropertyFileInputHandler,3,3,6,0.5,1,0.3333333333333333,1,0.3333333333333333,3,0.5,0.0,0.0,0.00253592561284869,2.0262612999825026e-06,3,2,5
org.apache.tools.ant.types.selectors.OrSelector,2,2,2,1.0,1,0.5,205,102.5,0,0.0,0.0,0.0,0.1639514870111676,0.00011814295297309685,5,1,6
org.apache.tools.ant.filters.util.ChainReaderHelper,13,35,156,0.22435897435897437,1,0.07692307692307693,205,15.76923076923077,121,0.7756410256410257,0.3484848484848485,0.026806526806526808,0.20177339901477834,0.027331173368988756,4,12,16
org.apache.tools.ant.taskdefs.Ant,11,24,110,0.21818181818181817,1,0.09090909090909091,212,19.272727272727273,86,0.7818181818181819,0.0,0.0,0.002704987320371936,0.000159150338349312,3,10,13
org.apache.tools.ant.taskdefs.JikesOutputParser,4,6,12,0.5,1,0.25,206,51.5,6,0.5,0.0,0.0,0.0008453085376162299,6.376763502886112e-05,1,3,4
org.apache.tools.ant.taskdefs.SignJar,10,25,90,0.2777777777777778,1,0.1,212,21.2,65,0.7222222222222222,0.0,0.0,0.0,0.0,0,9,9
org.apache.tools.ant.taskdefs.condition.And,4,5,12,0.4166666666666667,1,0.25,227,56.75,7,0.5833333333333334,0.16666666666666666,0.041666666666666664,0.0023480792711561946,8.379547622031029e-07,1,3,4
org.apache.tools.ant.taskdefs.condition.IsTrue,4,3,12,0.25,1,0.25,206,51.5,9,0.75,0.0,0.0,0.0027664643049258434,8.379547622031029e-07,1,3,4
org.apache.tools.ant.taskdefs.ExecuteOn,17,46,272,0.16911764705882354,1,0.058823529411764705,215,12.647058823529411,226,0.8308823529411765,0.0,0.0,0.0038038884192730348,0.0003841760735055038,4,16,20
org.apache.tools.ant.types.Assertions,9,18,72,0.25,1,0.1111111111111111,216,24.0,54,0.75,0.08928571428571427,0.00992063492063492,0.018862301406680104,0.00012992762058417214,4,9,13
org.apache.tools.bzip2.CRC,1,0,0,0,1,1.0,-1,-1.0,0,0,0.0,0.0,0.0033812341504649195,0.0,2,0,2
org.apache.tools.ant.taskdefs.SQLExec,8,12,56,0.21428571428571427,1,0.125,209,26.125,44,0.7857142857142857,0.14285714285714285,0.017857142857142856,0.0016906170752324597,0.0001734904461752821,2,7,9
org.apache.tools.ant.taskdefs.ExecuteWatchdog,4,5,12,0.4166666666666667,1,0.25,205,51.25,7,0.5833333333333334,0.0,0.0,0.1310803891449053,0.0011588242552709558,6,3,9
org.apache.tools.ant.taskdefs.condition.IsSet,3,2,6,0.3333333333333333,1,0.3333333333333333,206,68.66666666666667,4,0.6666666666666666,0.0,0.0,0.0027664643049258434,0.0,1,2,3
org.apache.tools.ant.types.Commandline,5,8,20,0.4,1,0.2,205,41.0,12,0.6,0.41666666666666663,0.08333333333333333,0.1395523150829614,0.0011851422464335517,75,5,80
org.apache.tools.ant.types.selectors.NotSelector,2,1,2,0.5,1,0.5,205,102.5,1,0.5,0.0,0.0,0.16399743754003845,0.0,5,1,6
org.apache.tools.ant.types.XMLCatalog,12,28,132,0.21212121212121213,1,0.08333333333333333,210,17.5,104,0.7878787878787878,0.14545454545454545,0.012121212121212121,0.0068188222034375875,0.0005283297551942612,8,12,20
org.apache.tools.ant.filters.LineContainsRegExp,7,10,42,0.23809523809523808,1,0.14285714285714285,205,29.285714285714285,32,0.7619047619047619,0.0,0.0,0.12885770912637243,0.00019878319771128358,1,6,7
org.apache.tools.ant.helper.ProjectHelper2,15,57,210,0.2714285714285714,1,0.06666666666666667,205,13.666666666666666,153,0.7285714285714285,0.4743589743589744,0.03162393162393163,0.1573387623401068,0.004638108241560533,7,14,21
org.apache.tools.ant.taskdefs.SubAnt,12,37,132,0.2803030303030303,1,0.08333333333333333,213,17.75,95,0.7196969696969697,0.0,0.0,0.0,0.0,0,11,11
org.apache.tools.ant.types.selectors.FileSelector,1,0,0,0,1,1.0,-1,-1.0,0,0,0.0,0.0,0.17101786654746784,0.0,10,0,10
org.apache.tools.ant.types.Path,14,44,182,0.24175824175824176,1,0.07142857142857142,205,14.642857142857142,138,0.7582417582417582,0.36538461538461536,0.026098901098901096,0.26670139341060034,0.03131476225571666,94,14,108
org.apache.tools.ant.filters.StripLineComments,5,5,20,0.25,1,0.2,205,41.0,15,0.75,0.0,0.0,0.12885770912637243,0.0006539587778058831,1,4,5
org.apache.tools.ant.taskdefs.Sequential,3,3,6,0.5,1,0.3333333333333333,206,68.66666666666667,3,0.5,0.0,0.0,0.0008453085376162299,0.00014803626673989814,1,2,3
org.apache.tools.ant.util.TaskLogger,3,5,6,0.8333333333333334,1,0.3333333333333333,206,68.66666666666667,1,0.16666666666666666,0.0,0.0,0.0,0.0,0,2,2
org.apache.tools.ant.taskdefs.compilers.Gcj,8,26,56,0.4642857142857143,1,0.125,225,28.125,30,0.5357142857142857,0.0,0.0,0.004046689807737271,2.3967961432798086e-05,1,7,8
org.apache.tools.ant.types.selectors.SelectSelector,4,8,12,0.6666666666666666,1,0.25,205,51.25,4,0.3333333333333333,0.0,0.0,0.1639514870111676,0.00012704650729928476,6,4,10
org.apache.tools.ant.types.selectors.FilenameSelector,5,7,20,0.35,1,0.2,205,41.0,13,0.65,0.0,0.0,0.16422757708191332,0.0001307908524722785,7,4,11
org.apache.tools.ant.types.selectors.TypeSelector,4,4,12,0.3333333333333333,1,0.25,205,51.25,8,0.6666666666666666,0.0,0.0,0.16431981385646088,0.0006874238999980988,5,3,8
org.apache.tools.ant.taskdefs.GUnzip,2,1,2,0.5,1,0.5,207,103.5,1,0.5,0.0,0.0,0.0,0.0,0,1,1
org.apache.tools.ant.taskdefs.Basename,4,8,12,0.6666666666666666,1,0.25,206,51.5,4,0.3333333333333333,0.0,0.0,0.0,0.0,0,3,3
org.apache.tools.ant.types.selectors.SelectorScanner,2,1,2,0.5,1,0.5,0,0.0,1,0.5,0.0,0.0,0.1662086415012718,0.0,2,1,3
org.apache.tools.ant.PathTokenizer,2,1,2,0.5,1,0.5,1,0.5,1,0.5,0.0,0.0,0.23989787151655959,0.0001796501516835387,2,1,3
org.apache.tools.ant.taskdefs.Definer,13,39,156,0.25,1,0.07692307692307693,205,15.76923076923077,117,0.75,0.0,0.0,0.14127060771194042,0.0019458902414779024,1,12,13
org.apache.tools.ant.input.InputHandler,2,1,2,0.5,1,0.5,0,0.0,1,0.5,0.0,0.0,0.23527754296985065,0.0002973836437327261,8,1,9
org.apache.tools.ant.taskdefs.condition.IsReference,7,13,42,0.30952380952380953,1,0.14285714285714285,206,29.428571428571427,29,0.6904761904761905,0.0,0.0,0.0027664643049258434,5.4041709784444205e-05,1,6,7
org.apache.tools.ant.taskdefs.BUnzip2,3,2,6,0.3333333333333333,1,0.3333333333333333,210,70.0,4,0.6666666666666666,0.0,0.0,0.0,0.0,0,2,2
org.apache.tools.ant.ProjectHelper,8,18,56,0.32142857142857145,1,0.125,205,25.625,38,0.6785714285714286,0.07142857142857142,0.008928571428571428,0.20198234626953995,0.005617144330090369,24,8,32
org.apache.tools.ant.taskdefs.KeySubst,2,1,2,0.5,1,0.5,206,103.0,1,0.5,0.0,0.0,0.0,0.0,0,1,1
org.apache.tools.ant.PropertyHelper,2,4,2,2.0,1,0.5,205,102.5,-2,-1.0,0.0,0.0,0.23462023141253296,0.0,3,2,5
org.apache.tools.ant.types.CommandlineJava,11,30,110,0.2727272727272727,1,0.09090909090909091,216,19.636363636363637,80,0.7272727272727273,0.07777777777777778,0.007070707070707071,0.02132260159016012,0.00029376991514097573,15,10,25
org.apache.tools.ant.filters.TailFilter,5,5,20,0.25,1,0.2,205,41.0,15,0.75,0.0,0.0,0.12885770912637243,5.951330831159527e-05,1,4,5
org.apache.tools.ant.filters.ExpandProperties,4,5,12,0.4166666666666667,1,0.25,205,51.25,7,0.5833333333333334,0.0,0.0,0.128829338868969,2.4462673063698804e-05,1,3,4
org.apache.tools.ant.DirectoryScanner,9,14,72,0.19444444444444445,1,0.1111111111111111,205,22.77777777777778,58,0.8055555555555556,0.0,0.0,0.2151260504201681,0.00459631558094257,72,8,80
org.apache.tools.ant.taskdefs.PumpStreamHandler,3,2,6,0.3333333333333333,1,0.3333333333333333,1,0.3333333333333333,4,0.6666666666666666,0.0,0.0,0.13083209283270905,0.0005985814263830664,10,2,12
org.apache.tools.ant.types.ResourceLocation,1,0,0,0,1,1.0,-1,-1.0,0,0,0.0,0.0,0.011875554089437766,0.0,10,0,10
org.apache.tools.ant.taskdefs.War,8,21,56,0.375,1,0.125,234,29.25,35,0.625,0.0,0.0,0.0,0.0,0,7,7
org.apache.tools.ant.taskdefs.MacroDef,14,47,182,0.25824175824175827,1,0.07142857142857142,213,15.214285714285714,135,0.7417582417582418,0.22243589743589745,0.01588827838827839,0.0033812341504649195,0.00027813627889362386,4,13,17
org.apache.tools.ant.taskdefs.Copydir,3,3,6,0.5,1,0.3333333333333333,207,69.0,3,0.5,0.0,0.0,0.0,0.0,0,2,2
org.apache.tools.ant.taskdefs.LoadProperties,5,6,20,0.3,1,0.2,206,41.2,14,0.7,0.0,0.0,0.0,0.0,0,4,4
org.apache.tools.ant.types.ZipFileSet,8,17,56,0.30357142857142855,1,0.125,218,27.25,39,0.6964285714285714,0.0,0.0,0.00422654268808115,5.809320720965315e-05,6,8,14
org.apache.tools.ant.Diagnostics,4,5,12,0.4166666666666667,1,0.25,214,53.5,7,0.5833333333333334,0.16666666666666666,0.041666666666666664,0.0008453085376162299,3.57575523526324e-07,1,3,4
org.apache.tools.ant.util.MergingMapper,2,1,2,0.5,1,0.5,0,0.0,1,0.5,0.0,0.0,0.004347301050597754,3.57575523526324e-07,3,1,4
org.apache.tools.ant.types.selectors.modifiedselector.HashvalueAlgorithm,2,1,2,0.5,1,0.5,0,0.0,1,0.5,0.0,0.0,0.0008453085376162299,0.0,1,1,2
org.apache.tools.ant.taskdefs.email.UUMailer,2,1,2,0.5,1,0.5,215,107.5,1,0.5,0.0,0.0,0.0,0.0,0,1,1
org.apache.tools.ant.types.AbstractFileSet,31,83,930,0.08924731182795699,1,0.03225806451612903,205,6.612903225806452,847,0.910752688172043,0.0,0.0,0.20912896967221484,0.028119015391858085,61,31,92
org.apache.tools.ant.taskdefs.MacroInstance,11,32,110,0.2909090909090909,1,0.09090909090909091,213,19.363636363636363,78,0.7090909090909091,0.1,0.009090909090909092,0.0022541561003099463,1.5965747125450367e-05,2,10,12
org.apache.tools.ant.taskdefs.MatchingTask,28,88,756,0.1164021164021164,1,0.03571428571428571,206,7.357142857142857,668,0.8835978835978836,0.0,0.0,0.03762087447632672,0.002646291514418296,28,27,55
org.apache.tools.ant.taskdefs.Copy,14,29,182,0.15934065934065933,1,0.07142857142857142,209,14.928571428571429,153,0.8406593406593407,0.0,0.0,0.0033812341504649195,0.00030643053098993264,4,13,17
org.apache.tools.ant.types.DTDLocation,2,1,2,0.5,1,0.5,0,0.0,1,0.5,0.0,0.0,0.005494505494505495,1.609089855868458e-06,3,1,4
org.apache.tools.ant.taskdefs.Typedef,2,1,2,0.5,1,0.5,205,102.5,1,0.5,0.0,0.0,0.17667356797791584,0.0023935747969328603,2,1,3
org.apache.tools.ant.types.resolver.ApacheCatalog,2,2,2,1.0,1,0.5,212,106.0,0,0.0,0.0,0.0,0.0008453085376162299,0.0,1,1,2
org.apache.tools.ant.taskdefs.cvslib.ChangeLogWriter,3,3,6,0.5,1,0.3333333333333333,1,0.3333333333333333,3,0.5,0.0,0.0,0.0008453085376162299,3.57575523526324e-07,1,2,3
org.apache.tools.ant.taskdefs.compilers.Jikes,8,26,56,0.4642857142857143,1,0.125,225,28.125,30,0.5357142857142857,0.0,0.0,0.004046689807737271,2.3967961432798086e-05,1,7,8
org.apache.tools.ant.taskdefs.BuildNumber,5,11,20,0.55,1,0.2,206,41.2,9,0.45,0.0,0.0,0.0,0.0,0,4,4
org.apache.tools.ant.types.Reference,3,4,6,0.6666666666666666,1,0.3333333333333333,205,68.33333333333333,2,0.3333333333333333,0.0,0.0,0.22047583162880827,0.0009688708867778659,51,2,53
org.apache.tools.ant.taskdefs.Chmod,12,39,132,0.29545454545454547,1,0.08333333333333333,216,18.0,93,0.7045454545454546,0.0,0.0,0.0,0.0,0,11,11
org.apache.tools.ant.taskdefs.AntlibDefinition,4,6,12,0.5,1,0.25,205,51.25,6,0.5,0.0,0.0,0.17704776312945755,8.403024802868613e-06,5,3,8
org.apache.tools.ant.util.PackageNameMapper,2,1,2,0.5,1,0.5,1,0.5,1,0.5,0.0,0.0,0.0008453085376162299,0.0,1,1,2
org.apache.tools.ant.util.LineTokenizer,3,2,6,0.3333333333333333,1,0.3333333333333333,205,68.33333333333333,4,0.6666666666666666,0.0,0.0,0.20317460317460317,0.0007357911008828622,5,2,7
org.apache.tools.ant.TaskAdapter,4,8,12,0.6666666666666666,1,0.25,205,51.25,4,0.3333333333333333,0.3333333333333333,0.08333333333333333,0.23415080317841425,0.0002887656479305947,3,3,6
org.apache.tools.ant.taskdefs.rmic.DefaultRmicAdapter,11,34,110,0.3090909090909091,1,0.09090909090909091,219,19.90909090909091,76,0.6909090909090909,0.0425925925925926,0.0038720538720538726,0.003182338023966983,9.172459219873736e-05,4,10,14
org.apache.tools.ant.types.Parameter,1,0,0,0,1,1.0,-1,-1.0,0,0,0.0,0.0,0.16929439251085357,0.0,30,0,30
org.apache.tools.ant.IntrospectionHelper,19,63,342,0.18421052631578946,1,0.05263157894736842,205,10.789473684210526,279,0.8157894736842105,0.18474945533769063,0.00972365554408898,0.18389153272874204,0.0018415665973319842,2,19,21
org.apache.tools.ant.taskdefs.compilers.Javac12,6,11,30,0.36666666666666664,1,0.16666666666666666,225,37.5,19,0.6333333333333333,0.0,0.0,0.004226542688081149,2.069981283379916e-05,2,5,7
org.apache.tools.ant.types.FileSet,2,3,2,1.5,1,0.5,205,102.5,-1,-0.5,0.0,0.0,0.20950335021226538,0.0005484074223604384,68,2,70
org.apache.tools.ant.input.MultipleChoiceInputRequest,2,1,2,0.5,1,0.5,0,0.0,1,0.5,0.0,0.0,0.17608847714591028,0.0,2,1,3
org.apache.tools.mail.MailMessage,4,3,12,0.25,1,0.25,2,0.5,9,0.75,0.0,0.0,0.004025278750553476,2.145453141157944e-05,3,3,6
org.apache.tools.ant.types.PropertySet,14,38,182,0.2087912087912088,1,0.07142857142857142,208,14.857142857142858,144,0.7912087912087912,0.0,0.0,0.023398336904598086,0.0004689090104943287,10,14,24
org.apache.tools.ant.taskdefs.XSLTLogger,1,0,0,0,1,1.0,-1,-1.0,0,0,0.0,0.0,0.0035221189067342917,0.0,4,0,4
org.apache.tools.ant.DemuxOutputStream,3,3,6,0.5,1,0.3333333333333333,207,69.0,3,0.5,0.0,0.0,0.0019019442096365174,6.78933754741196e-05,2,2,4
org.apache.tools.ant.DefaultLogger,9,23,72,0.3194444444444444,1,0.1111111111111111,208,23.11111111111111,49,0.6805555555555556,0.0,0.0,0.0071428571428571435,0.00023019705841277087,7,8,15
org.apache.tools.tar.TarInputStream,3,3,6,0.5,1,0.3333333333333333,3,1.0,3,0.5,0.0,0.0,0.0016906170752324597,1.072726570578972e-06,2,2,4
org.apache.tools.ant.types.selectors.DifferentSelector,3,4,6,0.6666666666666666,1,0.3333333333333333,205,68.33333333333333,2,0.3333333333333333,0.0,0.0,0.16404341383315313,0.0004780955023605773,4,2,6
org.apache.tools.ant.BuildListener,2,1,2,0.5,1,0.5,205,102.5,1,0.5,0.0,0.0,0.23825034899953468,3.498280538499203e-06,22,1,23
org.apache.tools.ant.taskdefs.condition.Contains,3,2,6,0.3333333333333333,1,0.3333333333333333,206,68.66666666666667,4,0.6666666666666666,0.0,0.0,0.003451676528599606,0.00014887422150210123,2,2,4
org.apache.tools.ant.taskdefs.Antlib,9,33,72,0.4583333333333333,1,0.1111111111111111,205,22.77777777777778,39,0.5416666666666666,0.0,0.0,0.11771129695088658,1.6412716529858275e-05,2,9,11
org.apache.tools.ant.helper.ProjectHelperImpl,12,41,132,0.3106060606060606,1,0.08333333333333333,205,17.083333333333332,91,0.6893939393939394,0.23484848484848483,0.01957070707070707,0.1762478485370052,0.005478638966644407,10,12,22
org.apache.tools.ant.types.selectors.modifiedselector.PropertiesfileCache,2,1,2,0.5,1,0.5,0,0.0,1,0.5,0.0,0.0,0.13342818377115293,0.0,2,1,3
org.apache.tools.ant.taskdefs.cvslib.CvsUser,1,0,0,0,1,1.0,-1,-1.0,0,0,0.0,0.0,0.0008453085376162299,0.0,1,0,1
org.apache.tools.ant.taskdefs.BZip2,3,2,6,0.3333333333333333,1,0.3333333333333333,211,70.33333333333333,4,0.6666666666666666,0.0,0.0,0.0,0.0,0,2,2
org.apache.tools.ant.TypeAdapter,2,2,2,1.0,1,0.5,205,102.5,0,0.0,0.0,0.0,0.19172439618049059,6.60109723443839e-05,7,1,8
org.apache.tools.ant.taskdefs.ProcessDestroyer,2,2,2,1.0,1,0.5,0,0.0,0,0.0,0.0,0.0,0.13016591215191375,0.0005957208221948558,3,1,4
org.apache.tools.ant.types.selectors.PresentSelector,6,8,30,0.26666666666666666,1,0.16666666666666666,205,34.166666666666664,22,0.7333333333333333,0.0,0.0,0.16418149751483085,0.003042455180291964,6,5,11
org.apache.tools.ant.types.FilterSetCollection,2,2,2,1.0,1,0.5,205,102.5,0,0.0,0.0,0.0,0.2514580391675364,0.00020401327813653872,5,1,6
org.apache.tools.ant.taskdefs.GenerateKey,8,17,56,0.30357142857142855,1,0.125,214,26.75,39,0.6964285714285714,0.0,0.0,0.0,0.0,0,7,7
org.apache.tools.ant.types.selectors.modifiedselector.Cache,1,0,0,0,1,1.0,-1,-1.0,0,0,0.0,0.0,0.13371831366618023,0.0,3,0,3
org.apache.tools.ant.taskdefs.email.EmailTask,10,20,90,0.2222222222222222,1,0.1,216,21.6,70,0.7777777777777778,0.1111111111111111,0.01111111111111111,0.00253592561284869,0.0004641330295371687,3,9,12
org.apache.tools.ant.util.FlatFileNameMapper,2,1,2,0.5,1,0.5,0,0.0,1,0.5,0.0,0.0,0.0023480792711561946,0.0,1,1,2
org.apache.tools.ant.taskdefs.Transform,2,1,2,0.5,1,0.5,216,108.0,1,0.5,0.0,0.0,0.0,0.0,0,1,1
org.apache.tools.ant.util.GlobPatternMapper,2,1,2,0.5,1,0.5,0,0.0,1,0.5,0.0,0.0,0.01078167115902965,8.343428882280894e-06,8,1,9
org.apache.tools.mail.ErrorInQuitException,1,0,0,0,1,1.0,-1,-1.0,0,0,0.0,0.0,0.003196322907861369,0.0,1,0,1
org.apache.tools.ant.taskdefs.rmic.RmicAdapterFactory,7,13,42,0.30952380952380953,1,0.14285714285714285,219,31.285714285714285,29,0.6904761904761905,0.0,0.0,0.003182338023966983,2.6949584878965144e-05,1,6,7
org.apache.tools.ant.taskdefs.cvslib.RCSFile,1,0,0,0,1,1.0,-1,-1.0,0,0,0.0,0.0,0.00253592561284869,0.0,2,0,2
org.apache.tools.ant.XmlLogger,11,24,110,0.21818181818181817,1,0.09090909090909091,212,19.272727272727273,86,0.7818181818181819,0.0,0.0,0.0,0.0,0,10,10
org.apache.tools.ant.types.Description,9,35,72,0.4861111111111111,1,0.1111111111111111,205,22.77777777777778,37,0.5138888888888888,0.28125,0.03125,0.2333105491000228,0.006888922507100882,1,8,9
org.apache.tools.ant.Location,3,3,6,0.5,1,0.3333333333333333,205,68.33333333333333,3,0.5,0.0,0.0,0.26298555377207067,0.008687401554412217,20,2,22
org.apache.tools.ant.taskdefs.CallTarget,6,13,30,0.43333333333333335,1,0.16666666666666666,213,35.5,17,0.5666666666666667,0.0,0.0,0.0,0.0,0,5,5
org.apache.tools.ant.taskdefs.ManifestException,1,0,0,0,1,1.0,-1,-1.0,0,0,0.0,0.0,0.00993668811565201,0.0,8,0,8
org.apache.tools.ant.taskdefs.compilers.Jvc,5,10,20,0.5,1,0.2,225,45.0,10,0.5,0.0,0.0,0.004046689807737271,1.1698427524223795e-05,1,4,5
org.apache.tools.ant.types.selectors.ExtendFileSelector,1,0,0,0,1,1.0,-1,-1.0,0,0,0.0,0.0,0.1351809854477963,0.0,2,0,2
org.apache.tools.mail.MailPrintStream,1,0,0,0,1,1.0,-1,-1.0,0,0,0.0,0.0,0.003196322907861369,0.0,1,0,1
org.apache.tools.ant.taskdefs.XSLTProcess,18,47,306,0.15359477124183007,1,0.05555555555555555,221,12.277777777777779,259,0.8464052287581699,0.058823529411764705,0.0032679738562091504,0.0019019442096365174,0.0003996502434612549,2,17,19
org.apache.tools.ant.taskdefs.Manifest,7,17,42,0.40476190476190477,1,0.14285714285714285,210,30.0,25,0.5952380952380952,0.1,0.014285714285714287,0.01315200636467605,0.0006536242186378851,13,7,20
org.apache.tools.ant.types.selectors.DependSelector,3,3,6,0.5,1,0.3333333333333333,205,68.33333333333333,3,0.5,0.0,0.0,0.16422757708191332,0.0003070410207689172,6,2,8
org.apache.tools.ant.taskdefs.condition.Not,3,4,6,0.6666666666666666,1,0.3333333333333333,227,75.66666666666667,2,0.3333333333333333,0.0,0.0,0.0023480792711561946,0.0,1,2,3
org.apache.tools.ant.types.selectors.SelectorContainer,21,27,420,0.06428571428571428,1,0.047619047619047616,205,9.761904761904763,393,0.9357142857142857,0.0,0.0,0.16385966315957917,0.0,3,20,23
org.apache.tools.ant.taskdefs.Exit,4,8,12,0.6666666666666666,1,0.25,206,51.5,4,0.3333333333333333,0.0,0.0,0.0,0.0,0,3,3
org.apache.tools.ant.taskdefs.Copyfile,2,1,2,0.5,1,0.5,206,103.0,1,0.5,0.0,0.0,0.0,0.0,0,1,1
org.apache.tools.ant.filters.TokenFilter,16,29,240,0.12083333333333333,1,0.0625,205,12.8125,211,0.8791666666666667,0.23333333333333336,0.014583333333333335,0.12997397981849337,0.002536635098600205,6,15,21
org.apache.tools.ant.filters.StripJavaComments,3,2,6,0.3333333333333333,1,0.3333333333333333,205,68.33333333333333,4,0.6666666666666666,0.0,0.0,0.128829338868969,1.3594881178775338e-06,1,2,3
org.apache.tools.mail.SmtpResponseReader,1,0,0,0,1,1.0,-1,-1.0,0,0,0.0,0.0,0.003196322907861369,0.0,1,0,1
org.apache.tools.ant.taskdefs.LoadFile,6,14,30,0.4666666666666667,1,0.16666666666666666,206,34.333333333333336,16,0.5333333333333333,0.0,0.0,0.0,0.0,0,5,5
org.apache.tools.ant.ExitException,1,0,0,0,1,1.0,-1,-1.0,0,0,0.0,0.0,0.015655577299412915,0.0,4,0,4
org.apache.tools.ant.taskdefs.Move,5,11,20,0.55,1,0.2,210,42.0,9,0.45,0.0,0.0,0.0008453085376162299,4.0491171187885635e-06,1,4,5
org.apache.tools.ant.taskdefs.XSLTLiaison,1,0,0,0,1,1.0,-1,-1.0,0,0,0.0,0.0,0.006224544686083148,0.0,7,0,7
org.apache.tools.ant.taskdefs.email.EmailAddress,1,0,0,0,1,1.0,-1,-1.0,0,0,0.0,0.0,0.006037918125830214,0.0,6,0,6
org.apache.tools.ant.util.TimeoutObserver,2,2,2,1.0,1,0.5,0,0.0,0,0.0,0.0,0.0,0.11118748585291119,0.0,3,1,4
org.apache.tools.ant.taskdefs.rmic.SunRmic,7,16,42,0.38095238095238093,1,0.14285714285714285,219,31.285714285714285,26,0.6190476190476191,0.0,0.0,0.002459079382156305,2.2780538064746247e-05,1,6,7
org.apache.tools.ant.types.ZipScanner,5,7,20,0.35,1,0.2,217,43.4,13,0.65,0.0,0.0,0.003043110735418428,1.6615342659856523e-05,2,4,6
org.apache.tools.ant.types.selectors.DepthSelector,4,4,12,0.3333333333333333,1,0.25,205,51.25,8,0.6666666666666666,0.0,0.0,0.16431981385646088,9.69140017107532e-05,6,3,9
org.apache.tools.ant.taskdefs.cvslib.CvsTagDiff,4,4,12,0.3333333333333333,1,0.25,210,52.5,8,0.6666666666666666,0.0,0.0,0.0,0.0,0,3,3
org.apache.tools.ant.taskdefs.cvslib.CVSEntry,2,1,2,0.5,1,0.5,0,0.0,1,0.5,0.0,0.0,0.003018959062915107,2.503028664684268e-06,3,1,4
org.apache.tools.ant.taskdefs.Java,20,77,380,0.2026315789473684,1,0.05,225,11.25,303,0.7973684210526316,0.0,0.0,0.019233143692953546,0.002102942115480995,17,19,36
org.apache.tools.ant.taskdefs.ConditionTask,5,7,20,0.35,1,0.2,228,45.6,13,0.65,0.0,0.0,0.0,0.0,0,4,4
org.apache.tools.tar.TarBuffer,1,0,0,0,1,1.0,-1,-1.0,0,0,0.0,0.0,0.002641589180050719,0.0,2,0,2
org.apache.tools.ant.types.Permissions,4,5,12,0.4166666666666667,1,0.25,209,52.25,7,0.5833333333333334,0.16666666666666666,0.041666666666666664,0.01650993237531699,0.0003683916413318991,6,3,9
org.apache.tools.ant.taskdefs.Dirname,2,1,2,0.5,1,0.5,206,103.0,1,0.5,0.0,0.0,0.0,0.0,0,1,1
org.apache.tools.zip.ExtraFieldUtils,5,9,20,0.45,1,0.2,5,1.0,11,0.55,0.0,0.0,0.005958394326124157,2.860604188210592e-05,2,4,6
org.apache.tools.ant.taskdefs.Expand,12,33,132,0.25,1,0.08333333333333333,217,18.083333333333332,99,0.75,0.0,0.0,0.0008453085376162299,0.0001190726493342659,1,11,12
org.apache.tools.ant.types.selectors.BaseSelectorContainer,23,57,506,0.11264822134387352,1,0.043478260869565216,205,8.91304347826087,449,0.8873517786561265,0.2662337662337662,0.01157538114059853,0.1332899446794663,0.0007684298000580703,5,22,27
org.apache.tools.ant.util.CollectionUtils,1,0,0,0,1,1.0,-1,-1.0,0,0,0.0,0.0,0.18941991790921212,0.0,7,0,7
org.apache.tools.ant.util.regexp.RegexpMatcher,1,0,0,0,1,1.0,-1,-1.0,0,0,0.0,0.0,0.14502220598904428,0.0,21,0,21
org.apache.tools.bzip2.CBZip2InputStream,3,2,6,0.3333333333333333,1,0.3333333333333333,1,0.3333333333333333,4,0.6666666666666666,0.0,0.0,0.0019019442096365174,4.290906282315888e-06,2,2,4
org.apache.tools.ant.util.FileUtils,7,10,42,0.23809523809523808,1,0.14285714285714285,205,29.285714285714285,32,0.7619047619047619,0.3,0.04285714285714286,0.2819965576592083,0.03086233583638828,89,7,96
org.apache.tools.ant.taskdefs.XSLTLiaison2,2,2,2,1.0,1,0.5,221,110.5,0,0.0,0.0,0.0,0.0019019442096365174,0.0,2,1,3
org.apache.tools.zip.UnrecognizedExtraField,3,3,6,0.5,1,0.3333333333333333,1,0.3333333333333333,3,0.5,0.0,0.0,0.004890713681922474,0.0,3,2,5
org.apache.tools.ant.UnknownElement,13,52,156,0.3333333333333333,1,0.07692307692307693,205,15.76923076923077,104,0.6666666666666666,0.3712121212121212,0.028554778554778556,0.2488910494014705,0.008055907796358196,19,13,32
org.apache.tools.ant.taskdefs.email.Message,3,5,6,0.8333333333333334,1,0.3333333333333333,206,68.66666666666667,1,0.16666666666666666,0.0,0.0,0.00526692242668574,0.0005100031582432431,5,2,7
org.apache.tools.ant.filters.EscapeUnicode,3,2,6,0.3333333333333333,1,0.3333333333333333,205,68.33333333333333,4,0.6666666666666666,0.0,0.0,0.12885770912637243,5.8785416067727384e-05,1,2,3
org.apache.tools.ant.taskdefs.Exec,5,10,20,0.5,1,0.2,207,41.4,10,0.5,0.25,0.05,0.0008453085376162299,0.00014803626673989814,1,4,5
org.apache.tools.ant.taskdefs.Unpack,2,1,2,0.5,1,0.5,206,103.0,1,0.5,0.0,0.0,0.0016906170752324597,0.0002960725334797963,2,1,3
org.apache.tools.ant.types.FilterSet,7,14,42,0.3333333333333333,1,0.14285714285714285,205,29.285714285714285,28,0.6666666666666666,0.3333333333333333,0.047619047619047616,0.24040380326329386,0.0017344642709313327,8,7,15
org.apache.tools.ant.types.DirSet,2,3,2,1.5,1,0.5,205,102.5,-1,-0.5,0.0,0.0,0.19465830244273358,3.664186186984585e-05,8,2,10
org.apache.tools.ant.taskdefs.Zip,25,68,600,0.11333333333333333,1,0.04,226,9.04,532,0.8866666666666667,0.0,0.0,0.001521555367709214,5.440426453423609e-05,1,24,25
org.apache.tools.ant.util.ScriptRunner,1,0,0,0,1,1.0,-1,-1.0,0,0,0.0,0.0,0.002704987320371936,0.0,3,0,3
org.apache.tools.ant.taskdefs.condition.Or,3,4,6,0.6666666666666666,1,0.3333333333333333,227,75.66666666666667,2,0.3333333333333333,0.0,0.0,0.0023480792711561946,0.0,1,2,3
org.apache.tools.ant.taskdefs.Tstamp,5,13,20,0.65,1,0.2,209,41.8,7,0.35,0.0,0.0,0.00253592561284869,2.3379938076721186e-07,3,4,7
org.apache.tools.tar.TarConstants,1,0,0,0,1,1.0,-1,-1.0,0,0,0.0,0.0,0.0037654653039268424,0.0,3,0,3
org.apache.tools.ant.input.InputRequest,1,0,0,0,1,1.0,-1,-1.0,0,0,0.0,0.0,0.17741071206988157,0.0,5,0,5
org.apache.tools.ant.util.Watchdog,2,2,2,1.0,1,0.5,0,0.0,0,0.0,0.0,0.0,0.11118748585291119,0.0,3,1,4
org.apache.tools.ant.filters.ClassConstants,3,2,6,0.3333333333333333,1,0.3333333333333333,205,68.33333333333333,4,0.6666666666666666,0.0,0.0,0.128829338868969,1.3594881178775338e-06,1,2,3
org.apache.tools.ant.taskdefs.ExecTask,14,43,182,0.23626373626373626,1,0.07142857142857142,211,15.071428571428571,139,0.7637362637362637,0.0,0.0,0.007513853667699822,0.0002139803472873063,6,13,19
org.apache.tools.ant.taskdefs.compilers.CompilerAdapter,2,2,2,1.0,1,0.5,225,112.5,0,0.0,0.0,0.0,0.00655842830909144,5.584901809333372e-06,4,1,5
org.apache.tools.ant.types.ResourceFactory,2,1,2,0.5,1,0.5,0,0.0,1,0.5,0.0,0.0,0.16559861543139137,0.0,4,1,5
org.apache.tools.ant.taskdefs.Touch,7,14,42,0.3333333333333333,1,0.14285714285714285,206,29.428571428571427,28,0.6666666666666666,0.0,0.0,0.0,0.0,0,6,6
org.apache.tools.ant.taskdefs.Jikes,3,2,6,0.3333333333333333,1,0.3333333333333333,207,69.0,4,0.6666666666666666,0.0,0.0,0.0,0.0,0,2,2
org.apache.tools.ant.taskdefs.Deltree,2,1,2,0.5,1,0.5,206,103.0,1,0.5,0.0,0.0,0.0,0.0,0,1,1
org.apache.tools.zip.ZipEntry,4,7,12,0.5833333333333334,1,0.25,6,1.5,5,0.4166666666666667,0.0,0.0,0.007924767540152155,4.898784672310639e-05,8,4,12
org.apache.tools.ant.taskdefs.Get,7,16,42,0.38095238095238093,1,0.14285714285714285,207,29.571428571428573,26,0.6190476190476191,0.0,0.0,0.0011270780501549732,2.072348811903674e-05,1,6,7
org.apache.tools.ant.types.FileList,6,15,30,0.5,1,0.16666666666666666,205,34.166666666666664,15,0.5,0.0,0.0,0.19478790184515885,0.00010052072304540649,9,6,15
org.apache.tools.ant.taskdefs.Property,9,28,72,0.3888888888888889,1,0.1111111111111111,205,22.77777777777778,44,0.6111111111111112,0.0,0.0,0.17742354673828295,0.011652200939873035,6,8,14
org.apache.tools.ant.types.Resource,1,0,0,0,1,1.0,-1,-1.0,0,0,0.0,0.0,0.16774070292613077,0.0,9,0,9
org.apache.tools.ant.taskdefs.Untar,6,9,30,0.3,1,0.16666666666666666,227,37.833333333333336,21,0.7,0.0,0.0,0.0,0.0,0,5,5
org.apache.tools.ant.taskdefs.ManifestTask,7,16,42,0.38095238095238093,1,0.14285714285714285,212,30.285714285714285,26,0.6190476190476191,0.0,0.0,0.0,0.0,0,6,6
org.apache.tools.tar.TarOutputStream,4,5,12,0.4166666666666667,1,0.25,3,0.75,7,0.5833333333333334,0.0,0.0,0.0016906170752324597,1.430302094105296e-06,2,3,5
org.apache.tools.ant.types.Parameterizable,2,1,2,0.5,1,0.5,0,0.0,1,0.5,0.0,0.0,0.165271990943361,0.0,3,1,4
org.apache.tools.zip.ZipFile,6,11,30,0.36666666666666664,1,0.16666666666666666,9,1.5,19,0.6333333333333333,0.2,0.03333333333333333,0.005532928609851687,2.503028664684268e-05,5,5,10
org.apache.tools.ant.taskdefs.compilers.Sj,4,6,12,0.5,1,0.25,225,56.25,6,0.5,0.0,0.0,0.004046689807737271,1.1409616524452535e-05,1,3,4
org.apache.tools.ant.taskdefs.Filter,3,3,6,0.5,1,0.3333333333333333,206,68.66666666666667,3,0.5,0.0,0.0,0.0,0.0,0,2,2
org.apache.tools.ant.BuildLogger,1,0,0,0,1,1.0,-1,-1.0,0,0,0.0,0.0,0.006339814032121725,0.0,5,0,5
org.apache.tools.ant.taskdefs.Recorder,8,16,56,0.2857142857142857,1,0.125,212,26.5,40,0.7142857142857143,0.0,0.0,0.0,0.0,0,7,7
org.apache.tools.ant.taskdefs.Echo,3,2,6,0.3333333333333333,1,0.3333333333333333,207,69.0,4,0.6666666666666666,0.0,0.0,0.00253592561284869,5.049761004466198e-06,3,2,5
org.apache.tools.ant.taskdefs.ExecuteStreamHandler,1,0,0,0,1,1.0,-1,-1.0,0,0,0.0,0.0,0.1324129959873008,0.0,19,0,19
org.apache.tools.ant.taskdefs.Parallel,7,12,42,0.2857142857142857,1,0.14285714285714285,208,29.714285714285715,30,0.7142857142857143,0.11666666666666667,0.016666666666666666,0.0008453085376162299,1.2801203742242404e-05,1,6,7
org.apache.tools.ant.TaskContainer,2,1,2,0.5,1,0.5,205,102.5,1,0.5,0.0,0.0,0.18826990255561685,2.979796029386033e-07,14,1,15
org.apache.tools.ant.filters.StripLineBreaks,4,4,12,0.3333333333333333,1,0.25,205,51.25,8,0.6666666666666666,0.0,0.0,0.12885770912637243,5.895310665807074e-05,1,3,4
org.apache.tools.ant.types.Environment,3,3,6,0.5,1,0.3333333333333333,207,69.0,3,0.5,0.0,0.0,0.026378075365929617,1.6281295915367426e-06,9,2,11
org.apache.tools.ant.taskdefs.DependSet,9,24,72,0.3333333333333333,1,0.1111111111111111,207,23.0,48,0.6666666666666666,0.0,0.0,0.0,0.0,0,8,8
org.apache.tools.ant.types.selectors.ExtendSelector,9,14,72,0.19444444444444445,1,0.1111111111111111,205,22.77777777777778,58,0.8055555555555556,0.0,0.0,0.16413544379883793,0.0011871130255433997,6,8,14
org.apache.tools.ant.types.selectors.modifiedselector.Algorithm,1,0,0,0,1,1.0,-1,-1.0,0,0,0.0,0.0,0.13393153193398508,0.0,4,0,4
org.apache.tools.ant.taskdefs.Available,13,33,156,0.21153846153846154,1,0.07692307692307693,207,15.923076923076923,123,0.7884615384615384,0.0,0.0,0.0027664643049258434,0.00017244054979468528,1,12,13
org.apache.tools.ant.taskdefs.LogStreamHandler,5,6,20,0.3,1,0.2,205,41.0,14,0.7,0.0,0.0,0.13140418979179366,0.0005957460306003556,21,4,25
org.apache.tools.tar.TarUtils,1,0,0,0,1,1.0,-1,-1.0,0,0,0.0,0.0,0.0031861629494765588,0.0,1,0,1
org.apache.tools.ant.Main,15,35,210,0.16666666666666666,1,0.06666666666666667,214,14.266666666666667,175,0.8333333333333334,0.06593406593406594,0.004395604395604396,0.0008453085376162299,0.00011703446885016585,1,14,15
org.apache.tools.ant.util.regexp.Regexp,1,0,0,0,1,1.0,-1,-1.0,0,0,0.0,0.0,0.1395583729385698,0.0,15,0,15
org.apache.tools.ant.util.facade.FacadeTaskHelper,3,3,6,0.5,1,0.3333333333333333,208,69.33333333333333,3,0.5,0.0,0.0,0.009685230024213076,0.00014946656883400346,3,2,5
org.apache.tools.ant.taskdefs.Mkdir,3,3,6,0.5,1,0.3333333333333333,206,68.66666666666667,3,0.5,0.0,0.0,0.001521555367709214,3.3604040786765504e-06,1,2,3
org.apache.tools.ant.util.TeeOutputStream,1,0,0,0,1,1.0,-1,-1.0,0,0,0.0,0.0,0.014772382210769066,0.0,4,0,4
org.apache.tools.ant.util.FileNameMapper,1,0,0,0,1,1.0,-1,-1.0,0,0,0.0,0.0,0.14262052871520328,0.0,25,0,25
org.apache.tools.ant.taskdefs.condition.Http,5,8,20,0.4,1,0.2,206,41.2,12,0.6,0.0,0.0,0.0027664643049258434,4.9989187184479205e-05,1,4,5
org.apache.tools.ant.taskdefs.Patch,8,23,56,0.4107142857142857,1,0.125,206,25.75,33,0.5892857142857143,0.0,0.0,0.0,0.0,0,7,7
org.apache.tools.ant.taskdefs.FixCRLF,9,17,72,0.2361111111111111,1,0.1111111111111111,211,23.444444444444443,55,0.7638888888888888,0.21428571428571427,0.023809523809523808,0.0016906170752324597,0.00030036343976211214,2,8,10
org.apache.tools.ant.taskdefs.StreamPumper,1,0,0,0,1,1.0,-1,-1.0,0,0,0.0,0.0,0.11072144376093855,0.0,3,0,3
org.apache.tools.ant.types.RegularExpression,8,18,56,0.32142857142857145,1,0.125,205,25.625,38,0.6785714285714286,0.0,0.0,0.137293021384997,0.0015382283197589721,6,8,14
org.apache.tools.ant.taskdefs.Javadoc,33,106,1056,0.10037878787878787,1,0.030303030303030304,217,6.575757575757576,950,0.8996212121212122,0.0522513440860215,0.0015833740632127727,0.0016906170752324597,0.00015432247540241072,2,32,34
org.apache.tools.ant.taskdefs.Cvs,2,1,2,0.5,1,0.5,209,104.5,1,0.5,0.0,0.0,0.0,0.0,0,1,1
org.apache.tools.zip.ZipExtraField,2,1,2,0.5,1,0.5,0,0.0,1,0.5,0.0,0.0,0.008284023668639054,0.0,6,1,7
org.apache.tools.ant.types.selectors.modifiedselector.EqualComparator,1,0,0,0,1,1.0,-1,-1.0,0,0,0.0,0.0,0.13342818377115293,0.0,2,0,2
org.apache.tools.ant.util.facade.ImplementationSpecificArgument,2,1,2,0.5,1,0.5,206,103.0,1,0.5,0.0,0.0,0.011887151310228234,0.000596038667104657,6,1,7
org.apache.tools.ant.types.selectors.NoneSelector,2,2,2,1.0,1,0.5,205,102.5,0,0.0,0.0,0.0,0.16404341383315313,0.00026474891761888564,6,1,7
org.apache.tools.ant.taskdefs.Rename,3,3,6,0.5,1,0.3333333333333333,206,68.66666666666667,3,0.5,0.0,0.0,0.0,0.0,0,2,2
org.apache.tools.ant.input.DefaultInputHandler,5,6,20,0.3,1,0.2,3,0.6,14,0.7,0.0,0.0,0.23396501629756208,0.0014870374105048058,3,4,7
org.apache.tools.ant.taskdefs.condition.FilesMatch,3,3,6,0.5,1,0.3333333333333333,206,68.66666666666667,3,0.5,0.0,0.0,0.003451676528599606,9.408285304015693e-05,2,2,4
org.apache.tools.ant.loader.AntClassLoader2,7,17,42,0.40476190476190477,1,0.14285714285714285,211,30.142857142857142,25,0.5952380952380952,0.0,0.0,0.0,0.0,0,6,6
org.apache.tools.ant.util.UnPackageNameMapper,2,1,2,0.5,1,0.5,1,0.5,1,0.5,0.0,0.0,0.0008453085376162299,0.0,1,1,2
org.apache.tools.ant.taskdefs.XSLTLoggerAware,2,1,2,0.5,1,0.5,0,0.0,1,0.5,0.0,0.0,0.0022541561003099463,0.0,2,1,3
org.apache.tools.zip.AsiExtraField,5,5,20,0.25,1,0.2,3,0.6,15,0.75,0.0,0.0,0.005353620738236122,1.2157567799895017e-05,4,4,8
org.apache.tools.ant.types.Substitution,4,8,12,0.6666666666666666,1,0.25,205,51.25,4,0.3333333333333333,0.0,0.0,0.10976230672347725,0.00014819518919479872,4,4,8
org.apache.tools.ant.taskdefs.Checksum,6,12,30,0.4,1,0.16666666666666666,207,34.5,18,0.6,0.0,0.0,0.0027664643049258434,0.0001494865907147132,1,5,6
org.apache.tools.ant.types.selectors.modifiedselector.DigestAlgorithm,3,2,6,0.3333333333333333,1,0.3333333333333333,205,68.33333333333333,4,0.6666666666666666,0.0,0.0,0.13335069670530017,5.36363285289486e-07,2,2,4
org.apache.tools.ant.util.JAXPUtils,3,3,6,0.5,1,0.3333333333333333,205,68.33333333333333,3,0.5,0.0,0.0,0.14866434378629503,0.00023031184059242295,8,2,10
org.apache.tools.tar.TarEntry,3,3,6,0.5,1,0.3333333333333333,1,0.3333333333333333,3,0.5,0.0,0.0,0.00507185122569738,6.793934947000156e-06,7,3,10
org.apache.tools.ant.MagicNames,1,0,0,0,1,1.0,-1,-1.0,0,0,0.0,0.0,0.0016906170752324597,0.0,2,0,2
org.apache.tools.ant.taskdefs.cvslib.ChangeLogTask,15,36,210,0.17142857142857143,1,0.06666666666666667,213,14.2,174,0.8285714285714286,0.0,0.0,0.0,0.0,0,14,14
org.apache.tools.ant.taskdefs.rmic.WLRmic,9,26,72,0.3611111111111111,1,0.1111111111111111,219,24.333333333333332,46,0.6388888888888888,0.0,0.0,0.002352162887279944,3.984823698105341e-05,1,8,9
org.apache.tools.bzip2.CBZip2OutputStream,4,3,12,0.25,1,0.25,2,0.5,9,0.75,0.0,0.0,0.0019019442096365174,6.436359423473832e-06,2,3,5
org.apache.tools.ant.taskdefs.Execute,21,57,420,0.1357142857142857,1,0.047619047619047616,205,9.761904761904763,363,0.8642857142857143,0.039473684210526314,0.0018796992481203006,0.15857530003871467,0.013528922812333942,48,20,68
org.apache.tools.ant.util.DateUtils,1,0,0,0,1,1.0,-1,-1.0,0,0,0.0,0.0,0.015069450966886862,0.0,8,0,8
org.apache.tools.ant.filters.LineContains,5,5,20,0.25,1,0.2,205,41.0,15,0.75,0.0,0.0,0.12885770912637243,0.0006496678715235671,1,4,5
org.apache.tools.ant.Target,8,20,56,0.35714285714285715,1,0.125,205,25.625,36,0.6428571428571429,0.17857142857142855,0.02232142857142857,0.2516743471582181,0.0016765119930413452,31,7,38
org.apache.tools.ant.types.FilterChain,26,55,650,0.08461538461538462,1,0.038461538461538464,205,7.884615384615385,595,0.9153846153846154,0.0,0.0,0.15755058081390877,0.01767939302902424,5,25,30
org.apache.tools.ant.util.IdentityMapper,2,1,2,0.5,1,0.5,0,0.0,1,0.5,0.0,0.0,0.13440657558615676,0.0,6,1,7
org.apache.tools.ant.types.selectors.DateSelector,5,5,20,0.25,1,0.2,205,41.0,15,0.75,0.0,0.0,0.16431981385646088,0.0007080300656139745,6,4,10
org.apache.tools.ant.taskdefs.ExecuteJava,11,27,110,0.24545454545454545,1,0.09090909090909091,216,19.636363636363637,83,0.7545454545454545,0.0,0.0,0.013730048232310676,0.00015169318594319988,2,10,12
org.apache.tools.ant.types.FlexInteger,1,0,0,0,1,1.0,-1,-1.0,0,0,0.0,0.0,0.0008453085376162299,0.0,1,0,1
org.apache.tools.ant.taskdefs.Sleep,4,8,12,0.6666666666666666,1,0.25,206,51.5,4,0.3333333333333333,0.0,0.0,0.0,0.0,0,3,3
org.apache.tools.ant.Task,8,26,56,0.4642857142857143,1,0.125,205,25.625,30,0.5357142857142857,0.13095238095238093,0.016369047619047616,0.28501843991371517,0.013640692276796394,180,7,187
org.apache.tools.ant.taskdefs.cvslib.RedirectingStreamHandler,4,4,12,0.3333333333333333,1,0.25,210,52.5,8,0.6666666666666666,0.0,0.0,0.0008453085376162299,1.78787761763162e-06,1,3,4
org.apache.tools.ant.filters.ConcatFilter,4,4,12,0.3333333333333333,1,0.25,206,51.5,8,0.6666666666666666,0.0,0.0,0.0,0.0,0,3,3
org.apache.tools.ant.taskdefs.compilers.Kjc,7,21,42,0.5,1,0.14285714285714285,225,32.142857142857146,21,0.5,0.0,0.0,0.004134661325296777,1.8383059623464718e-05,1,6,7
org.apache.tools.ant.listener.AnsiColorLogger,2,1,2,0.5,1,0.5,209,104.5,1,0.5,0.0,0.0,0.0,0.0,0,1,1
org.apache.tools.ant.util.StringUtils,1,0,0,0,1,1.0,-1,-1.0,0,0,0.0,0.0,0.24662727566702788,0.0,24,0,24
org.apache.tools.ant.taskdefs.XmlProperty,3,3,6,0.5,1,0.3333333333333333,206,68.66666666666667,3,0.5,0.0,0.0,0.0008453085376162299,7.389894152877362e-07,1,2,3
org.apache.tools.ant.types.selectors.ContainsSelector,4,5,12,0.4166666666666667,1,0.25,205,51.25,7,0.5833333333333334,0.0,0.0,0.16431981385646088,0.00010266614320786039,6,3,9
org.apache.tools.ant.util.ResourceUtils,7,10,42,0.23809523809523808,1,0.14285714285714285,206,29.428571428571427,32,0.7619047619047619,0.0,0.0,0.014657232605950555,3.657827331615473e-05,3,6,9
org.apache.tools.ant.filters.PrefixLines,4,4,12,0.3333333333333333,1,0.25,205,51.25,8,0.6666666666666666,0.0,0.0,0.12885770912637243,5.895310665807074e-05,1,3,4
org.apache.tools.ant.taskdefs.compilers.Javac13,3,4,6,0.6666666666666666,1,0.3333333333333333,225,75.0,2,0.3333333333333333,0.0,0.0,0.004226542688081149,1.1347270022914611e-05,2,2,4
org.apache.tools.ant.filters.HeadFilter,5,5,20,0.25,1,0.2,205,41.0,15,0.75,0.0,0.0,0.12885770912637243,5.951330831159527e-05,1,4,5
org.apache.tools.ant.taskdefs.compilers.DefaultCompilerAdapter,13,39,156,0.25,1,0.07692307692307693,225,17.307692307692307,117,0.75,0.0,0.0,0.0076077768385460695,0.0006791533356660355,9,12,21
org.apache.tools.ant.NoBannerLogger,5,8,20,0.4,1,0.2,209,41.8,12,0.6,0.0,0.0,0.0,0.0,0,4,4
org.apache.tools.ant.taskdefs.condition.IsFalse,4,3,12,0.25,1,0.25,206,51.5,9,0.75,0.0,0.0,0.0027664643049258434,8.379547622031029e-07,1,3,4
org.apache.tools.ant.filters.BaseParamFilterReader,4,4,12,0.3333333333333333,1,0.25,205,51.25,8,0.6666666666666666,0.0,0.0,0.11023791581440413,0.001347916693484831,11,3,14
org.apache.tools.ant.types.selectors.MajoritySelector,2,2,2,1.0,1,0.5,205,102.5,0,0.0,0.0,0.0,0.1639514870111676,0.00011814295297309685,5,1,6
org.apache.tools.ant.taskdefs.Sync,5,9,20,0.45,1,0.2,211,42.2,11,0.55,0.08333333333333333,0.016666666666666666,0.0008453085376162299,2.1442147843665108e-05,1,4,5
org.apache.tools.ant.types.selectors.modifiedselector.ModifiedSelector,14,22,182,0.12087912087912088,1,0.07142857142857142,205,14.642857142857142,160,0.8791208791208791,0.0,0.0,0.16418149751483085,0.004979069633227226,6,13,19
org.apache.tools.ant.util.regexp.RegexpFactory,5,7,20,0.35,1,0.2,205,41.0,13,0.65,0.0,0.0,0.11498189372034923,0.0005392715662141667,1,4,5
org.apache.tools.zip.ZipShort,1,0,0,0,1,1.0,-1,-1.0,0,0,0.0,0.0,0.01117920540997464,0.0,11,0,11
org.apache.tools.ant.taskdefs.condition.Condition,1,0,0,0,1,1.0,-1,-1.0,0,0,0.0,0.0,0.17402202670857025,0.0,20,0,20
org.apache.tools.ant.taskdefs.cvslib.RedirectingOutputStream,3,2,6,0.3333333333333333,1,0.3333333333333333,209,69.66666666666667,4,0.6666666666666666,0.0,0.0,0.0011270780501549732,0.00014624838912226653,1,2,3
org.apache.tools.ant.taskdefs.Pack,3,3,6,0.5,1,0.3333333333333333,206,68.66666666666667,3,0.5,0.0,0.0,0.0016906170752324597,0.0002960725334797963,2,2,4
org.apache.tools.ant.types.Mapper,10,29,90,0.32222222222222224,1,0.1,205,20.5,61,0.6777777777777778,0.0,0.0,0.1375835544657553,0.0012275016991259357,12,10,22
org.apache.tools.ant.types.selectors.BaseExtendSelector,4,3,12,0.25,1,0.25,205,51.25,9,0.75,0.0,0.0,0.13526187173898688,0.000675698547623577,8,3,11
org.apache.tools.ant.taskdefs.Ear,8,21,56,0.375,1,0.125,234,29.25,35,0.625,0.0,0.0,0.0,0.0,0,7,7
org.apache.tools.ant.taskdefs.Taskdef,3,2,6,0.3333333333333333,1,0.3333333333333333,206,68.66666666666667,4,0.6666666666666666,0.0,0.0,0.0,0.0,0,2,2
org.apache.tools.ant.filters.TabsToSpaces,4,4,12,0.3333333333333333,1,0.25,205,51.25,8,0.6666666666666666,0.0,0.0,0.12885770912637243,5.895310665807074e-05,1,3,4
org.apache.tools.ant.listener.MailLogger,11,26,110,0.23636363636363636,1,0.09090909090909091,216,19.636363636363637,84,0.7636363636363637,0.0,0.0,0.0,0.0,0,10,10
org.apache.tools.ant.taskdefs.Concat,14,33,182,0.1813186813186813,1,0.07142857142857142,209,14.928571428571429,149,0.8186813186813187,0.14423076923076922,0.010302197802197802,0.0016906170752324597,0.00023429540219856504,2,13,15
org.apache.tools.ant.BuildEvent,5,15,20,0.75,1,0.2,205,41.0,5,0.25,0.0,0.0,0.238541727330965,0.0006854910887119693,25,4,29
org.apache.tools.ant.taskdefs.Jar,13,31,156,0.1987179487179487,1,0.07692307692307693,233,17.923076923076923,125,0.8012820512820513,0.0,0.0,0.0016906170752324597,2.6317558531537446e-05,2,12,14
org.apache.tools.ant.taskdefs.Delete,24,74,552,0.13405797101449277,1,0.041666666666666664,207,8.625,478,0.8659420289855072,0.0,0.0,0.0029585798816568047,0.00010642189915294583,1,23,24
org.apache.tools.ant.taskdefs.compilers.JavacExternal,4,6,12,0.5,1,0.25,225,56.25,6,0.5,0.0,0.0,0.004134661325296777,1.693217183224798e-05,2,3,5
org.apache.tools.ant.taskdefs.WhichResource,4,5,12,0.4166666666666667,1,0.25,206,51.5,7,0.5833333333333334,0.0,0.0,0.0,0.0,0,3,3
org.apache.tools.ant.taskdefs.email.PlainMailer,5,6,20,0.3,1,0.2,214,42.8,14,0.7,0.0,0.0,0.002641589180050719,0.0001651998918691617,2,4,6
org.apache.tools.ant.BuildException,2,1,2,0.5,1,0.5,205,102.5,1,0.5,0.0,0.0,0.371755309493556,0.007286893486019548,263,1,264
org.apache.tools.ant.taskdefs.CVSPass,3,2,6,0.3333333333333333,1,0.3333333333333333,206,68.66666666666667,4,0.6666666666666666,0.0,0.0,0.0,0.0,0,2,2
org.apache.tools.ant.ProjectComponent,2,3,2,1.5,1,0.5,205,102.5,-1,-0.5,0.0,0.0,0.2851573377889167,0.003655921431107603,80,1,81
org.apache.tools.ant.taskdefs.GZip,2,1,2,0.5,1,0.5,207,103.5,1,0.5,0.0,0.0,0.0,0.0,0,1,1
org.apache.tools.ant.taskdefs.condition.ConditionBase,21,45,420,0.10714285714285714,1,0.047619047619047616,227,10.80952380952381,375,0.8928571428571429,0.14210526315789473,0.006766917293233083,0.00422654268808115,0.0006842056975933253,5,20,25
org.apache.tools.ant.filters.ReplaceTokens,5,5,20,0.25,1,0.2,205,41.0,15,0.75,0.0,0.0,0.12885770912637243,0.0006539587778058831,1,4,5
org.apache.tools.ant.util.RegexpPatternMapper,4,4,12,0.3333333333333333,1,0.25,206,51.5,8,0.6666666666666666,0.0,0.0,0.0,0.0,0,3,3
org.apache.tools.ant.taskdefs.condition.Equals,2,1,2,0.5,1,0.5,0,0.0,1,0.5,0.0,0.0,0.003451676528599606,7.15151047052648e-07,2,1,3
org.apache.tools.ant.taskdefs.LogOutputStream,2,1,2,0.5,1,0.5,205,102.5,1,0.5,0.0,0.0,0.11366411366411368,0.0003008359502753434,15,1,16
org.apache.tools.ant.taskdefs.WaitFor,4,4,12,0.3333333333333333,1,0.25,229,57.25,8,0.6666666666666666,0.0,0.0,0.0,0.0,0,3,3
org.apache.tools.ant.taskdefs.DefBase,10,33,90,0.36666666666666664,1,0.1,205,20.5,57,0.6333333333333333,0.0,0.0,0.17678031937850672,0.0013588533352842903,3,9,12
org.apache.tools.zip.ZipLong,1,0,0,0,1,1.0,-1,-1.0,0,0,0.0,0.0,0.008472296933835395,0.0,4,0,4
org.apache.tools.ant.taskdefs.rmic.RmicAdapter,4,7,12,0.5833333333333334,1,0.25,219,54.75,5,0.4166666666666667,0.0,0.0,0.004161518954418362,3.9624553625780824e-05,3,3,6
org.apache.tools.ant.filters.ChainableReader,1,0,0,0,1,1.0,-1,-1.0,0,0,0.0,0.0,0.16143861207858168,0.0,20,0,20
org.apache.tools.ant.taskdefs.condition.Socket,5,8,20,0.4,1,0.2,206,41.2,12,0.6,0.0,0.0,0.0027664643049258434,4.9989187184479205e-05,1,4,5
org.apache.tools.ant.taskdefs.email.Mailer,5,4,20,0.2,1,0.2,209,41.8,16,0.8,0.0,0.0,0.004508312200619893,3.704085117595465e-05,4,4,8
org.apache.tools.ant.taskdefs.UpToDate,12,29,132,0.2196969696969697,1,0.08333333333333333,209,17.416666666666668,103,0.7803030303030303,0.0,0.0,0.0027664643049258434,0.00017405855546360238,1,11,12
org.apache.tools.ant.util.JavaEnvUtils,3,5,6,0.8333333333333334,1,0.3333333333333333,205,68.33333333333333,1,0.16666666666666666,0.0,0.0,0.26429216673119116,0.0017775738032354347,40,2,42
org.apache.tools.ant.util.KeepAliveInputStream,1,0,0,0,1,1.0,-1,-1.0,0,0,0.0,0.0,0.1759830665040989,0.0,1,0,1
org.apache.tools.ant.types.selectors.MappingSelector,6,9,30,0.3,1,0.16666666666666666,205,34.166666666666664,21,0.7,0.0,0.0,0.13344192865287507,0.00021383016306874178,3,5,8
org.apache.tools.ant.Project,24,80,552,0.14492753623188406,1,0.041666666666666664,205,8.541666666666666,472,0.855072463768116,0.6111660079051383,0.025465250329380764,0.34892239543402337,0.07720311210840501,284,24,308
org.apache.tools.ant.taskdefs.RecorderEntry,8,25,56,0.44642857142857145,1,0.125,209,26.125,31,0.5535714285714286,0.0,0.0,0.0008453085376162299,3.599593603498328e-06,1,7,8
org.apache.tools.ant.taskdefs.Javac,17,39,272,0.14338235294117646,1,0.058823529411764705,225,13.235294117647058,233,0.8566176470588235,0.11666666666666667,0.006862745098039216,0.00864520095289326,0.0006855852310280741,9,16,25
org.apache.tools.ant.taskdefs.ImportTask,8,26,56,0.4642857142857143,1,0.125,206,25.75,30,0.5357142857142857,0.0,0.0,0.0,0.0,0,7,7
org.apache.tools.ant.taskdefs.Tar,11,16,110,0.14545454545454545,1,0.09090909090909091,223,20.272727272727273,94,0.8545454545454545,0.0,0.0,0.0,0.0,0,10,10
org.apache.tools.ant.taskdefs.cvslib.CvsTagEntry,1,0,0,0,1,1.0,-1,-1.0,0,0,0.0,0.0,0.0008453085376162299,0.0,1,0,1
org.apache.tools.ant.taskdefs.Redirector,10,16,90,0.17777777777777778,1,0.1,208,20.8,74,0.8222222222222222,0.0,0.0,0.016746386821433725,0.00015524822450130644,2,9,11
org.apache.tools.ant.taskdefs.TempFile,4,5,12,0.4166666666666667,1,0.25,206,51.5,7,0.5833333333333334,0.0,0.0,0.0,0.0,0,3,3
org.apache.tools.ant.types.selectors.BaseSelector,4,4,12,0.3333333333333333,1,0.25,205,51.25,8,0.6666666666666666,0.0,0.0,0.1365560926821137,0.000838747878129816,15,3,18
org.apache.tools.ant.types.selectors.AndSelector,2,2,2,1.0,1,0.5,205,102.5,0,0.0,0.0,0.0,0.1639514870111676,0.00011814295297309685,5,1,6
org.apache.tools.ant.DemuxInputStream,2,2,2,1.0,1,0.5,206,103.0,0,0.0,0.0,0.0,0.0011270780501549732,0.0,1,1,2
org.apache.tools.ant.types.PatternSet,7,17,42,0.40476190476190477,1,0.14285714285714285,205,29.285714285714285,25,0.5952380952380952,0.0,0.0,0.16381378979363304,0.00013801726490919112,11,7,18
org.apache.tools.ant.taskdefs.compilers.CompilerAdapterFactory,12,11,132,0.08333333333333333,1,0.08333333333333333,225,18.75,121,0.9166666666666666,0.0,0.0,0.005593953557754463,0.0001107416187288884,2,11,13
org.apache.tools.ant.taskdefs.JDBCTask,8,24,56,0.42857142857142855,1,0.125,206,25.75,32,0.5714285714285714,0.0,0.0,0.0019019442096365174,8.933087947981684e-05,2,7,9
org.apache.tools.ant.util.SourceFileScanner,7,11,42,0.2619047619047619,1,0.14285714285714285,207,29.571428571428573,31,0.7380952380952381,0.0,0.0,0.017954678457637038,0.0001844795306918638,7,6,13
org.apache.tools.ant.types.EnumeratedAttribute,1,0,0,0,1,1.0,-1,-1.0,0,0,0.0,0.0,0.19299327755348064,0.0,95,0,95
org.apache.tools.bzip2.BZip2Constants,1,0,0,0,1,1.0,-1,-1.0,0,0,0.0,0.0,0.0033812341504649195,0.0,2,0,2
org.apache.tools.ant.types.DataType,6,12,30,0.4,1,0.16666666666666666,205,34.166666666666664,18,0.6,0.0,0.0,0.2110143732934934,0.002533405544637371,18,5,23
org.apache.tools.ant.taskdefs.PreSetDef,9,29,72,0.4027777777777778,1,0.1111111111111111,205,22.77777777777778,43,0.5972222222222222,0.059523809523809514,0.0066137566137566125,0.18394934207571745,4.954236265193957e-05,2,8,10
org.apache.tools.ant.util.ClasspathUtils,6,15,30,0.5,1,0.16666666666666666,205,34.166666666666664,15,0.5,0.025,0.004166666666666667,0.14147554573086488,1.3111102529298547e-06,2,5,7
org.apache.tools.ant.taskdefs.cvslib.ChangeLogParser,2,1,2,0.5,1,0.5,1,0.5,1,0.5,0.0,0.0,0.00253592561284869,2.860604188210592e-06,3,1,4
org.apache.tools.ant.util.regexp.RegexpUtil,1,0,0,0,1,1.0,-1,-1.0,0,0,0.0,0.0,0.006762468300929839,0.0,6,0,6
org.apache.tools.ant.types.resolver.ApacheCatalogResolver,5,7,20,0.35,1,0.2,212,42.4,13,0.65,0.25,0.05,0.0008453085376162299,0.0001516120219751614,1,4,5
org.apache.tools.ant.filters.BaseFilterReader,3,5,6,0.8333333333333334,1,0.3333333333333333,205,68.33333333333333,1,0.16666666666666666,0.0,0.0,0.15891984170093895,0.0017829809363447422,5,2,7
org.apache.tools.zip.ZipOutputStream,4,5,12,0.4166666666666667,1,0.25,7,1.75,7,0.5833333333333334,0.0,0.0,0.005952380952380952,1.5018171988105606e-05,6,3,9
org.apache.tools.ant.taskdefs.Rmic,17,45,272,0.16544117647058823,1,0.058823529411764705,219,12.882352941176471,227,0.8345588235294118,0.08125,0.004779411764705883,0.00491815876431261,0.0003733033222952868,5,16,21
org.apache.tools.ant.taskdefs.TaskOutputStream,2,1,2,0.5,1,0.5,206,103.0,1,0.5,0.0,0.0,0.0,0.0,0,1,1
org.apache.tools.ant.taskdefs.AbstractCvsTask,13,34,156,0.21794871794871795,1,0.07692307692307693,208,16.0,122,0.782051282051282,0.0,0.0,0.0016906170752324597,0.00025046178892332744,2,12,14
org.apache.tools.ant.util.Tokenizer,1,0,0,0,1,1.0,-1,-1.0,0,0,0.0,0.0,0.15865574678333466,0.0,4,0,4
org.apache.tools.ant.AntTypeDefinition,5,10,20,0.5,1,0.2,205,41.0,10,0.5,0.0,0.0,0.17736976572987487,8.942215580716212e-05,9,5,14
org.apache.tools.ant.taskdefs.Replace,7,11,42,0.2619047619047619,1,0.14285714285714285,209,29.857142857142858,31,0.7380952380952381,0.13333333333333333,0.019047619047619046,0.0008453085376162299,0.00014875141778695079,1,6,7
org.apache.tools.ant.util.DOMElementWriter,2,1,2,0.5,1,0.5,207,103.5,1,0.5,0.0,0.0,0.005177514792899408,0.00015407929308749302,6,1,7
org.apache.tools.ant.util.regexp.RegexpMatcherFactory,3,3,6,0.5,1,0.3333333333333333,205,68.33333333333333,3,0.5,0.0,0.0,0.10343695547867371,0.0005842784054420135,5,2,7
org.apache.tools.ant.taskdefs.Input,8,16,56,0.2857142857142857,1,0.125,206,25.75,40,0.7142857142857143,0.0,0.0,0.0,0.0,0,7,7
org.apache.tools.ant.types.selectors.ContainsRegexpSelector,7,11,42,0.2619047619047619,1,0.14285714285714285,205,29.285714285714285,31,0.7380952380952381,0.0,0.0,0.16408941591218654,0.0024403744481186276,5,6,11
org.apache.tools.ant.taskdefs.condition.Os,2,1,2,0.5,1,0.5,0,0.0,1,0.5,0.0,0.0,0.22458343208181605,0.0005821329523008554,28,1,29
org.apache.tools.ant.types.AntFilterReader,7,16,42,0.38095238095238093,1,0.14285714285714285,205,29.285714285714285,26,0.6190476190476191,0.0,0.0,0.15729646697388636,8.817450446655173e-05,2,6,8
org.apache.tools.ant.taskdefs.rmic.KaffeRmic,6,14,30,0.4666666666666667,1,0.16666666666666666,219,36.5,16,0.5333333333333333,0.0,0.0,0.002459079382156305,1.7059329688325062e-05,1,5,6
org.apache.tools.ant.helper.AntXMLContext,5,10,20,0.5,1,0.2,205,41.0,10,0.5,0.0,0.0,0.12891448714317189,0.0002836408164025634,7,4,11
org.apache.tools.zip.UnixStat,1,0,0,0,1,1.0,-1,-1.0,0,0,0.0,0.0,0.006934395461122971,0.0,5,0,5
org.apache.tools.ant.ComponentHelper,15,52,210,0.24761904761904763,1,0.06666666666666667,205,13.666666666666666,158,0.7523809523809524,0.40750915750915756,0.02716727716727717,0.2354699626329405,0.020141238979683663,10,15,25
org.apache.tools.ant.taskdefs.SendEmail,2,1,2,0.5,1,0.5,217,108.5,1,0.5,0.0,0.0,0.0,0.0,0,1,1
org.apache.tools.ant.taskdefs.PathConvert,14,40,182,0.21978021978021978,1,0.07142857142857142,208,14.857142857142858,142,0.7802197802197802,0.07051282051282051,0.005036630036630037,0.0008453085376162299,0.00013249282863792282,1,13,14
org.apache.tools.ant.util.LazyFileOutputStream,1,0,0,0,1,1.0,-1,-1.0,0,0,0.0,0.0,0.013195152553552001,0.0,2,0,2
org.apache.tools.ant.AntClassLoader,8,19,56,0.3392857142857143,1,0.125,205,25.625,37,0.6607142857142857,0.3333333333333333,0.041666666666666664,0.24606512074972967,0.0016737666964029615,24,7,31
org.apache.tools.ant.DynamicConfigurator,1,0,0,0,1,1.0,-1,-1.0,0,0,0.0,0.0,0.1475598228573555,0.0,6,0,6
org.apache.tools.ant.util.WeakishReference,4,5,12,0.4166666666666667,1,0.25,207,51.75,7,0.5833333333333334,0.3333333333333333,0.08333333333333333,0.00253592561284869,0.0002996482887150595,4,4,8
org.apache.tools.ant.types.selectors.SelectorUtils,2,2,2,1.0,1,0.5,0,0.0,0,0.0,0.0,0.0,0.16701318219191008,1.2097971879307297e-05,8,2,10
org.apache.tools.ant.types.selectors.SizeSelector,5,5,20,0.25,1,0.2,205,41.0,15,0.75,0.0,0.0,0.16431981385646088,0.0012817089982143412,6,4,10
org.apache.tools.ant.RuntimeConfigurable,7,13,42,0.30952380952380953,1,0.14285714285714285,205,29.285714285714285,29,0.6904761904761905,0.0,0.0,0.20654530785134387,0.0011807443745143246,12,7,19
org.apache.tools.ant.taskdefs.DefaultExcludes,5,9,20,0.45,1,0.2,206,41.2,11,0.55,0.0,0.0,0.0,0.0,0,4,4
org.apache.tools.ant.taskdefs.AntStructure,4,4,12,0.3333333333333333,1,0.25,206,51.5,8,0.6666666666666666,0.0,0.0,0.0,0.0,0,3,3
org.apache.tools.ant.util.LoaderUtils,2,2,2,1.0,1,0.5,205,102.5,0,0.0,0.0,0.0,0.19122315592903827,0.000272185689498279,7,1,8
