name,Size,Ties,Pairs,Density,WeakComp,nWeakComp,2StepReach,ReachEffic,Broker,nBroker,EgoBetween,nEgoBetween,Closeness_Centrality,Betweenness_Centrality,in_degree,out_degree,degree
org.apache.lucene.search.FuzzyQuery,14,47,182,0.25824175824175827,1,0.07142857142857142,132,9.428571428571429,135,0.7417582417582418,0.05769230769230769,0.004120879120879121,0.0224950084548967,0.0007522061473812327,7,13,20
org.apache.lucene.index.MultiLevelSkipListReader,4,5,12,0.4166666666666667,1,0.25,2,0.5,7,0.5833333333333334,0.0,0.0,0.004510274886575928,9.516159936496206e-06,2,3,5
org.apache.lucene.store.RAMDirectory,11,24,110,0.21818181818181817,1,0.09090909090909091,123,11.181818181818182,86,0.7818181818181819,0.23333333333333334,0.021212121212121213,0.11410900056599224,0.004233665863161767,111,10,121
org.apache.lucene.search.spans.SpanQuery,6,12,30,0.4,1,0.16666666666666666,127,21.166666666666668,18,0.6,0.05,0.008333333333333333,0.025383829075839286,0.0007161863963368516,19,5,24
org.apache.lucene.index.TermPositions,1,0,0,0,1,1.0,-1,-1.0,0,0,0.0,0.0,0.11598410202265398,0.0,20,0,20
org.apache.lucene.search.function.DocValues,2,2,2,1.0,1,0.5,0,0.0,0,0.0,0.0,0.0,0.007629633118259314,5.2926956950175525e-06,8,1,9
org.apache.lucene.analysis.standard.CharStream,1,0,0,0,1,1.0,-1,-1.0,0,0,0.0,0.0,0.036626811822902304,0.0,3,0,3
org.apache.lucene.analysis.standard.FastCharStream,2,1,2,0.5,1,0.5,0,0.0,1,0.5,0.0,0.0,0.03600718412567892,0.0,1,1,2
org.apache.lucene.search.FieldCacheImpl,10,13,90,0.14444444444444443,1,0.1,133,13.3,77,0.8555555555555555,0.0,0.0,0.0,0.0,0,9,9
org.apache.lucene.document.LoadFirstFieldSelector,2,1,2,0.5,1,0.5,0,0.0,1,0.5,0.0,0.0,0.0008006405124099279,3.2076943606166987e-07,1,1,2
org.apache.lucene.index.SegmentInfo,5,9,20,0.45,1,0.2,7,1.4,11,0.55,0.25,0.05,0.12242840686050949,0.00020087486244794203,15,5,20
org.apache.lucene.store.BufferedIndexInput,2,1,2,0.5,1,0.5,0,0.0,1,0.5,0.0,0.0,0.09923067507612973,2.726540206524194e-06,12,1,13
org.apache.lucene.index.TermInfosWriter,7,11,42,0.2619047619047619,1,0.14285714285714285,22,3.142857142857143,31,0.7380952380952381,0.0,0.0,0.08647782312258448,0.0001952630480452738,3,6,9
org.apache.lucene.index.DefaultSkipListReader,3,3,6,0.5,1,0.3333333333333333,3,1.0,3,0.5,0.0,0.0,0.003975594268518262,0.0,1,2,3
org.apache.lucene.search.MultiSearcher,15,49,210,0.23333333333333334,1,0.06666666666666667,128,8.533333333333333,161,0.7666666666666667,0.0,0.0,0.0024019215372297837,2.337798199487551e-05,3,14,17
org.apache.lucene.search.Searchable,9,15,72,0.20833333333333334,1,0.1111111111111111,123,13.666666666666666,57,0.7916666666666666,0.0,0.0,0.10494141333059043,0.00011011403750595103,10,8,18
org.apache.lucene.search.MultiPhraseQuery,12,44,132,0.3333333333333333,1,0.08333333333333333,136,11.333333333333334,88,0.6666666666666666,0.03787878787878788,0.0031565656565656565,0.022948599144435682,0.001185964502753285,8,11,19
org.apache.lucene.store.IndexOutput,1,0,0,0,1,1.0,-1,-1.0,0,0,0.0,0.0,0.15339434525487594,0.0,32,0,32
org.apache.lucene.analysis.WordlistLoader,2,1,2,0.5,1,0.5,13,6.5,1,0.5,0.0,0.0,0.04464649248965533,8.981544209726756e-06,8,1,9
org.apache.lucene.search.spans.TermSpans,3,2,6,0.3333333333333333,1,0.3333333333333333,3,1.0,4,0.6666666666666666,0.0,0.0,0.01540373403016892,1.293214613871139e-05,4,2,6
org.apache.lucene.analysis.LowerCaseFilter,3,4,6,0.6666666666666666,1,0.3333333333333333,1,0.3333333333333333,2,0.3333333333333333,0.0,0.0,0.04373405015846679,1.315843891523336e-05,10,2,12
org.apache.lucene.index.MultiReader,16,52,240,0.21666666666666667,1,0.0625,141,8.8125,188,0.7833333333333333,0.0,0.0,0.0,0.0,0,15,15
org.apache.lucene.search.spans.SpanScorer,6,10,30,0.3333333333333333,1,0.16666666666666666,125,20.833333333333332,20,0.6666666666666666,0.0,0.0,0.014269609667667245,5.982349982550143e-05,2,5,7
org.apache.lucene.search.spans.SpanNearQuery,8,18,56,0.32142857142857145,1,0.125,132,16.5,38,0.6785714285714286,0.17460317460317462,0.021825396825396828,0.015420669869228715,0.00045889590411237147,13,7,20
org.apache.lucene.document.Document,4,7,12,0.5833333333333334,1,0.25,8,2.0,5,0.4166666666666667,0.0,0.0,0.2068531927741417,0.001804983414188838,137,3,140
org.apache.lucene.queryParser.CharStream,1,0,0,0,1,1.0,-1,-1.0,0,0,0.0,0.0,0.04999248129468042,0.0,9,0,9
org.apache.lucene.search.PhrasePositions,3,2,6,0.3333333333333333,1,0.3333333333333333,3,1.0,4,0.6666666666666666,0.0,0.0,0.017772264426413494,4.170002668801708e-06,3,2,5
org.apache.lucene.search.SloppyPhraseScorer,5,8,20,0.4,1,0.2,127,25.4,12,0.6,0.0,0.0,0.019395791289710917,0.00018983135226129623,2,4,6
org.apache.lucene.index.FieldInfos,7,10,42,0.23809523809523808,1,0.14285714285714285,17,2.4285714285714284,32,0.7619047619047619,0.0,0.0,0.08906859787346787,7.541179777045393e-05,20,6,26
org.apache.lucene.document.FieldSelector,2,1,2,0.5,1,0.5,0,0.0,1,0.5,0.0,0.0,0.116798123474547,0.00038203639834944884,13,1,14
org.apache.lucene.index.CompoundFileWriter,6,8,30,0.26666666666666666,1,0.16666666666666666,8,1.3333333333333333,22,0.7333333333333333,0.0,0.0,0.08540550157843994,0.00042702660296735573,2,5,7
org.apache.lucene.search.PrefixFilter,4,8,12,0.6666666666666666,1,0.25,126,31.5,4,0.3333333333333333,0.0,0.0,0.0,0.0,0,3,3
org.apache.lucene.index.TermVectorsWriter,10,14,90,0.15555555555555556,1,0.1,23,2.3,76,0.8444444444444444,0.0,0.0,0.08637120159145958,0.0013431845904073687,5,9,14
org.apache.lucene.search.function.FieldScoreQuery,4,4,12,0.3333333333333333,1,0.25,130,32.5,8,0.6666666666666666,0.0,0.0,0.0016012810248198558,2.245386052431689e-06,2,3,5
org.apache.lucene.index.FieldsReader,17,44,272,0.16176470588235295,1,0.058823529411764705,26,1.5294117647058822,228,0.8382352941176471,0.07152777777777777,0.004207516339869281,0.07373512009914916,0.0008279169592835911,4,16,20
org.apache.lucene.util.PriorityQueue,1,0,0,0,1,1.0,-1,-1.0,0,0,0.0,0.0,0.08641933719886573,0.0,23,0,23
org.apache.lucene.search.Query,8,26,56,0.4642857142857143,1,0.125,123,15.375,30,0.5357142857142857,0.46428571428571425,0.05803571428571428,0.13269979279303593,0.011850169666829719,120,8,128
org.apache.lucene.index.MultipleTermPositions,8,15,56,0.26785714285714285,1,0.125,126,15.75,41,0.7321428571428571,0.0,0.0,0.01773122107565723,0.00024327154030917038,1,7,8
org.apache.lucene.index.MultiTermEnum,7,15,42,0.35714285714285715,1,0.14285714285714285,124,17.714285714285715,27,0.6428571428571429,0.0,0.0,0.0008006405124099279,1.924616616370019e-06,1,6,7
org.apache.lucene.queryParser.QueryParser,33,87,1056,0.08238636363636363,1,0.030303030303030304,178,5.393939393939394,969,0.9176136363636364,0.0,0.0,0.024086066495632656,0.007430718020379485,31,32,63
org.apache.lucene.analysis.SimpleAnalyzer,3,2,6,0.3333333333333333,1,0.3333333333333333,5,1.6666666666666667,4,0.6666666666666666,0.0,0.0,0.03109272843375915,0.00023473474546833225,44,2,46
org.apache.lucene.search.FieldDocSortedHitQueue,5,5,20,0.25,1,0.2,125,25.0,15,0.75,0.0,0.0,0.0028594304014640283,7.858851183510912e-06,3,4,7
org.apache.lucene.search.function.FieldCacheSource,5,9,20,0.45,1,0.2,128,25.6,11,0.55,0.0,0.0,0.0032025620496397116,0.0001616677957750816,5,5,10
org.apache.lucene.search.BooleanQuery,11,38,110,0.34545454545454546,1,0.09090909090909091,123,11.181818181818182,72,0.6545454545454545,0.32222222222222224,0.029292929292929294,0.10885052127723684,0.0026073285966009487,46,10,56
org.apache.lucene.index.TermInfo,2,1,2,0.5,1,0.5,1,0.5,1,0.5,0.0,0.0,0.08705362845363587,0.0003777060109626163,8,1,9
org.apache.lucene.index.Term,1,1,0,0,1,1.0,-1,-1.0,-1,0,0.0,0.0,0.19581316158577966,0.0,113,1,114
org.apache.lucene.search.PrefixGenerator,4,7,12,0.5833333333333334,1,0.25,125,31.25,5,0.4166666666666667,0.0,0.0,0.0008006405124099279,6.415388721233397e-07,1,3,4
org.apache.lucene.search.TermQuery,7,19,42,0.4523809523809524,1,0.14285714285714285,126,18.0,23,0.5476190476190477,0.03333333333333333,0.0047619047619047615,0.04240278450305154,0.0008574035181297697,43,6,49
org.apache.lucene.analysis.CharTokenizer,3,3,6,0.5,1,0.3333333333333333,1,0.3333333333333333,3,0.5,0.0,0.0,0.05156724498541564,0.000100080064051241,4,2,6
org.apache.lucene.index.CorruptIndexException,1,0,0,0,1,1.0,-1,-1.0,0,0,0.0,0.0,0.0872111440660369,0.0,6,0,6
org.apache.lucene.queryParser.MultiFieldQueryParser,5,7,20,0.35,1,0.2,139,27.8,13,0.65,0.0,0.0,0.005382083444533405,0.0001236867504881916,4,4,8
org.apache.lucene.index.SegmentMergeQueue,3,2,6,0.3333333333333333,1,0.3333333333333333,5,1.6666666666666667,4,0.6666666666666666,0.0,0.0,0.08543115658041604,0.00024271553995333016,2,2,4
org.apache.lucene.store.Directory,6,8,30,0.26666666666666666,1,0.16666666666666666,5,0.8333333333333334,22,0.7333333333333333,0.0,0.0,0.1820261204160254,0.000978691486148144,116,6,122
org.apache.lucene.analysis.PorterStemmer,1,0,0,0,1,1.0,-1,-1.0,0,0,0.0,0.0,0.0008006405124099279,0.0,1,0,1
org.apache.lucene.search.Searcher,12,34,132,0.25757575757575757,1,0.08333333333333333,123,10.25,98,0.7424242424242424,0.2863636363636364,0.023863636363636365,0.13357528624218884,0.007259948720600136,100,11,111
org.apache.lucene.search.payloads.BoostingTermQuery,6,11,30,0.36666666666666664,1,0.16666666666666666,132,22.0,19,0.6333333333333333,0.1,0.016666666666666666,0.0018300354569369779,1.4327701477421255e-05,2,5,7
org.apache.lucene.analysis.Analyzer,2,1,2,0.5,1,0.5,1,0.5,1,0.5,0.0,0.0,0.165377508219752,0.0001723425083617132,52,1,53
org.apache.lucene.store.SimpleFSLockFactory,5,7,20,0.35,1,0.2,14,2.8,13,0.65,0.0,0.0,0.10128216533340634,0.00038378102767113977,2,4,6
org.apache.lucene.search.DisjunctionSumScorer,5,7,20,0.35,1,0.2,126,25.2,13,0.65,0.0,0.0,0.001067520683213237,3.207694360616699e-06,1,4,5
org.apache.lucene.index.TermBuffer,4,6,12,0.5,1,0.25,19,4.75,6,0.5,0.0,0.0,0.003566489555280588,0.0,2,4,6
org.apache.lucene.store.BufferedIndexOutput,2,1,2,0.5,1,0.5,0,0.0,1,0.5,0.0,0.0,0.13731245111696294,6.415388721233397e-07,2,1,3
org.apache.lucene.index.TermVectorOffsetInfo,1,0,0,0,1,1.0,-1,-1.0,0,0,0.0,0.0,0.07388660033801185,0.0,5,0,5
org.apache.lucene.search.function.IntFieldSource,5,7,20,0.35,1,0.2,130,26.0,13,0.65,0.0,0.0,0.0,0.0,0,4,4
org.apache.lucene.index.MultiLevelSkipListWriter,3,3,6,0.5,1,0.3333333333333333,123,41.0,3,0.5,0.0,0.0,0.08540125260799179,8.553851628311199e-05,2,2,4
org.apache.lucene.index.IndexDeletionPolicy,1,0,0,0,1,1.0,-1,-1.0,0,0,0.0,0.0,0.12095604904976613,0.0,8,0,8
org.apache.lucene.analysis.LetterTokenizer,2,1,2,0.5,1,0.5,2,1.0,1,0.5,0.0,0.0,0.04387568878632318,0.00020176397528279036,2,1,3
org.apache.lucene.search.MatchAllDocsQuery,5,7,20,0.35,1,0.2,126,25.2,13,0.65,0.125,0.025,0.02174413462035345,0.00032670776192668594,8,4,12
org.apache.lucene.search.BooleanClause,3,5,6,0.8333333333333334,1,0.3333333333333333,123,41.0,1,0.16666666666666666,0.0,0.0,0.1084756055897148,1.4827185313574424e-05,40,2,42
org.apache.lucene.index.IndexCommitPoint,1,0,0,0,1,1.0,-1,-1.0,0,0,0.0,0.0,0.09695262115868868,0.0,6,0,6
org.apache.lucene.util.ToStringUtils,1,0,0,0,1,1.0,-1,-1.0,0,0,0.0,0.0,0.09333781432760255,0.0,18,0,18
org.apache.lucene.search.WildcardQuery,8,22,56,0.39285714285714285,1,0.125,130,16.25,34,0.6071428571428571,0.0,0.0,0.021894644262989694,0.00044337928690015417,7,7,14
org.apache.lucene.index.SegmentTermVector,2,1,2,0.5,1,0.5,0,0.0,1,0.5,0.0,0.0,0.004658272072203217,6.415388721233397e-07,2,1,3
org.apache.lucene.search.function.ValueSource,3,3,6,0.5,1,0.3333333333333333,125,41.666666666666664,3,0.5,0.0,0.0,0.008569818818017378,7.315452484087392e-05,8,2,10
org.apache.lucene.document.DateField,1,0,0,0,1,1.0,-1,-1.0,0,0,0.0,0.0,0.020788466481483595,0.0,2,0,2
org.apache.lucene.search.FieldDoc,2,1,2,0.5,1,0.5,0,0.0,1,0.5,0.0,0.0,0.00678189610511939,1.6038471803083494e-07,3,1,4
org.apache.lucene.queryParser.TokenMgrError,1,0,0,0,1,1.0,-1,-1.0,0,0,0.0,0.0,0.022236657250328567,0.0,2,0,2
org.apache.lucene.index.SegmentMerger,22,64,462,0.13852813852813853,1,0.045454545454545456,123,5.590909090909091,398,0.8614718614718615,0.06309523809523811,0.0028679653679653683,0.10356110975737111,0.005632816364032918,4,21,25
org.apache.lucene.index.MultiTermDocs,5,12,20,0.6,1,0.2,124,24.8,8,0.4,0.0,0.0,0.0016012810248198558,4.276925814155598e-07,2,4,6
org.apache.lucene.document.FieldSelectorResult,1,0,0,0,1,1.0,-1,-1.0,0,0,0.0,0.0,0.09527127553798564,0.0,4,0,4
org.apache.lucene.search.SortComparatorSource,3,3,6,0.5,1,0.3333333333333333,123,41.0,3,0.5,0.0,0.0,0.07528466332162675,0.0006524450329494366,4,2,6
org.apache.lucene.search.ReqOptSumScorer,3,3,6,0.5,1,0.3333333333333333,3,1.0,3,0.5,0.0,0.0,0.001067520683213237,0.0,1,2,3
org.apache.lucene.search.DisjunctionMaxScorer,4,5,12,0.4166666666666667,1,0.25,124,31.0,7,0.5833333333333334,0.0,0.0,0.0019615692554043234,3.2076943606166987e-07,1,3,4
org.apache.lucene.document.NumberTools,1,0,0,0,1,1.0,-1,-1.0,0,0,0.0,0.0,0.0008006405124099279,0.0,1,0,1
org.apache.lucene.search.SimilarityDelegator,2,2,2,1.0,1,0.5,124,62.0,0,0.0,0.0,0.0,0.0,0.0,0,1,1
org.apache.lucene.store.SingleInstanceLockFactory,4,5,12,0.4166666666666667,1,0.25,3,0.75,7,0.5833333333333334,0.0,0.0,0.0924277933884319,0.00040102001531722213,3,3,6
org.apache.lucene.search.SortField,2,1,2,0.5,1,0.5,123,61.5,1,0.5,0.0,0.0,0.08893842403700179,0.0009129098150315125,3,1,4
org.apache.lucene.search.Similarity,4,7,12,0.5833333333333334,1,0.25,123,30.75,5,0.4166666666666667,0.16666666666666666,0.041666666666666664,0.13880840225559488,0.0039396454078199465,47,4,51
org.apache.lucene.search.FuzzyTermEnum,5,12,20,0.6,1,0.2,132,26.4,8,0.4,0.0,0.0,0.019585610685079857,5.5546574011345845e-06,2,4,6
org.apache.lucene.store.Lock,2,1,2,0.5,1,0.5,0,0.0,1,0.5,0.0,0.0,0.17165599844622645,0.00013339051194335427,25,1,26
org.apache.lucene.search.spans.SpanFirstQuery,6,10,30,0.3333333333333333,1,0.16666666666666666,128,21.333333333333332,20,0.6666666666666666,0.0,0.0,0.002451961569255404,1.0655655171267664e-05,1,5,6
org.apache.lucene.search.TopDocs,2,1,2,0.5,1,0.5,0,0.0,1,0.5,0.0,0.0,0.10948843204582787,0.00021479637922792446,22,1,23
org.apache.lucene.search.TopFieldDocCollector,7,9,42,0.21428571428571427,1,0.14285714285714285,127,18.142857142857142,33,0.7857142857142857,0.0,0.0,0.005539566788565988,1.0264621953973436e-05,1,6,7
org.apache.lucene.analysis.Tokenizer,1,0,0,0,1,1.0,-1,-1.0,0,0,0.0,0.0,0.06567399330668348,0.0,7,0,7
org.apache.lucene.search.ComplexExplanation,2,2,2,1.0,1,0.5,0,0.0,0,0.0,0.0,0.0,0.0781964036998089,0.0,9,1,10
org.apache.lucene.search.Hit,3,3,6,0.5,1,0.3333333333333333,123,41.0,3,0.5,0.0,0.0,0.07748681175667707,3.143540473404365e-06,3,2,5
org.apache.lucene.util.Parameter,1,0,0,0,1,1.0,-1,-1.0,0,0,0.0,0.0,0.14884173525871056,0.0,8,0,8
org.apache.lucene.search.spans.NearSpansUnordered,8,17,56,0.30357142857142855,1,0.125,132,16.5,39,0.6964285714285714,0.26190476190476186,0.03273809523809523,0.010965809684784864,0.00016380625868215942,2,7,9
org.apache.lucene.document.Fieldable,2,1,2,0.5,1,0.5,1,0.5,1,0.5,0.0,0.0,0.15559152302685061,0.00011676712062473156,25,1,26
org.apache.lucene.search.Hits,7,12,42,0.2857142857142857,1,0.14285714285714285,123,17.571428571428573,30,0.7142857142857143,0.23333333333333334,0.03333333333333333,0.11342407259140645,0.002076398395328539,78,6,84
org.apache.lucene.queryParser.Token,1,1,0,0,1,1.0,-1,-1.0,-1,0,0.0,0.0,0.17940278148444683,0.0,65,1,66
org.apache.lucene.search.spans.SpanTermQuery,7,11,42,0.2619047619047619,1,0.14285714285714285,129,18.428571428571427,31,0.7380952380952381,0.0,0.0,0.020845247626672767,0.0003588434324991897,16,6,22
org.apache.lucene.util.StringHelper,1,0,0,0,1,1.0,-1,-1.0,0,0,0.0,0.0,0.07428445299474574,0.0,3,0,3
org.apache.lucene.store.RAMInputStream,4,4,12,0.3333333333333333,1,0.25,123,30.75,8,0.6666666666666666,0.0,0.0,0.09217780728647958,9.623083081850095e-07,2,3,5
org.apache.lucene.search.CachingWrapperFilter,3,4,6,0.6666666666666666,1,0.3333333333333333,125,41.666666666666664,2,0.3333333333333333,0.0,0.0,0.005811100493297864,6.135784696132975e-05,4,2,6
org.apache.lucene.index.TermPositionVector,1,0,0,0,1,1.0,-1,-1.0,0,0,0.0,0.0,0.0032025620496397116,0.0,4,0,4
org.apache.lucene.store.RAMFile,2,2,2,1.0,1,0.5,123,61.5,0,0.0,0.0,0.0,0.09253893483706324,0.00034450637433023343,6,1,7
org.apache.lucene.store.NoLock,2,1,2,0.5,1,0.5,1,0.5,1,0.5,0.0,0.0,0.08387874320620517,0.0,1,1,2
org.apache.lucene.analysis.StopFilter,3,4,6,0.6666666666666666,1,0.3333333333333333,1,0.3333333333333333,2,0.3333333333333333,0.0,0.0,0.04760715518679688,1.6699886236704706e-05,16,2,18
org.apache.lucene.util.ScorerDocQueue,3,3,6,0.5,1,0.3333333333333333,3,1.0,3,0.5,0.0,0.0,0.0012009607686148918,3.849233232740038e-06,1,2,3
org.apache.lucene.search.DefaultSimilarity,2,2,2,1.0,1,0.5,124,62.0,0,0.0,0.0,0.0,0.0014411529223378702,0.0,1,1,2
org.apache.lucene.search.ConstantScoreRangeQuery,5,11,20,0.55,1,0.2,129,25.8,9,0.45,0.0,0.0,0.02100776098265547,0.00068438825669249,3,4,7
org.apache.lucene.analysis.TokenFilter,2,1,2,0.5,1,0.5,1,0.5,1,0.5,0.0,0.0,0.0036028823058446755,3.2076943606166987e-07,4,1,5
org.apache.lucene.search.PhraseQueue,2,1,2,0.5,1,0.5,0,0.0,1,0.5,0.0,0.0,0.01600480784427642,1.2830777442466795e-06,1,1,2
org.apache.lucene.index.KeepOnlyLastCommitDeletionPolicy,3,2,6,0.3333333333333333,1,0.3333333333333333,1,0.3333333333333333,4,0.6666666666666666,0.0,0.0,0.11969710448493477,0.00037973755072434015,5,2,7
org.apache.lucene.analysis.standard.StandardAnalyzer,9,16,72,0.2222222222222222,1,0.1111111111111111,36,4.0,56,0.7777777777777778,0.0,0.0,0.05194359569288083,0.0032494507156772085,51,8,59
org.apache.lucene.store.RAMOutputStream,3,2,6,0.3333333333333333,1,0.3333333333333333,123,41.0,4,0.6666666666666666,0.0,0.0,0.0926599403092268,0.0001585670245598188,4,2,6
org.apache.lucene.store.AlreadyClosedException,1,0,0,0,1,1.0,-1,-1.0,0,0,0.0,0.0,0.12486707846415301,0.0,7,0,7
org.apache.lucene.search.spans.Spans,1,0,0,0,1,1.0,-1,-1.0,0,0,0.0,0.0,0.02332078428700407,0.0,13,0,13
org.apache.lucene.index.SegmentMergeInfo,5,8,20,0.4,1,0.2,3,0.6,12,0.6,0.0,0.0,0.08569233765390691,3.207694360616699e-06,3,4,7
org.apache.lucene.index.SegmentTermDocs,15,47,210,0.22380952380952382,1,0.06666666666666667,137,9.133333333333333,163,0.7761904761904762,0.015567765567765568,0.0010378510378510379,0.005698676588329487,6.223996291049935e-05,5,14,19
org.apache.lucene.index.CompoundFileReader,8,14,56,0.25,1,0.125,9,1.125,42,0.75,0.0,0.0,0.11250012668362538,0.0010446808333160894,5,7,12
org.apache.lucene.search.PhraseQuery,8,23,56,0.4107142857142857,1,0.125,133,16.625,33,0.5892857142857143,0.06746031746031746,0.008432539682539682,0.024332079018532217,0.0006541590940788367,15,7,22
org.apache.lucene.analysis.WhitespaceAnalyzer,4,4,12,0.3333333333333333,1,0.25,5,1.25,8,0.6666666666666666,0.0,0.0,0.048938324213089475,0.00024211142418208067,56,3,59
org.apache.lucene.search.QueryTermVector,3,2,6,0.3333333333333333,1,0.3333333333333333,3,1.0,4,0.6666666666666666,0.0,0.0,0.0008006405124099279,9.623083081850095e-07,1,2,3
org.apache.lucene.analysis.standard.TokenMgrError,1,0,0,0,1,1.0,-1,-1.0,0,0,0.0,0.0,0.029865737167017983,0.0,1,0,1
org.apache.lucene.index.FieldsWriter,8,20,56,0.35714285714285715,1,0.125,26,3.25,36,0.6428571428571429,0.007936507936507936,0.000992063492063492,0.08645188496327956,0.0015135538739999232,3,7,10
org.apache.lucene.index.SegmentTermPositions,6,15,30,0.5,1,0.16666666666666666,137,22.833333333333332,15,0.5,0.016666666666666666,0.002777777777777778,0.004843875100080065,1.139800729472467e-05,2,5,7
org.apache.lucene.store.IndexInput,1,0,0,0,1,1.0,-1,-1.0,0,0,0.0,0.0,0.17510911146105781,0.0,47,0,47
org.apache.lucene.analysis.TokenStream,2,2,2,1.0,1,0.5,0,0.0,0,0.0,0.0,0.0,0.18221577261809446,0.00024876059631503516,69,1,70
org.apache.lucene.search.ExactPhraseScorer,7,11,42,0.2619047619047619,1,0.14285714285714285,127,18.142857142857142,31,0.7380952380952381,0.0,0.0,0.019395791289710917,0.00019931543525418627,2,6,8
org.apache.lucene.search.RangeFilter,6,15,30,0.5,1,0.16666666666666666,125,20.833333333333332,15,0.5,0.0,0.0,0.019514301397449838,0.00012518796319875653,8,6,14
org.apache.lucene.search.IdGenerator,2,2,2,1.0,1,0.5,124,62.0,0,0.0,0.0,0.0,0.001067520683213237,0.0,1,1,2
org.apache.lucene.search.function.ReverseOrdFieldSource,5,8,20,0.4,1,0.2,128,25.6,12,0.6,0.0,0.0,0.0,0.0,0,4,4
org.apache.lucene.search.ReqExclScorer,3,3,6,0.5,1,0.3333333333333333,3,1.0,3,0.5,0.0,0.0,0.001067520683213237,0.0,1,2,3
org.apache.lucene.analysis.PorterStemFilter,4,5,12,0.4166666666666667,1,0.25,2,0.5,7,0.5833333333333334,0.0,0.0,0.0,0.0,0,3,3
org.apache.lucene.index.IndexModifier,10,22,90,0.24444444444444444,1,0.1,124,12.4,68,0.7555555555555555,0.0,0.0,0.009966593964827034,0.0007402864675737806,10,9,19
org.apache.lucene.store.SimpleFSLock,3,2,6,0.3333333333333333,1,0.3333333333333333,13,4.333333333333333,4,0.6666666666666666,0.0,0.0,0.08380484122981205,0.0,1,2,3
org.apache.lucene.index.SegmentTermEnum,8,18,56,0.32142857142857145,1,0.125,24,3.0,38,0.6785714285714286,0.0,0.0,0.004510274886575928,1.2905623644214518e-05,2,7,9
org.apache.lucene.analysis.standard.ParseException,3,4,6,0.6666666666666666,1,0.3333333333333333,1,0.3333333333333333,2,0.3333333333333333,0.0,0.0,0.03600718412567892,0.0,1,2,3
org.apache.lucene.index.SegmentTermPositionVector,3,2,6,0.3333333333333333,1,0.3333333333333333,2,0.6666666666666666,4,0.6666666666666666,0.0,0.0,0.004189398030051948,0.0,1,2,3
org.apache.lucene.search.function.CustomScoreQuery,9,31,72,0.4305555555555556,1,0.1111111111111111,131,14.555555555555555,41,0.5694444444444444,0.013392857142857142,0.001488095238095238,0.0024019215372297837,4.847182589376346e-05,3,8,11
org.apache.lucene.search.HitQueue,2,1,2,0.5,1,0.5,0,0.0,1,0.5,0.0,0.0,0.006722838588330982,9.623083081850095e-07,4,1,5
org.apache.lucene.store.LockFactory,2,1,2,0.5,1,0.5,1,0.5,1,0.5,0.0,0.0,0.13911390360474155,5.257054646566256e-07,9,1,10
org.apache.lucene.search.NonMatchingScorer,3,4,6,0.6666666666666666,1,0.3333333333333333,124,41.333333333333336,2,0.3333333333333333,0.0,0.0,0.001067520683213237,6.415388721233397e-07,1,2,3
org.apache.lucene.index.StaleReaderException,1,0,0,0,1,1.0,-1,-1.0,0,0,0.0,0.0,0.11344248913290984,0.0,3,0,3
org.apache.lucene.search.TopFieldDocs,3,3,6,0.5,1,0.3333333333333333,1,0.3333333333333333,3,0.5,0.0,0.0,0.10548973303271698,0.00015361801040343875,11,2,13
org.apache.lucene.search.spans.SpanWeight,13,45,156,0.28846153846153844,1,0.07692307692307693,127,9.76923076923077,111,0.7115384615384616,0.036616161616161616,0.0028166278166278165,0.01785853461530286,0.00014207719177124567,2,12,14
org.apache.lucene.index.DefaultSkipListWriter,3,3,6,0.5,1,0.3333333333333333,123,41.0,3,0.5,0.0,0.0,0.08524714508448865,0.0,1,2,3
org.apache.lucene.analysis.standard.StandardTokenizerConstants,1,0,0,0,1,1.0,-1,-1.0,0,0,0.0,0.0,0.036626811822902304,0.0,3,0,3
org.apache.lucene.queryParser.QueryParserTokenManager,5,5,20,0.25,1,0.2,3,0.6,15,0.75,0.0,0.0,0.02214091669702401,8.981544209726756e-06,2,4,6
org.apache.lucene.search.SortComparator,5,8,20,0.4,1,0.2,126,25.2,12,0.6,0.0,0.0,0.0008006405124099279,4.105848781589374e-05,1,4,5
org.apache.lucene.search.function.ValueSourceQuery,8,21,56,0.375,1,0.125,128,16.0,35,0.625,0.055555555555555546,0.006944444444444443,0.005895625591382197,0.00012041261103010504,7,7,14
org.apache.lucene.index.TermEnum,2,2,2,1.0,1,0.5,0,0.0,0,0.0,0.0,0.0,0.12031218470711529,5.346157267694497e-07,27,1,28
org.apache.lucene.search.MultiSearcherThread,11,19,110,0.17272727272727273,1,0.09090909090909091,128,11.636363636363637,91,0.8272727272727273,0.0,0.0,0.0008006405124099279,0.0,1,10,11
org.apache.lucene.index.ParallelReader,14,38,182,0.2087912087912088,1,0.07142857142857142,127,9.071428571428571,144,0.7912087912087912,0.17307692307692307,0.012362637362637362,0.0040032025620496394,0.0002638970150479358,5,13,18
org.apache.lucene.search.TermScorer,9,19,72,0.2638888888888889,1,0.1111111111111111,126,14.0,53,0.7361111111111112,0.0,0.0,0.030424339471577258,7.81258670658426e-05,2,8,10
org.apache.lucene.search.function.ShortFieldSource,4,6,12,0.5,1,0.25,129,32.25,6,0.5,0.0,0.0,0.0,0.0,0,3,3
org.apache.lucene.search.FilteredQuery,8,22,56,0.39285714285714285,1,0.125,125,15.625,34,0.6071428571428571,0.0,0.0,0.0012009607686148918,2.5791390132863316e-05,1,7,8
org.apache.lucene.search.function.FloatFieldSource,4,6,12,0.5,1,0.25,129,32.25,6,0.5,0.0,0.0,0.0,0.0,0,3,3
org.apache.lucene.search.FilterManager,4,6,12,0.5,1,0.25,127,31.75,6,0.5,0.3333333333333333,0.08333333333333333,0.0025620496397117695,8.532466999240419e-05,4,4,8
org.apache.lucene.search.FilteredTermEnum,3,4,6,0.6666666666666666,1,0.3333333333333333,1,0.3333333333333333,2,0.3333333333333333,0.0,0.0,0.021554296369856975,3.597963841158397e-06,8,2,10
org.apache.lucene.index.TermDocs,3,4,6,0.6666666666666666,1,0.3333333333333333,1,0.3333333333333333,2,0.3333333333333333,0.0,0.0,0.11849349662285609,2.0924859545756262e-05,32,2,34
org.apache.lucene.index.SegmentReader,28,112,756,0.14814814814814814,1,0.03571428571428571,137,4.892857142857143,644,0.8518518518518519,0.08155270655270656,0.002912596662596663,0.006919821571542949,0.0005177486005898737,10,28,38
org.apache.lucene.search.FieldSortedHitQueue,10,17,90,0.18888888888888888,1,0.1,127,12.7,73,0.8111111111111111,0.0,0.0,0.0,0.0,0,9,9
org.apache.lucene.analysis.PerFieldAnalyzerWrapper,3,3,6,0.5,1,0.3333333333333333,2,0.6666666666666666,3,0.5,0.0,0.0,0.029977018051688314,2.4442083189848325e-05,5,2,7
org.apache.lucene.search.HitCollector,1,0,0,0,1,1.0,-1,-1.0,0,0,0.0,0.0,0.06794310626479352,0.0,6,0,6
org.apache.lucene.analysis.WhitespaceTokenizer,2,1,2,0.5,1,0.5,2,1.0,1,0.5,0.0,0.0,0.03073548886502567,0.0001087408388249061,4,1,5
org.apache.lucene.search.spans.SpanNotQuery,6,10,30,0.3333333333333333,1,0.16666666666666666,128,21.333333333333332,20,0.6666666666666666,0.0,0.0,0.002451961569255404,1.0655655171267664e-05,1,5,6
org.apache.lucene.analysis.standard.StandardFilter,3,2,6,0.3333333333333333,1,0.3333333333333333,2,0.6666666666666666,4,0.6666666666666666,0.0,0.0,0.04310312314454525,6.415388721233398e-05,9,2,11
org.apache.lucene.search.ConstantScoreQuery,7,20,42,0.47619047619047616,1,0.14285714285714285,127,18.142857142857142,22,0.5238095238095238,0.04444444444444444,0.006349206349206348,0.019800208318590595,0.0004862223396666336,9,6,15
org.apache.lucene.search.RemoteSearchable,11,25,110,0.22727272727272727,1,0.09090909090909091,124,11.272727272727273,85,0.7727272727272727,0.0,0.0,0.0024019215372297837,9.626138028860208e-06,3,10,13
org.apache.lucene.index.FilterIndexReader,10,22,90,0.24444444444444444,1,0.1,124,12.4,68,0.7555555555555555,0.0,0.0,0.002135041366426474,1.3055316047709965e-05,2,9,11
org.apache.lucene.document.DateTools,2,1,2,0.5,1,0.5,0,0.0,1,0.5,0.0,0.0,0.024974860938792053,0.0,12,1,13
org.apache.lucene.search.ScoreDocComparator,2,1,2,0.5,1,0.5,0,0.0,1,0.5,0.0,0.0,0.06524439556233196,3.207694360616699e-06,3,1,4
org.apache.lucene.index.Payload,1,0,0,0,1,1.0,-1,-1.0,0,0,0.0,0.0,0.0875034359422829,0.0,8,0,8
org.apache.lucene.search.Filter,2,2,2,1.0,1,0.5,124,62.0,0,0.0,0.0,0.0,0.026802370378109265,0.0006883871788295327,24,1,25
org.apache.lucene.search.FieldCache,3,3,6,0.5,1,0.3333333333333333,125,41.666666666666664,3,0.5,0.0,0.0,0.008073125166800107,0.0001648754901356983,10,2,12
org.apache.lucene.util.SmallFloat,1,0,0,0,1,1.0,-1,-1.0,0,0,0.0,0.0,0.10813015702444488,0.0,2,0,2
org.apache.lucene.store.NativeFSLock,3,2,6,0.3333333333333333,1,0.3333333333333333,13,4.333333333333333,4,0.6666666666666666,0.0,0.0,0.08380484122981205,0.0,1,2,3
org.apache.lucene.index.IndexFileDeleter,9,21,72,0.2916666666666667,1,0.1111111111111111,23,2.5555555555555554,51,0.7083333333333334,0.06547619047619048,0.007275132275132276,0.12004858409234749,0.0014133956908571324,6,8,14
org.apache.lucene.analysis.KeywordTokenizer,3,3,6,0.5,1,0.3333333333333333,1,0.3333333333333333,3,0.5,0.0,0.0,0.0016012810248198558,2.405770770462524e-06,1,2,3
org.apache.lucene.queryParser.QueryParserConstants,1,0,0,0,1,1.0,-1,-1.0,0,0,0.0,0.0,0.022236657250328567,0.0,2,0,2
org.apache.lucene.index.TermFreqVector,1,0,0,0,1,1.0,-1,-1.0,0,0,0.0,0.0,0.11590732903783345,0.0,19,0,19
org.apache.lucene.index.IndexFileNames,2,3,2,1.5,1,0.5,7,3.5,-1,-0.5,0.0,0.0,0.10015717095595703,4.811541540925048e-06,9,1,10
org.apache.lucene.index.SegmentInfos,8,21,56,0.375,1,0.125,17,2.125,35,0.625,0.023809523809523808,0.002976190476190476,0.10465231930535321,0.0007832905840127411,5,7,12
org.apache.lucene.document.Field,8,17,56,0.30357142857142855,1,0.125,7,0.875,39,0.6964285714285714,0.011904761904761904,0.001488095238095238,0.16867203271499123,0.0008690368609981818,100,7,107
org.apache.lucene.search.TopDocCollector,5,6,20,0.3,1,0.2,3,0.6,14,0.7,0.0,0.0,0.0060890817917491884,2.105316732018093e-05,2,4,6
org.apache.lucene.analysis.KeywordAnalyzer,3,2,6,0.3333333333333333,1,0.3333333333333333,3,1.0,4,0.6666666666666666,0.0,0.0,0.0018014411529223377,4.170002668801708e-06,2,2,4
org.apache.lucene.store.FSDirectory,13,30,156,0.19230769230769232,1,0.07692307692307693,123,9.461538461538462,126,0.8076923076923077,0.05681818181818182,0.004370629370629371,0.12802473234233275,0.005989754987438263,33,13,46
org.apache.lucene.analysis.CachingTokenFilter,3,4,6,0.6666666666666666,1,0.3333333333333333,1,0.3333333333333333,2,0.3333333333333333,0.0,0.0,0.0008006405124099279,3.2076943606166987e-07,1,2,3
org.apache.lucene.search.spans.SpanOrQuery,6,10,30,0.3333333333333333,1,0.16666666666666666,128,21.333333333333332,20,0.6666666666666666,0.0,0.0,0.002451961569255404,1.0655655171267664e-05,1,5,6
org.apache.lucene.store.SingleInstanceLock,2,1,2,0.5,1,0.5,1,0.5,1,0.5,0.0,0.0,0.07766888524428688,0.0,1,1,2
org.apache.lucene.store.NoLockFactory,4,6,12,0.5,1,0.25,3,0.75,6,0.5,0.0,0.0,0.1013904885048859,0.00038512825930259886,4,4,8
org.apache.lucene.search.ScoreDoc,1,0,0,0,1,1.0,-1,-1.0,0,0,0.0,0.0,0.09102680318633251,0.0,15,0,15
org.apache.lucene.search.spans.NearSpansOrdered,3,4,6,0.6666666666666666,1,0.3333333333333333,132,44.0,2,0.3333333333333333,0.0,0.0,0.010885178731220269,7.206619996852184e-05,2,2,4
org.apache.lucene.analysis.LengthFilter,3,4,6,0.6666666666666666,1,0.3333333333333333,1,0.3333333333333333,2,0.3333333333333333,0.0,0.0,0.0008006405124099279,1.2830777442466795e-06,1,2,3
org.apache.lucene.search.IndexSearcher,18,49,306,0.16013071895424835,1,0.05555555555555555,129,7.166666666666667,257,0.8398692810457516,0.0,0.0,0.008578291204392085,0.0002617397827315762,9,17,26
org.apache.lucene.queryParser.ParseException,2,2,2,1.0,1,0.5,0,0.0,0,0.0,0.0,0.0,0.023642173987044737,1.2812056159252659e-05,13,1,14
org.apache.lucene.search.Weight,5,9,20,0.45,1,0.2,123,24.6,11,0.55,0.16666666666666666,0.03333333333333333,0.11795537137158749,0.0020012508577394116,30,4,34
org.apache.lucene.search.Scorer,4,5,12,0.4166666666666667,1,0.25,123,30.75,7,0.5833333333333334,0.0,0.0,0.0781275516554368,0.0004895932655051706,9,3,12
org.apache.lucene.index.IndexReader,24,63,552,0.11413043478260869,1,0.041666666666666664,123,5.125,489,0.8858695652173914,0.03211462450592885,0.001338109354413702,0.1455065489763474,0.022028831295953417,106,24,130
org.apache.lucene.search.QueryWrapperFilter,3,5,6,0.8333333333333334,1,0.3333333333333333,124,41.333333333333336,1,0.16666666666666666,0.0,0.0,0.0,0.0,0,2,2
org.apache.lucene.analysis.StopAnalyzer,7,9,42,0.21428571428571427,1,0.14285714285714285,22,3.142857142857143,33,0.7857142857142857,0.0,0.0,0.042589295316850496,0.00040868190075055567,12,6,18
org.apache.lucene.index.TermVectorsReader,10,21,90,0.23333333333333334,1,0.1,27,2.7,69,0.7666666666666667,0.0,0.0,0.005604483586869495,3.5771138278143886e-05,3,9,12
org.apache.lucene.analysis.standard.StandardTokenizerTokenManager,7,8,42,0.19047619047619047,1,0.14285714285714285,5,0.7142857142857143,34,0.8095238095238095,0.0,0.0,0.03600718412567892,0.00013344008540165466,1,6,7
org.apache.lucene.store.NativeFSLockFactory,5,7,20,0.35,1,0.2,14,2.8,13,0.65,0.0,0.0,0.10128216533340634,0.00038378102767113977,2,4,6
org.apache.lucene.analysis.ISOLatin1AccentFilter,3,4,6,0.6666666666666666,1,0.3333333333333333,1,0.3333333333333333,2,0.3333333333333333,0.0,0.0,0.0018014411529223377,1.4434624622775145e-06,2,2,4
org.apache.lucene.analysis.standard.Token,2,2,2,1.0,1,0.5,0,0.0,0,0.0,0.0,0.0,0.036626811822902304,0.0,3,1,4
org.apache.lucene.search.RemoteCachingWrapperFilter,4,7,12,0.5833333333333334,1,0.25,128,32.0,5,0.4166666666666667,0.0,0.0,0.001067520683213237,0.0,1,3,4
org.apache.lucene.search.RangeQuery,9,26,72,0.3611111111111111,1,0.1111111111111111,127,14.11111111111111,46,0.6388888888888888,0.0,0.0,0.022100346944222044,0.00018022714578353721,7,8,15
org.apache.lucene.search.PrefixQuery,10,29,90,0.32222222222222224,1,0.1,127,12.7,61,0.6777777777777778,0.0,0.0,0.022100346944222044,0.00026314757247898374,7,9,16
org.apache.lucene.analysis.standard.StandardTokenizer,11,21,110,0.19090909090909092,1,0.09090909090909091,11,1.0,89,0.8090909090909091,0.0,0.0,0.045499529597152526,0.0013114513467457722,13,10,23
org.apache.lucene.search.function.ByteFieldSource,5,7,20,0.35,1,0.2,130,26.0,13,0.65,0.0,0.0,0.0,0.0,0,4,4
org.apache.lucene.search.function.OrdFieldSource,5,8,20,0.4,1,0.2,128,25.6,12,0.6,0.0,0.0,0.0,0.0,0,4,4
org.apache.lucene.document.MapFieldSelector,2,1,2,0.5,1,0.5,0,0.0,1,0.5,0.0,0.0,0.0016012810248198558,9.623083081850095e-07,2,1,3
org.apache.lucene.index.IndexFileNameFilter,3,3,6,0.5,1,0.3333333333333333,15,5.0,3,0.5,0.0,0.0,0.10185423329770184,4.423324770391902e-05,4,3,7
org.apache.lucene.analysis.LowerCaseTokenizer,2,1,2,0.5,1,0.5,3,1.5,1,0.5,0.0,0.0,0.054393560762292105,0.00037305485413972205,7,1,8
org.apache.lucene.util.BitVector,4,6,12,0.5,1,0.25,6,1.5,6,0.5,0.0,0.0,0.005637843608219909,1.7535395838037954e-06,3,3,6
org.apache.lucene.document.AbstractField,7,15,42,0.35714285714285715,1,0.14285714285714285,7,1.0,27,0.6428571428571429,0.0,0.0,0.15264220832931122,0.0004146437767783724,15,6,21
org.apache.lucene.search.DisjunctionMaxQuery,6,18,30,0.6,1,0.16666666666666666,126,21.0,12,0.4,0.016666666666666666,0.002777777777777778,0.0036028823058446755,3.1598363725603975e-05,4,5,9
org.apache.lucene.index.DocumentWriter,13,34,156,0.21794871794871795,1,0.07692307692307693,39,3.0,122,0.782051282051282,0.0,0.0,0.10380337736904693,0.003609613117844703,5,12,17
org.apache.lucene.search.MultiTermQuery,9,24,72,0.3333333333333333,1,0.1111111111111111,125,13.88888888888889,48,0.6666666666666666,0.0,0.0,0.020892822985140617,2.022985910095598e-05,4,8,12
org.apache.lucene.search.BooleanScorer,8,12,56,0.21428571428571427,1,0.125,128,16.0,44,0.7857142857142857,0.0,0.0,0.001067520683213237,5.132310976986718e-06,1,7,8
org.apache.lucene.search.QueryFilter,3,3,6,0.5,1,0.3333333333333333,126,42.0,3,0.5,0.0,0.0,0.004843875100080065,1.0585391390035105e-05,5,2,7
org.apache.lucene.search.ParallelMultiSearcher,15,48,210,0.22857142857142856,1,0.06666666666666667,131,8.733333333333333,162,0.7714285714285715,0.0,0.0,0.0,0.0,0,14,14
org.apache.lucene.search.ConjunctionScorer,4,5,12,0.4166666666666667,1,0.25,124,31.0,7,0.5833333333333334,0.0,0.0,0.001067520683213237,0.0,1,3,4
org.apache.lucene.analysis.Token,2,1,2,0.5,1,0.5,0,0.0,1,0.5,0.0,0.0,0.001868161195623165,3.207694360616699e-06,2,1,3
org.apache.lucene.index.MultiTermPositions,5,9,20,0.45,1,0.2,125,25.0,11,0.55,0.0,0.0,0.0008006405124099279,0.0,1,4,5
org.apache.lucene.queryParser.FastCharStream,2,1,2,0.5,1,0.5,0,0.0,1,0.5,0.0,0.0,0.020771055705535956,0.0,1,1,2
org.apache.lucene.search.WildcardTermEnum,4,7,12,0.5833333333333334,1,0.25,125,31.25,5,0.4166666666666667,0.0,0.0,0.01921769299497569,0.0,1,3,4
org.apache.lucene.store.LockObtainFailedException,1,0,0,0,1,1.0,-1,-1.0,0,0,0.0,0.0,0.1568198915253029,0.0,6,0,6
org.apache.lucene.search.Sort,2,1,2,0.5,1,0.5,123,61.5,1,0.5,0.0,0.0,0.10872526175908122,0.0011321557245796638,17,1,18
org.apache.lucene.index.Posting,3,3,6,0.5,1,0.3333333333333333,1,0.3333333333333333,3,0.5,0.0,0.0,0.08554294884966833,8.553851628311196e-07,1,2,3
org.apache.lucene.index.IndexWriter,21,64,420,0.1523809523809524,1,0.047619047619047616,123,5.857142857142857,356,0.8476190476190476,0.1206140350877193,0.005743525480367585,0.13110395809709746,0.016952291640761626,99,20,119
org.apache.lucene.index.TermInfosReader,9,17,72,0.2361111111111111,1,0.1111111111111111,27,3.0,55,0.7638888888888888,0.0,0.0,0.005012705816827374,9.68723696906243e-06,2,8,10
org.apache.lucene.search.PhraseScorer,6,8,30,0.26666666666666666,1,0.16666666666666666,126,21.0,22,0.7333333333333333,0.0,0.0,0.01760475565349559,0.0001289493132967913,2,5,7
org.apache.lucene.store.MMapDirectory,5,8,20,0.4,1,0.2,126,25.2,12,0.6,0.0,0.0,0.0,0.0,0,4,4
org.apache.lucene.search.HitDoc,2,1,2,0.5,1,0.5,9,4.5,1,0.5,0.0,0.0,0.09189024887114862,0.0,1,1,2
org.apache.lucene.document.SetBasedFieldSelector,2,1,2,0.5,1,0.5,0,0.0,1,0.5,0.0,0.0,0.0033360021350413663,2.245386052431689e-06,4,1,5
org.apache.lucene.search.Explanation,1,1,0,0,1,1.0,-1,-1.0,-1,0,0.0,0.0,0.10951010048160109,0.0,40,1,41
org.apache.lucene.index.FieldReaderException,1,0,0,0,1,1.0,-1,-1.0,0,0,0.0,0.0,0.05660445365491845,0.0,1,0,1
org.apache.lucene.index.FieldInfo,1,0,0,0,1,1.0,-1,-1.0,0,0,0.0,0.0,0.08935972130096494,0.0,13,0,13
org.apache.lucene.search.HitIterator,3,4,6,0.6666666666666666,1,0.3333333333333333,123,41.0,2,0.3333333333333333,0.5,0.16666666666666666,0.0916710082166639,0.0003714510069594137,2,2,4
org.apache.lucene.search.BooleanScorer2,13,33,156,0.21153846153846154,1,0.07692307692307693,138,10.615384615384615,123,0.7884615384615384,0.05681818181818182,0.004370629370629371,0.0008006405124099279,4.715310710106547e-05,1,12,13
