name,Size,Ties,Pairs,Density,WeakComp,nWeakComp,2StepReach,ReachEffic,Broker,nBroker,EgoBetween,nEgoBetween,Closeness_Centrality,Betweenness_Centrality,in_degree,out_degree,degree
org.apache.html.dom.HTMLOptGroupElementImpl,4,5,12,0.4166666666666667,1,0.25,94,23.5,7,0.5833333333333334,0.0,0.0,0.0,0.0,0,3,3
org.apache.wml.WMLPElement,1,0,0,0,1,1.0,-1,-1.0,0,0,0.0,0.0,0.019562419562419563,0.0,1,0,1
org.w3c.dom.html.HTMLTitleElement,1,0,0,0,1,1.0,-1,-1.0,0,0,0.0,0.0,0.043236409608091025,0.0,2,0,2
org.w3c.dom.html.HTMLLegendElement,2,1,2,0.5,1,0.5,15,7.5,1,0.5,0.0,0.0,0.0015037593984962407,1.1323489446507835e-06,1,1,2
org.w3c.dom.events.EventListener,2,1,2,0.5,1,0.5,1,0.5,1,0.5,0.0,0.0,0.10517206774636798,4.529395778603134e-06,6,1,7
org.apache.html.dom.HTMLModElementImpl,4,5,12,0.4166666666666667,1,0.25,94,23.5,7,0.5833333333333334,0.0,0.0,0.0,0.0,0,3,3
org.apache.xerces.dom.CoreDOMImplementationImpl,10,36,90,0.4,1,0.1,43,4.3,54,0.6,0.0,0.0,0.08995713583022978,0.0,1,9,10
org.apache.wml.WMLBigElement,1,0,0,0,1,1.0,-1,-1.0,0,0,0.0,0.0,0.019562419562419563,0.0,1,0,1
org.apache.wml.dom.WMLTrElementImpl,4,6,12,0.5,1,0.25,138,34.5,6,0.5,0.3333333333333333,0.08333333333333333,0.02820063858275827,8.379382190415798e-05,1,3,4
org.apache.html.dom.HTMLHtmlElementImpl,4,7,12,0.5833333333333334,1,0.25,92,23.0,5,0.4166666666666667,0.0,0.0,0.042105263157894736,0.0,1,3,4
org.xml.sax.ext.LexicalHandler,1,0,0,0,1,1.0,-1,-1.0,0,0,0.0,0.0,0.03413923622152243,0.0,4,0,4
org.w3c.dom.traversal.NodeIterator,3,4,6,0.6666666666666666,1,0.3333333333333333,14,4.666666666666667,2,0.3333333333333333,0.0,0.0,0.08684872975390018,1.1323489446507835e-06,4,2,6
org.apache.xerces.dom.EntityImpl,5,12,20,0.6,1,0.2,43,8.6,8,0.4,0.0,0.0,0.0994360902255639,0.00010841432324356502,5,4,9
org.w3c.dom.events.EventException,1,0,0,0,1,1.0,-1,-1.0,0,0,0.0,0.0,0.0851507890605635,0.0,1,0,1
org.apache.xerces.dom.DeferredEntityReferenceImpl,8,18,56,0.32142857142857145,1,0.125,361,45.125,38,0.6785714285714286,0.11904761904761904,0.01488095238095238,0.034371643394199784,3.5313519154899705e-05,1,7,8
org.w3c.dom.html.HTMLParagraphElement,1,0,0,0,1,1.0,-1,-1.0,0,0,0.0,0.0,0.0015037593984962407,0.0,1,0,1
org.apache.wml.WMLMetaElement,1,0,0,0,1,1.0,-1,-1.0,0,0,0.0,0.0,0.019562419562419563,0.0,1,0,1
org.apache.xerces.dom.AttrImpl,13,48,156,0.3076923076923077,1,0.07692307692307693,43,3.3076923076923075,108,0.6923076923076923,0.030303030303030304,0.002331002331002331,0.11297433725157965,0.0008682272461260596,10,12,22
org.apache.wml.WMLStrongElement,1,0,0,0,1,1.0,-1,-1.0,0,0,0.0,0.0,0.019562419562419563,0.0,1,0,1
org.apache.wml.dom.WMLNoopElementImpl,4,6,12,0.5,1,0.25,138,34.5,6,0.5,0.3333333333333333,0.08333333333333333,0.02820063858275827,8.379382190415798e-05,1,3,4
org.xml.sax.XMLFilter,2,1,2,0.5,1,0.5,9,4.5,1,0.5,0.0,0.0,0.0015037593984962407,0.0,1,1,2
org.w3c.dom.events.Event,2,2,2,1.0,1,0.5,1,0.5,0,0.0,0.0,0.0,0.1056057669948066,0.00010665289155188598,8,1,9
javax.xml.parsers.FactoryFinder,2,1,2,0.5,1,0.5,0,0.0,1,0.5,0.0,0.0,0.0061403508771929825,0.0,2,1,3
org.xml.sax.ext.DeclHandler,1,0,0,0,1,1.0,-1,-1.0,0,0,0.0,0.0,0.034185874522371505,0.0,5,0,5
org.apache.wml.dom.WMLOptionElementImpl,4,6,12,0.5,1,0.25,138,34.5,6,0.5,0.3333333333333333,0.08333333333333333,0.02820063858275827,8.379382190415798e-05,1,3,4
org.w3c.dom.DocumentType,2,1,2,0.5,1,0.5,12,6.0,1,0.5,0.0,0.0,0.17213055135025415,5.305324412580503e-05,20,1,21
org.apache.html.dom.HTMLTableElementImpl,13,51,156,0.3269230769230769,1,0.07692307692307693,99,7.615384615384615,105,0.6730769230769231,0.022727272727272728,0.0017482517482517483,0.0020050125313283208,6.7940936679047005e-06,1,12,13
org.apache.wml.WMLSmallElement,1,0,0,0,1,1.0,-1,-1.0,0,0,0.0,0.0,0.019562419562419563,0.0,1,0,1
org.apache.xerces.dom.AttrNSImpl,4,9,12,0.75,1,0.25,43,10.75,3,0.25,0.0,0.0,0.0902946860584858,5.248167751564798e-05,3,3,6
org.apache.html.dom.HTMLBuilder,12,28,132,0.21212121212121213,1,0.08333333333333333,96,8.0,104,0.7878787878787878,0.0,0.0,0.0,0.0,0,11,11
org.apache.wml.dom.WMLRefreshElementImpl,4,6,12,0.5,1,0.25,138,34.5,6,0.5,0.3333333333333333,0.08333333333333333,0.02820063858275827,8.379382190415798e-05,1,3,4
org.apache.xerces.dom.DeferredElementNSImpl,7,11,42,0.2619047619047619,1,0.14285714285714285,361,51.57142857142857,31,0.7380952380952381,0.05,0.0071428571428571435,0.034371643394199784,1.4891287311796413e-05,1,6,7
org.w3c.dom.html.HTMLMenuElement,1,0,0,0,1,1.0,-1,-1.0,0,0,0.0,0.0,0.0015037593984962407,0.0,1,0,1
org.apache.html.dom.HTMLTableColElementImpl,4,5,12,0.4166666666666667,1,0.25,94,23.5,7,0.5833333333333334,0.0,0.0,0.0,0.0,0,3,3
org.apache.html.dom.HTMLDivElementImpl,4,5,12,0.4166666666666667,1,0.25,94,23.5,7,0.5833333333333334,0.0,0.0,0.0,0.0,0,3,3
org.apache.xerces.dom.AttributeMap,9,37,72,0.5138888888888888,1,0.1111111111111111,43,4.777777777777778,35,0.4861111111111111,0.023809523809523808,0.0026455026455026454,0.08578799941029043,7.928869074579733e-05,1,8,9
javax.xml.parsers.DocumentBuilder,7,9,42,0.21428571428571427,1,0.14285714285714285,19,2.7142857142857144,33,0.7857142857142857,0.0,0.0,0.006015037593984963,6.71671649002023e-05,4,6,10
org.w3c.dom.html.HTMLFrameElement,1,0,0,0,1,1.0,-1,-1.0,0,0,0.0,0.0,0.0015037593984962407,0.0,1,0,1
org.apache.html.dom.HTMLFormElementImpl,7,16,42,0.38095238095238093,1,0.14285714285714285,93,13.285714285714286,26,0.6190476190476191,0.0,0.0,0.0,0.0,0,6,6
org.apache.wml.WMLTdElement,1,0,0,0,1,1.0,-1,-1.0,0,0,0.0,0.0,0.019562419562419563,0.0,1,0,1
org.apache.wml.dom.WMLTimerElementImpl,4,6,12,0.5,1,0.25,138,34.5,6,0.5,0.3333333333333333,0.08333333333333333,0.02820063858275827,8.379382190415798e-05,1,3,4
org.apache.wml.dom.WMLCardElementImpl,4,6,12,0.5,1,0.25,138,34.5,6,0.5,0.3333333333333333,0.08333333333333333,0.02820063858275827,8.379382190415798e-05,1,3,4
org.apache.html.dom.HTMLAnchorElementImpl,4,5,12,0.4166666666666667,1,0.25,93,23.25,7,0.5833333333333334,0.0,0.0,0.0,0.0,0,3,3
org.apache.wml.dom.WMLUElementImpl,4,6,12,0.5,1,0.25,138,34.5,6,0.5,0.3333333333333333,0.08333333333333333,0.02820063858275827,8.379382190415798e-05,1,3,4
org.w3c.dom.html.HTMLOptionElement,2,1,2,0.5,1,0.5,15,7.5,1,0.5,0.0,0.0,0.031034641819272107,1.3210737687592472e-06,3,1,4
org.apache.html.dom.HTMLDirectoryElementImpl,4,5,12,0.4166666666666667,1,0.25,94,23.5,7,0.5833333333333334,0.0,0.0,0.0,0.0,0,3,3
org.apache.xml.serialize.HTMLSerializer,14,24,182,0.13186813186813187,1,0.07142857142857142,44,3.142857142857143,158,0.8681318681318682,0.0,0.0,0.0033834586466165413,8.194431862789504e-05,2,13,15
org.w3c.dom.html.HTMLHeadElement,1,0,0,0,1,1.0,-1,-1.0,0,0,0.0,0.0,0.043236409608091025,0.0,2,0,2
org.apache.html.dom.HTMLLinkElementImpl,4,5,12,0.4166666666666667,1,0.25,94,23.5,7,0.5833333333333334,0.0,0.0,0.0,0.0,0,3,3
org.apache.html.dom.HTMLDocumentImpl,22,54,462,0.11688311688311688,1,0.045454545454545456,92,4.181818181818182,408,0.8831168831168831,0.19523809523809527,0.008874458874458875,0.0827331486611265,0.008494617568016427,55,21,76
org.apache.html.dom.HTMLOptionElementImpl,8,11,56,0.19642857142857142,1,0.125,94,11.75,45,0.8035714285714286,0.0,0.0,0.0015037593984962407,2.03822810037141e-05,1,7,8
org.apache.wml.WMLOptgroupElement,1,0,0,0,1,1.0,-1,-1.0,0,0,0.0,0.0,0.019562419562419563,0.0,1,0,1
org.w3c.dom.html.HTMLFontElement,1,0,0,0,1,1.0,-1,-1.0,0,0,0.0,0.0,0.0015037593984962407,0.0,1,0,1
org.apache.wml.WMLTemplateElement,1,0,0,0,1,1.0,-1,-1.0,0,0,0.0,0.0,0.019562419562419563,0.0,1,0,1
org.w3c.dom.events.EventTarget,3,4,6,0.6666666666666666,1,0.3333333333333333,1,0.3333333333333333,2,0.3333333333333333,0.5,0.16666666666666666,0.09245270215249314,1.2833288039375546e-05,5,2,7
org.apache.wml.dom.WMLPrevElementImpl,4,6,12,0.5,1,0.25,138,34.5,6,0.5,0.3333333333333333,0.08333333333333333,0.02820063858275827,8.379382190415798e-05,1,3,4
org.apache.html.dom.HTMLParamElementImpl,4,5,12,0.4166666666666667,1,0.25,94,23.5,7,0.5833333333333334,0.0,0.0,0.0,0.0,0,3,3
org.apache.xml.serialize.Printer,3,2,6,0.3333333333333333,1,0.3333333333333333,26,8.666666666666666,4,0.6666666666666666,0.0,0.0,0.00870032223415682,0.0,5,2,7
org.w3c.dom.html.HTMLLabelElement,2,1,2,0.5,1,0.5,15,7.5,1,0.5,0.0,0.0,0.0015037593984962407,1.1323489446507835e-06,1,1,2
org.w3c.dom.html.HTMLInputElement,2,1,2,0.5,1,0.5,15,7.5,1,0.5,0.0,0.0,0.0015037593984962407,1.1323489446507835e-06,1,1,2
org.apache.xerces.jaxp.DocumentBuilderFactoryImpl,7,15,42,0.35714285714285715,1,0.14285714285714285,373,53.285714285714285,27,0.6428571428571429,0.0,0.0,0.0,0.0,0,6,6
org.apache.wml.WMLIElement,1,0,0,0,1,1.0,-1,-1.0,0,0,0.0,0.0,0.019562419562419563,0.0,1,0,1
org.apache.html.dom.HTMLParagraphElementImpl,4,5,12,0.4166666666666667,1,0.25,94,23.5,7,0.5833333333333334,0.0,0.0,0.0,0.0,0,3,3
org.apache.xerces.parsers.SAXParser,23,45,506,0.08893280632411067,1,0.043478260869565216,361,15.695652173913043,461,0.9110671936758893,0.0,0.0,0.03627158348131636,0.018733899076434607,9,22,31
org.xml.sax.helpers.XMLReaderFactory,6,10,30,0.3333333333333333,1,0.16666666666666666,21,3.5,20,0.6666666666666666,0.0,0.0,0.002255639097744361,3.7367515173475856e-05,1,5,6
org.apache.xerces.dom.NodeImpl,12,40,132,0.30303030303030304,1,0.08333333333333333,43,3.5833333333333335,92,0.696969696969697,0.049999999999999996,0.004166666666666667,0.11377557368598802,0.0009293098736775685,19,12,31
org.apache.html.dom.HTMLCollectionImpl,17,25,272,0.09191176470588236,1,0.058823529411764705,27,1.588235294117647,247,0.9080882352941176,0.0,0.0,0.04523809523809524,0.0013945991628526277,7,16,23
org.apache.xerces.dom.DeferredElementImpl,7,13,42,0.30952380952380953,1,0.14285714285714285,361,51.57142857142857,29,0.6904761904761905,0.01111111111111111,0.001587301587301587,0.034371643394199784,2.8128985688547237e-06,1,6,7
org.apache.xerces.dom.CDATASectionImpl,4,8,12,0.6666666666666666,1,0.25,43,10.75,4,0.3333333333333333,0.0,0.0,0.09021006123556313,4.891845479761051e-05,2,3,5
org.xml.sax.helpers.DefaultHandler,10,15,90,0.16666666666666666,1,0.1,8,0.8,75,0.8333333333333334,0.0,0.0,0.010741138560687433,6.423474060941221e-05,6,9,15
org.apache.xerces.dom.DeferredNotationImpl,5,7,20,0.35,1,0.2,361,72.2,13,0.65,0.08333333333333333,0.016666666666666666,0.034371643394199784,1.198402633088746e-05,1,4,5
org.xml.sax.DTDHandler,1,0,0,0,1,1.0,-1,-1.0,0,0,0.0,0.0,0.04059143843544605,0.0,9,0,9
org.apache.wml.WMLEmElement,1,0,0,0,1,1.0,-1,-1.0,0,0,0.0,0.0,0.019562419562419563,0.0,1,0,1
org.apache.html.dom.HTMLBRElementImpl,4,5,12,0.4166666666666667,1,0.25,94,23.5,7,0.5833333333333334,0.0,0.0,0.0,0.0,0,3,3
org.w3c.dom.html.HTMLSelectElement,4,4,12,0.3333333333333333,1,0.25,16,4.0,8,0.6666666666666666,0.0,0.0,0.004511278195488722,3.963221306277742e-06,3,3,6
org.apache.wml.dom.WMLIElementImpl,4,6,12,0.5,1,0.25,138,34.5,6,0.5,0.3333333333333333,0.08333333333333333,0.02820063858275827,8.379382190415798e-05,1,3,4
org.apache.wml.dom.WMLPElementImpl,4,6,12,0.5,1,0.25,138,34.5,6,0.5,0.3333333333333333,0.08333333333333333,0.02820063858275827,8.379382190415798e-05,1,3,4
javax.xml.parsers.FactoryConfigurationError,1,0,0,0,1,1.0,-1,-1.0,0,0,0.0,0.0,0.0061403508771929825,0.0,2,0,2
org.w3c.dom.html.HTMLParamElement,1,0,0,0,1,1.0,-1,-1.0,0,0,0.0,0.0,0.0015037593984962407,0.0,1,0,1
org.apache.html.dom.HTMLImageElementImpl,4,5,12,0.4166666666666667,1,0.25,93,23.25,7,0.5833333333333334,0.0,0.0,0.0,0.0,0,3,3
org.apache.wml.dom.WMLBigElementImpl,4,6,12,0.5,1,0.25,138,34.5,6,0.5,0.3333333333333333,0.08333333333333333,0.02820063858275827,8.379382190415798e-05,1,3,4
org.w3c.dom.html.HTMLQuoteElement,1,0,0,0,1,1.0,-1,-1.0,0,0,0.0,0.0,0.0015037593984962407,0.0,1,0,1
org.w3c.dom.html.HTMLLinkElement,1,0,0,0,1,1.0,-1,-1.0,0,0,0.0,0.0,0.0015037593984962407,0.0,1,0,1
org.apache.wml.dom.WMLBElementImpl,4,6,12,0.5,1,0.25,138,34.5,6,0.5,0.3333333333333333,0.08333333333333333,0.02820063858275827,8.379382190415798e-05,1,3,4
org.xml.sax.SAXNotSupportedException,2,1,2,0.5,1,0.5,0,0.0,1,0.5,0.0,0.0,0.06059094467403375,7.775462753268716e-06,16,1,17
org.w3c.dom.html.HTMLObjectElement,2,1,2,0.5,1,0.5,15,7.5,1,0.5,0.0,0.0,0.030845406198422885,1.1323489446507835e-06,2,1,3
org.w3c.dom.html.HTMLDocument,4,3,12,0.25,1,0.25,15,3.75,9,0.75,0.0,0.0,0.054237867395762134,9.93447474106954e-05,6,3,9
org.apache.wml.dom.WMLDoElementImpl,4,6,12,0.5,1,0.25,138,34.5,6,0.5,0.3333333333333333,0.08333333333333333,0.02820063858275827,8.379382190415798e-05,1,3,4
org.apache.html.dom.HTMLAppletElementImpl,4,5,12,0.4166666666666667,1,0.25,93,23.25,7,0.5833333333333334,0.0,0.0,0.0,0.0,0,3,3
org.apache.wml.WMLDOMImplementation,1,0,0,0,1,1.0,-1,-1.0,0,0,0.0,0.0,0.0015037593984962407,0.0,1,0,1
org.w3c.dom.html.HTMLModElement,1,0,0,0,1,1.0,-1,-1.0,0,0,0.0,0.0,0.0015037593984962407,0.0,1,0,1
org.apache.xerces.dom.DOMImplementationImpl,10,35,90,0.3888888888888889,1,0.1,64,6.4,55,0.6111111111111112,0.017361111111111112,0.0017361111111111112,0.08534001670843777,0.00023236699033872687,5,9,14
org.w3c.dom.html.HTMLDOMImplementation,2,1,2,0.5,1,0.5,16,8.0,1,0.5,0.0,0.0,0.0030075187969924814,0.0,2,1,3
org.w3c.dom.traversal.DocumentTraversal,4,6,12,0.5,1,0.25,16,4.0,6,0.5,0.0,0.0,0.08637726913970008,1.0077905607391974e-05,4,3,7
org.xml.sax.InputSource,1,0,0,0,1,1.0,-1,-1.0,0,0,0.0,0.0,0.10326546292739147,0.0,28,0,28
org.apache.html.dom.HTMLHeadElementImpl,4,7,12,0.5833333333333334,1,0.25,92,23.0,5,0.4166666666666667,0.0,0.0,0.042105263157894736,0.0,1,3,4
org.xml.sax.DocumentHandler,3,2,6,0.3333333333333333,1,0.3333333333333333,1,0.3333333333333333,4,0.6666666666666666,0.0,0.0,0.040075389546251686,1.7199122303751344e-05,10,2,12
org.apache.wml.dom.WMLFieldsetElementImpl,4,6,12,0.5,1,0.25,138,34.5,6,0.5,0.3333333333333333,0.08333333333333333,0.02820063858275827,8.379382190415798e-05,1,3,4
org.xml.sax.HandlerBase,10,15,90,0.16666666666666666,1,0.1,8,0.8,75,0.8333333333333334,0.0,0.0,0.009398496240601503,5.3162884261715666e-05,5,9,14
org.apache.xerces.dom.DeepNodeListImpl,4,8,12,0.6666666666666666,1,0.25,43,10.75,4,0.3333333333333333,0.16666666666666666,0.041666666666666664,0.09882354757530376,2.3842236112369276e-06,3,3,6
org.apache.html.dom.HTMLDOMImplementationImpl,6,9,30,0.3,1,0.16666666666666666,94,15.666666666666666,21,0.7,0.0,0.0,0.0015037593984962407,0.0001721170395869191,1,5,6
org.w3c.dom.html.HTMLBaseFontElement,1,0,0,0,1,1.0,-1,-1.0,0,0,0.0,0.0,0.0015037593984962407,0.0,1,0,1
org.w3c.dom.ProcessingInstruction,1,0,0,0,1,1.0,-1,-1.0,0,0,0.0,0.0,0.14964525015161811,0.0,9,0,9
org.apache.wml.WMLTrElement,1,0,0,0,1,1.0,-1,-1.0,0,0,0.0,0.0,0.019562419562419563,0.0,1,0,1
org.w3c.dom.html.HTMLDivElement,1,0,0,0,1,1.0,-1,-1.0,0,0,0.0,0.0,0.0015037593984962407,0.0,1,0,1
org.apache.wml.WMLAElement,1,0,0,0,1,1.0,-1,-1.0,0,0,0.0,0.0,0.019562419562419563,0.0,1,0,1
org.apache.xerces.dom.RangeImpl,12,32,132,0.24242424242424243,1,0.08333333333333333,64,5.333333333333333,100,0.7575757575757576,0.04393939393939394,0.0036616161616161613,0.0845881222880991,0.0012545869119154752,1,11,12
org.apache.wml.WMLBrElement,1,0,0,0,1,1.0,-1,-1.0,0,0,0.0,0.0,0.019562419562419563,0.0,1,0,1
org.apache.html.dom.NameNodeListImpl,5,12,20,0.6,1,0.2,44,8.8,8,0.4,0.0,0.0,0.04285714285714286,0.0001927509536894445,1,4,5
org.xml.sax.helpers.NamespaceSupport,2,3,2,1.5,1,0.5,0,0.0,-1,-0.5,0.0,0.0,0.04447368421052632,1.2455838391158618e-05,2,1,3
org.apache.xerces.jaxp.SAXParserImpl,12,33,132,0.25,1,0.08333333333333333,377,31.416666666666668,99,0.75,0.0,0.0,0.0015037593984962407,2.299926523135147e-05,1,11,12
javax.xml.parsers.SAXParserFactory,10,17,90,0.18888888888888888,1,0.1,369,36.9,73,0.8111111111111111,0.0,0.0,0.0030075187969924814,1.585288522511097e-05,3,10,13
org.w3c.dom.ranges.DocumentRange,2,2,2,1.0,1,0.5,14,7.0,0,0.0,0.0,0.0,0.0851507890605635,0.0,1,1,2
org.apache.xerces.dom.NodeIteratorImpl,6,14,30,0.4666666666666667,1,0.16666666666666666,64,10.666666666666666,16,0.5333333333333333,0.0,0.0,0.0845881222880991,0.0,1,5,6
org.apache.wml.dom.WMLSetvarElementImpl,4,6,12,0.5,1,0.25,138,34.5,6,0.5,0.3333333333333333,0.08333333333333333,0.02820063858275827,8.379382190415798e-05,1,3,4
org.apache.wml.WMLAnchorElement,1,0,0,0,1,1.0,-1,-1.0,0,0,0.0,0.0,0.019562419562419563,0.0,1,0,1
org.apache.wml.dom.WMLWmlElementImpl,4,6,12,0.5,1,0.25,138,34.5,6,0.5,0.3333333333333333,0.08333333333333333,0.02820063858275827,8.379382190415798e-05,1,3,4
org.apache.xerces.dom.DeferredEntityImpl,5,7,20,0.35,1,0.2,361,72.2,13,0.65,0.08333333333333333,0.016666666666666666,0.034371643394199784,1.1700939094724762e-05,1,4,5
org.apache.xerces.dom.LCount,1,1,0,0,1,1.0,-1,-1.0,-1,0,0.0,0.0,0.0851507890605635,0.0,2,1,3
org.w3c.dom.html.HTMLMapElement,2,1,2,0.5,1,0.5,14,7.0,1,0.5,0.0,0.0,0.0015037593984962407,0.0,1,1,2
org.w3c.dom.DocumentFragment,1,0,0,0,1,1.0,-1,-1.0,0,0,0.0,0.0,0.14906579129333497,0.0,12,0,12
org.apache.html.dom.HTMLTableCellElementImpl,5,6,20,0.3,1,0.2,93,18.6,14,0.7,0.0,0.0,0.0027067669172932333,0.0,1,4,5
org.apache.xerces.dom.DeferredElementDefinitionImpl,7,16,42,0.38095238095238093,1,0.14285714285714285,361,51.57142857142857,26,0.6190476190476191,0.08333333333333333,0.011904761904761904,0.034371643394199784,1.6085972637743627e-05,1,6,7
org.apache.xml.serialize.Serializer,5,4,20,0.2,1,0.2,20,4.0,16,0.8,0.0,0.0,0.006874328678839957,1.992934142585379e-05,3,4,7
org.xml.sax.ErrorHandler,2,1,2,0.5,1,0.5,2,1.0,1,0.5,0.0,0.0,0.06670156403667396,9.383398254672824e-05,20,1,21
org.w3c.dom.DOMImplementation,3,4,6,0.6666666666666666,1,0.3333333333333333,12,4.0,2,0.3333333333333333,0.0,0.0,0.16244592372651373,6.686250911271291e-06,12,2,14
org.apache.xml.serialize.BaseMarkupSerializer,24,52,552,0.09420289855072464,1,0.041666666666666664,41,1.7083333333333333,500,0.9057971014492754,0.0,0.0,0.0066985645933014355,0.00020956004469003834,4,23,27
org.apache.xml.serialize.HTMLdtd,1,0,0,0,1,1.0,-1,-1.0,0,0,0.0,0.0,0.0030075187969924814,0.0,1,0,1
org.apache.html.dom.HTMLTableSectionElementImpl,9,30,72,0.4166666666666667,1,0.1111111111111111,99,11.0,42,0.5833333333333334,0.0,0.0,0.0030075187969924814,0.0,2,8,10
org.apache.wml.dom.WMLEmElementImpl,4,6,12,0.5,1,0.25,138,34.5,6,0.5,0.3333333333333333,0.08333333333333333,0.02820063858275827,8.379382190415798e-05,1,3,4
org.apache.wml.WMLUElement,1,0,0,0,1,1.0,-1,-1.0,0,0,0.0,0.0,0.019562419562419563,0.0,1,0,1
org.apache.xerces.dom.ProcessingInstructionImpl,4,7,12,0.5833333333333334,1,0.25,43,10.75,5,0.4166666666666667,0.16666666666666666,0.041666666666666664,0.09037946980126373,6.544895201023474e-05,4,3,7
org.w3c.dom.html.HTMLHtmlElement,1,0,0,0,1,1.0,-1,-1.0,0,0,0.0,0.0,0.043236409608091025,0.0,2,0,2
org.apache.wml.WMLFieldsetElement,1,0,0,0,1,1.0,-1,-1.0,0,0,0.0,0.0,0.019562419562419563,0.0,1,0,1
org.apache.xerces.dom.RangeExceptionImpl,2,1,2,0.5,1,0.5,0,0.0,1,0.5,0.0,0.0,0.06827067669172933,0.0,1,1,2
org.apache.html.dom.HTMLIFrameElementImpl,4,5,12,0.4166666666666667,1,0.25,94,23.5,7,0.5833333333333334,0.0,0.0,0.0,0.0,0,3,3
org.w3c.dom.html.HTMLDListElement,1,0,0,0,1,1.0,-1,-1.0,0,0,0.0,0.0,0.0015037593984962407,0.0,1,0,1
org.w3c.dom.events.DocumentEvent,2,1,2,0.5,1,0.5,2,1.0,1,0.5,0.0,0.0,0.0851507890605635,0.0,1,1,2
org.apache.xml.serialize.XMLSerializer,14,25,182,0.13736263736263737,1,0.07142857142857142,44,3.142857142857143,157,0.8626373626373627,0.0,0.0,0.0033834586466165413,4.49542531026361e-05,2,13,15
org.apache.html.dom.HTMLFontElementImpl,4,5,12,0.4166666666666667,1,0.25,94,23.5,7,0.5833333333333334,0.0,0.0,0.0,0.0,0,3,3
org.w3c.dom.CDATASection,1,0,0,0,1,1.0,-1,-1.0,0,0,0.0,0.0,0.14777827486181863,0.0,8,0,8
javax.xml.parsers.DocumentBuilderFactory,6,7,30,0.23333333333333334,1,0.16666666666666666,24,4.0,23,0.7666666666666667,0.0,0.0,0.004511278195488722,2.264697889301567e-05,4,6,10
org.apache.wml.WMLOptionElement,1,0,0,0,1,1.0,-1,-1.0,0,0,0.0,0.0,0.019562419562419563,0.0,1,0,1
org.apache.xerces.dom.NamedNodeMapImpl,6,19,30,0.6333333333333333,1,0.16666666666666666,43,7.166666666666667,11,0.36666666666666664,0.0,0.0,0.0952068598796695,1.4726827107930466e-05,7,6,13
org.apache.wml.dom.WMLStrongElementImpl,4,6,12,0.5,1,0.25,138,34.5,6,0.5,0.3333333333333333,0.08333333333333333,0.02820063858275827,8.379382190415798e-05,1,3,4
org.apache.wml.WMLImgElement,1,0,0,0,1,1.0,-1,-1.0,0,0,0.0,0.0,0.019562419562419563,0.0,1,0,1
org.apache.xml.serialize.SieveEncodingInfo,3,2,6,0.3333333333333333,1,0.3333333333333333,1,0.3333333333333333,4,0.6666666666666666,0.0,0.0,0.006561859193438141,2.7176374671618802e-05,1,2,3
org.xml.sax.Attributes,1,0,0,0,1,1.0,-1,-1.0,0,0,0.0,0.0,0.04328297748312964,0.0,16,0,16
org.w3c.dom.html.HTMLHRElement,1,0,0,0,1,1.0,-1,-1.0,0,0,0.0,0.0,0.0015037593984962407,0.0,1,0,1
org.apache.html.dom.HTMLTableRowElementImpl,14,57,182,0.3131868131868132,1,0.07142857142857142,99,7.071428571428571,125,0.6868131868131868,0.035256410256410256,0.0025183150183150185,0.0030075187969924814,2.1212670229791344e-05,2,13,15
org.apache.wml.WMLCardElement,1,0,0,0,1,1.0,-1,-1.0,0,0,0.0,0.0,0.019562419562419563,0.0,1,0,1
org.w3c.dom.NamedNodeMap,2,3,2,1.5,1,0.5,12,6.0,-1,-0.5,0.0,0.0,0.17855782981374088,4.3008671734099746e-05,40,1,41
org.apache.xerces.dom.DeferredDocumentTypeImpl,8,19,56,0.3392857142857143,1,0.125,361,45.125,37,0.6607142857142857,0.019841269841269837,0.0024801587301587296,0.034371643394199784,8.461489743761688e-06,1,7,8
org.apache.html.dom.HTMLFormControl,1,0,0,0,1,1.0,-1,-1.0,0,0,0.0,0.0,0.03306304978131604,0.0,8,0,8
org.apache.wml.WMLPrevElement,1,0,0,0,1,1.0,-1,-1.0,0,0,0.0,0.0,0.019562419562419563,0.0,1,0,1
org.apache.xerces.dom.CoreDocumentImpl,39,160,1482,0.10796221322537113,1,0.02564102564102564,43,1.1025641025641026,1322,0.8920377867746289,0.366834315518526,0.009406008090218616,0.11767009210066733,0.009355165674578675,37,39,76
org.apache.wml.WMLPostfieldElement,1,0,0,0,1,1.0,-1,-1.0,0,0,0.0,0.0,0.019562419562419563,0.0,1,0,1
org.w3c.dom.ranges.RangeException,1,0,0,0,1,1.0,-1,-1.0,0,0,0.0,0.0,0.06893424036281179,0.0,3,0,3
org.w3c.dom.Node,4,8,12,0.6666666666666666,1,0.25,12,3.0,4,0.3333333333333333,0.8333333333333333,0.20833333333333331,0.20706909357290385,0.001581379385981251,80,4,84
org.apache.xerces.dom.DocumentTypeImpl,7,22,42,0.5238095238095238,1,0.14285714285714285,43,6.142857142857143,20,0.47619047619047616,0.06666666666666667,0.009523809523809523,0.1114052492341966,0.0002470806638983104,7,6,13
org.w3c.dom.html.HTMLCollection,2,2,2,1.0,1,0.5,13,6.5,0,0.0,0.0,0.0,0.06659763180406104,0.000517217455572379,15,1,16
org.apache.xerces.dom.TreeWalkerImpl,4,7,12,0.5833333333333334,1,0.25,15,3.75,5,0.4166666666666667,0.0,0.0,0.0851507890605635,0.0,1,3,4
org.apache.wml.dom.WMLOptgroupElementImpl,4,6,12,0.5,1,0.25,138,34.5,6,0.5,0.3333333333333333,0.08333333333333333,0.02820063858275827,8.379382190415798e-05,1,3,4
org.apache.xml.serialize.Method,1,0,0,0,1,1.0,-1,-1.0,0,0,0.0,0.0,0.012130325814536339,0.0,7,0,7
org.apache.wml.WMLSetvarElement,1,0,0,0,1,1.0,-1,-1.0,0,0,0.0,0.0,0.019562419562419563,0.0,1,0,1
org.apache.wml.dom.WMLHeadElementImpl,4,6,12,0.5,1,0.25,138,34.5,6,0.5,0.3333333333333333,0.08333333333333333,0.02820063858275827,8.379382190415798e-05,1,3,4
org.apache.html.dom.HTMLSelectElementImpl,11,28,110,0.2545454545454545,1,0.09090909090909091,95,8.636363636363637,82,0.7454545454545455,0.0,0.0,0.0,0.0,0,10,10
org.apache.wml.WMLInputElement,1,0,0,0,1,1.0,-1,-1.0,0,0,0.0,0.0,0.019562419562419563,0.0,1,0,1
org.apache.xerces.dom.ElementImpl,17,72,272,0.2647058823529412,1,0.058823529411764705,43,2.5294117647058822,200,0.7352941176470589,0.1190972222222222,0.0070057189542483645,0.11063693717051248,0.004487001810581842,10,16,26
org.w3c.dom.html.HTMLAnchorElement,1,0,0,0,1,1.0,-1,-1.0,0,0,0.0,0.0,0.030845406198422885,0.0,2,0,2
org.apache.xerces.dom.TextImpl,7,15,42,0.35714285714285715,1,0.14285714285714285,43,6.142857142857143,27,0.6428571428571429,0.1,0.014285714285714287,0.10047404523835685,0.0003377167819146257,9,6,15
org.w3c.dom.html.HTMLTableCaptionElement,1,0,0,0,1,1.0,-1,-1.0,0,0,0.0,0.0,0.004699248120300752,0.0,3,0,3
org.w3c.dom.html.HTMLScriptElement,1,0,0,0,1,1.0,-1,-1.0,0,0,0.0,0.0,0.0015037593984962407,0.0,1,0,1
org.apache.xml.serialize.TextSerializer,11,20,110,0.18181818181818182,1,0.09090909090909091,42,3.8181818181818183,90,0.8181818181818182,0.0,0.0,0.0020050125313283208,2.3062173506054292e-05,1,10,11
org.apache.wml.dom.WMLBrElementImpl,4,6,12,0.5,1,0.25,138,34.5,6,0.5,0.3333333333333333,0.08333333333333333,0.02820063858275827,8.379382190415798e-05,1,3,4
org.w3c.dom.html.HTMLStyleElement,1,0,0,0,1,1.0,-1,-1.0,0,0,0.0,0.0,0.0015037593984962407,0.0,1,0,1
org.apache.html.dom.HTMLBodyElementImpl,4,7,12,0.5833333333333334,1,0.25,92,23.0,5,0.4166666666666667,0.0,0.0,0.042105263157894736,0.0,1,3,4
org.apache.xerces.jaxp.DefaultValidationErrorHandler,3,3,6,0.5,1,0.3333333333333333,9,3.0,3,0.5,0.0,0.0,0.0040100250626566416,3.736751517347585e-06,2,2,4
org.w3c.dom.html.HTMLTableElement,5,6,20,0.3,1,0.2,17,3.4,14,0.7,0.0,0.0,0.0033834586466165413,2.264697889301567e-06,2,4,6
org.apache.html.dom.HTMLIsIndexElementImpl,4,5,12,0.4166666666666667,1,0.25,94,23.5,7,0.5833333333333334,0.0,0.0,0.0,0.0,0,3,3
org.apache.html.dom.HTMLPreElementImpl,4,5,12,0.4166666666666667,1,0.25,94,23.5,7,0.5833333333333334,0.0,0.0,0.0,0.0,0,3,3
org.xml.sax.AttributeList,1,0,0,0,1,1.0,-1,-1.0,0,0,0.0,0.0,0.0741993873572821,0.0,19,0,19
org.w3c.dom.ranges.Range,3,4,6,0.6666666666666666,1,0.3333333333333333,13,4.333333333333333,2,0.3333333333333333,0.0,0.0,0.08609188168659535,6.7836688680968e-05,6,3,9
org.apache.wml.dom.WMLOneventElementImpl,4,6,12,0.5,1,0.25,138,34.5,6,0.5,0.3333333333333333,0.08333333333333333,0.02820063858275827,8.379382190415798e-05,1,3,4
org.apache.xml.serialize.LineSeparator,1,0,0,0,1,1.0,-1,-1.0,0,0,0.0,0.0,0.008664518438954529,0.0,1,0,1
org.xml.sax.helpers.AttributesImpl,2,1,2,0.5,1,0.5,0,0.0,1,0.5,0.0,0.0,0.03413923622152243,1.2720053144910466e-05,4,1,5
org.xml.sax.helpers.ParserAdapter,20,43,380,0.11315789473684211,1,0.05,20,1.0,337,0.8868421052631579,0.04678362573099415,0.0023391812865497076,0.0034176349965823645,9.190898934082193e-05,2,19,21
org.apache.wml.WMLSelectElement,1,0,0,0,1,1.0,-1,-1.0,0,0,0.0,0.0,0.019562419562419563,0.0,1,0,1
org.w3c.dom.html.HTMLTableColElement,1,0,0,0,1,1.0,-1,-1.0,0,0,0.0,0.0,0.0015037593984962407,0.0,1,0,1
org.w3c.dom.CharacterData,1,0,0,0,1,1.0,-1,-1.0,0,0,0.0,0.0,0.12327387719616703,0.0,13,0,13
org.apache.wml.dom.WMLAElementImpl,4,6,12,0.5,1,0.25,138,34.5,6,0.5,0.3333333333333333,0.08333333333333333,0.02820063858275827,8.379382190415798e-05,1,3,4
org.apache.xml.serialize.SerializerFactoryImpl,10,30,90,0.3333333333333333,1,0.1,50,5.0,60,0.6666666666666666,0.05555555555555555,0.005555555555555555,0.0015037593984962407,4.514297792674457e-05,1,9,10
org.xml.sax.ContentHandler,3,2,6,0.3333333333333333,1,0.3333333333333333,1,0.3333333333333333,4,0.6666666666666666,0.0,0.0,0.04174291149560649,3.458696943161115e-05,10,2,12
org.apache.wml.WMLAccessElement,1,0,0,0,1,1.0,-1,-1.0,0,0,0.0,0.0,0.019562419562419563,0.0,1,0,1
org.apache.html.dom.HTMLAreaElementImpl,4,5,12,0.4166666666666667,1,0.25,93,23.25,7,0.5833333333333334,0.0,0.0,0.0,0.0,0,3,3
org.apache.wml.dom.WMLSelectElementImpl,4,6,12,0.5,1,0.25,138,34.5,6,0.5,0.3333333333333333,0.08333333333333333,0.02820063858275827,8.379382190415798e-05,1,3,4
org.apache.html.dom.HTMLLegendElementImpl,4,5,12,0.4166666666666667,1,0.25,94,23.5,7,0.5833333333333334,0.0,0.0,0.0,0.0,0,3,3
org.apache.xerces.jaxp.SAXParserFactoryImpl,10,31,90,0.34444444444444444,1,0.1,378,37.8,59,0.6555555555555556,0.0,0.0,0.0,0.0,0,9,9
org.w3c.dom.Comment,1,0,0,0,1,1.0,-1,-1.0,0,0,0.0,0.0,0.148777741455087,0.0,9,0,9
org.apache.html.dom.HTMLMenuElementImpl,4,5,12,0.4166666666666667,1,0.25,94,23.5,7,0.5833333333333334,0.0,0.0,0.0,0.0,0,3,3
org.apache.html.dom.HTMLFrameSetElementImpl,4,6,12,0.5,1,0.25,93,23.25,6,0.5,0.0,0.0,0.0,0.0,0,3,3
org.w3c.dom.html.HTMLTableSectionElement,3,2,6,0.3333333333333333,1,0.3333333333333333,15,5.0,4,0.6666666666666666,0.0,0.0,0.031918210159545206,0.0,5,2,7
org.w3c.dom.Text,1,1,0,0,1,1.0,-1,-1.0,-1,0,0.0,0.0,0.16433827364569373,0.0,17,1,18
org.apache.xerces.dom.ChildNode,4,12,12,1.0,1,0.25,43,10.75,0,0.0,0.0,0.0,0.09021006123556313,4.982335356463447e-06,6,4,10
org.xml.sax.SAXParseException,3,2,6,0.3333333333333333,1,0.3333333333333333,1,0.3333333333333333,4,0.6666666666666666,0.0,0.0,0.06445860247487603,5.869342029773226e-05,22,2,24
org.apache.wml.dom.WMLDocumentImpl,42,114,1722,0.06620209059233449,1,0.023809523809523808,138,3.2857142857142856,1608,0.9337979094076655,0.8567073170731707,0.02039779326364692,0.055639097744360905,0.009289286577027761,37,41,78
org.w3c.dom.html.HTMLBaseElement,1,0,0,0,1,1.0,-1,-1.0,0,0,0.0,0.0,0.0015037593984962407,0.0,1,0,1
org.apache.wml.WMLDocument,1,0,0,0,1,1.0,-1,-1.0,0,0,0.0,0.0,0.028952380952380955,0.0,1,0,1
org.apache.html.dom.HTMLBaseFontElementImpl,4,5,12,0.4166666666666667,1,0.25,94,23.5,7,0.5833333333333334,0.0,0.0,0.0,0.0,0,3,3
org.w3c.dom.DOMException,1,0,0,0,1,1.0,-1,-1.0,0,0,0.0,0.0,0.150180404571801,0.0,41,0,41
org.w3c.dom.traversal.NodeFilter,2,2,2,1.0,1,0.5,13,6.5,0,0.0,0.0,0.0,0.08971164174171692,1.0191140501857052e-06,9,1,10
org.w3c.dom.Notation,1,0,0,0,1,1.0,-1,-1.0,0,0,0.0,0.0,0.10443125887006674,0.0,7,0,7
org.apache.wml.WMLGoElement,1,0,0,0,1,1.0,-1,-1.0,0,0,0.0,0.0,0.019562419562419563,0.0,1,0,1
org.w3c.dom.html.HTMLTableRowElement,3,2,6,0.3333333333333333,1,0.3333333333333333,15,5.0,4,0.6666666666666666,0.0,0.0,0.031420165320132636,1.887248241084639e-06,5,2,7
org.w3c.dom.NodeList,2,3,2,1.5,1,0.5,12,6.0,-1,-0.5,0.0,0.0,0.18570881086210672,0.00013618383307666755,23,1,24
org.apache.xerces.dom.CharacterDataImpl,5,9,20,0.45,1,0.2,43,8.6,11,0.55,0.0,0.0,0.08863180049571442,2.542392987632592e-05,5,4,9
org.xml.sax.helpers.LocatorImpl,2,1,2,0.5,1,0.5,0,0.0,1,0.5,0.0,0.0,0.03995738935477078,0.0,2,1,3
org.w3c.dom.html.HTMLMetaElement,1,0,0,0,1,1.0,-1,-1.0,0,0,0.0,0.0,0.0015037593984962407,0.0,1,0,1
javax.xml.parsers.ParserConfigurationException,1,0,0,0,1,1.0,-1,-1.0,0,0,0.0,0.0,0.008187134502923977,0.0,5,0,5
org.xml.sax.XMLReader,6,6,30,0.2,1,0.16666666666666666,8,1.3333333333333333,24,0.8,0.0,0.0,0.04219243761577857,0.0003303672980500587,15,5,20
org.apache.xerces.dom.DeferredNode,1,0,0,0,1,1.0,-1,-1.0,0,0,0.0,0.0,0.03556791817994097,0.0,14,0,14
org.apache.wml.WMLTableElement,1,0,0,0,1,1.0,-1,-1.0,0,0,0.0,0.0,0.019562419562419563,0.0,1,0,1
org.apache.wml.dom.WMLAccessElementImpl,4,6,12,0.5,1,0.25,138,34.5,6,0.5,0.3333333333333333,0.08333333333333333,0.02820063858275827,8.379382190415798e-05,1,3,4
org.apache.xerces.dom.DeferredDocumentImpl,24,69,552,0.125,1,0.041666666666666664,361,15.041666666666666,483,0.875,0.5049407114624506,0.02103919631093544,0.04237599870517781,0.02321857099327884,14,23,37
org.w3c.dom.html.HTMLOptGroupElement,1,0,0,0,1,1.0,-1,-1.0,0,0,0.0,0.0,0.0015037593984962407,0.0,1,0,1
org.apache.xerces.dom.CommentImpl,5,8,20,0.4,1,0.2,43,8.6,12,0.6,0.25,0.05,0.09021006123556313,7.469646839154945e-05,2,4,6
org.apache.xerces.dom.DeferredTextImpl,4,5,12,0.4166666666666667,1,0.25,361,90.25,7,0.5833333333333334,0.16666666666666666,0.041666666666666664,0.034371643394199784,5.473019899145454e-06,1,3,4
org.apache.wml.dom.WMLImgElementImpl,4,6,12,0.5,1,0.25,138,34.5,6,0.5,0.3333333333333333,0.08333333333333333,0.02820063858275827,8.379382190415798e-05,1,3,4
org.apache.xml.serialize.XHTMLSerializer,5,8,20,0.4,1,0.2,45,9.0,12,0.6,0.0,0.0,0.0020050125313283208,0.0,1,4,5
org.apache.wml.dom.WMLTableElementImpl,4,6,12,0.5,1,0.25,138,34.5,6,0.5,0.3333333333333333,0.08333333333333333,0.02820063858275827,8.379382190415798e-05,1,3,4
org.w3c.dom.html.HTMLIFrameElement,1,0,0,0,1,1.0,-1,-1.0,0,0,0.0,0.0,0.0015037593984962407,0.0,1,0,1
org.apache.xml.serialize.EncodingInfo,1,0,0,0,1,1.0,-1,-1.0,0,0,0.0,0.0,0.011551606288448394,0.0,4,0,4
org.xml.sax.helpers.XMLReaderAdapter,16,35,240,0.14583333333333334,1,0.0625,23,1.4375,205,0.8541666666666666,0.0,0.0,0.0020050125313283208,3.909120190033315e-05,1,15,16
org.apache.xml.serialize.IndentPrinter,4,5,12,0.4166666666666667,1,0.25,27,6.75,7,0.5833333333333334,0.0,0.0,0.005065294815987336,0.0,1,3,4
org.apache.xerces.dom.DeferredCDATASectionImpl,4,5,12,0.4166666666666667,1,0.25,361,90.25,7,0.5833333333333334,0.16666666666666666,0.041666666666666664,0.034371643394199784,1.1906820721024906e-05,1,3,4
org.apache.xml.serialize.DOMSerializer,4,5,12,0.4166666666666667,1,0.25,13,3.25,7,0.5833333333333334,0.0,0.0,0.007164971251658559,3.3743998550593346e-05,2,3,5
org.apache.xerces.dom.events.MutationEventImpl,4,5,12,0.4166666666666667,1,0.25,18,4.5,7,0.5833333333333334,0.0,0.0,0.0851507890605635,0.0,1,3,4
org.apache.wml.dom.WMLPostfieldElementImpl,4,6,12,0.5,1,0.25,138,34.5,6,0.5,0.3333333333333333,0.08333333333333333,0.02820063858275827,8.379382190415798e-05,1,3,4
org.apache.html.dom.HTMLQuoteElementImpl,4,5,12,0.4166666666666667,1,0.25,94,23.5,7,0.5833333333333334,0.0,0.0,0.0,0.0,0,3,3
org.w3c.dom.html.HTMLElement,1,0,0,0,1,1.0,-1,-1.0,0,0,0.0,0.0,0.05754181371796839,0.0,13,0,13
org.xml.sax.Parser,6,6,30,0.2,1,0.16666666666666666,8,1.3333333333333333,24,0.8,0.0,0.0,0.03461142482762924,6.157282189984427e-05,10,5,15
org.apache.wml.dom.WMLDOMImplementationImpl,12,46,132,0.3484848484848485,1,0.08333333333333333,140,11.666666666666666,86,0.6515151515151515,0.0,0.0,0.0,0.0,0,11,11
org.w3c.dom.traversal.TreeWalker,3,4,6,0.6666666666666666,1,0.3333333333333333,14,4.666666666666667,2,0.3333333333333333,0.0,0.0,0.08751251064956118,2.1514629948364885e-06,5,2,7
org.w3c.dom.html.HTMLDirectoryElement,1,0,0,0,1,1.0,-1,-1.0,0,0,0.0,0.0,0.0015037593984962407,0.0,1,0,1
org.apache.xerces.dom.events.EventImpl,3,4,6,0.6666666666666666,1,0.3333333333333333,2,0.6666666666666666,2,0.3333333333333333,0.0,0.0,0.08580837384350008,8.040845803550761e-05,2,2,4
org.xml.sax.EntityResolver,2,1,2,0.5,1,0.5,0,0.0,1,0.5,0.0,0.0,0.07800224861218467,0.0,18,1,19
org.apache.html.dom.HTMLHeadingElementImpl,4,5,12,0.4166666666666667,1,0.25,94,23.5,7,0.5833333333333334,0.0,0.0,0.0,0.0,0,3,3
org.apache.wml.WMLTimerElement,1,0,0,0,1,1.0,-1,-1.0,0,0,0.0,0.0,0.019562419562419563,0.0,1,0,1
org.apache.wml.WMLHeadElement,1,0,0,0,1,1.0,-1,-1.0,0,0,0.0,0.0,0.019562419562419563,0.0,1,0,1
org.apache.html.dom.HTMLFrameElementImpl,4,5,12,0.4166666666666667,1,0.25,94,23.5,7,0.5833333333333334,0.0,0.0,0.0,0.0,0,3,3
org.apache.html.dom.HTMLBaseElementImpl,4,5,12,0.4166666666666667,1,0.25,94,23.5,7,0.5833333333333334,0.0,0.0,0.0,0.0,0,3,3
org.w3c.dom.EntityReference,1,0,0,0,1,1.0,-1,-1.0,0,0,0.0,0.0,0.1486341335965396,0.0,9,0,9
org.apache.xerces.dom.DeferredAttrImpl,5,8,20,0.4,1,0.2,361,72.2,12,0.6,0.0,0.0,0.034371643394199784,0.0,1,4,5
org.apache.html.dom.HTMLStyleElementImpl,4,5,12,0.4166666666666667,1,0.25,94,23.5,7,0.5833333333333334,0.0,0.0,0.0,0.0,0,3,3
org.xml.sax.helpers.ParserFactory,2,1,2,0.5,1,0.5,9,4.5,1,0.5,0.0,0.0,0.006416040100250627,0.0,4,1,5
org.w3c.dom.html.HTMLAppletElement,1,0,0,0,1,1.0,-1,-1.0,0,0,0.0,0.0,0.030845406198422885,0.0,2,0,2
org.apache.html.dom.HTMLMapElementImpl,6,11,30,0.36666666666666664,1,0.16666666666666666,94,15.666666666666666,19,0.6333333333333333,0.0,0.0,0.0,0.0,0,5,5
org.xml.sax.Locator,1,0,0,0,1,1.0,-1,-1.0,0,0,0.0,0.0,0.10334571368179485,0.0,24,0,24
org.w3c.dom.html.HTMLAreaElement,1,0,0,0,1,1.0,-1,-1.0,0,0,0.0,0.0,0.030845406198422885,0.0,2,0,2
org.apache.wml.WMLNoopElement,1,0,0,0,1,1.0,-1,-1.0,0,0,0.0,0.0,0.019562419562419563,0.0,1,0,1
org.apache.wml.dom.WMLElementImpl,4,4,12,0.3333333333333333,1,0.25,138,34.5,8,0.6666666666666666,0.3333333333333333,0.08333333333333333,0.054174910961614565,0.0018919663616873497,36,3,39
org.xml.sax.SAXNotRecognizedException,2,1,2,0.5,1,0.5,0,0.0,1,0.5,0.0,0.0,0.060298940121387805,7.775462753268716e-06,15,1,16
org.apache.xerces.dom.DeferredAttrNSImpl,5,7,20,0.35,1,0.2,361,72.2,13,0.65,0.08333333333333333,0.016666666666666666,0.034371643394199784,1.15122142706163e-05,1,4,5
org.apache.html.dom.CollectionIndex,1,0,0,0,1,1.0,-1,-1.0,0,0,0.0,0.0,0.03047377479844189,0.0,1,0,1
org.w3c.dom.html.HTMLHeadingElement,1,0,0,0,1,1.0,-1,-1.0,0,0,0.0,0.0,0.0015037593984962407,0.0,1,0,1
org.w3c.dom.events.MutationEvent,2,2,2,1.0,1,0.5,13,6.5,0,0.0,0.0,0.0,0.08703377700268175,3.170577045022194e-05,3,1,4
org.apache.xml.serialize.SerializerFactory,6,13,30,0.43333333333333335,1,0.16666666666666666,50,8.333333333333334,17,0.5666666666666667,0.0,0.0,0.0015037593984962407,0.0,2,6,8
org.apache.wml.WMLElement,1,0,0,0,1,1.0,-1,-1.0,0,0,0.0,0.0,0.02857142857142857,0.0,1,0,1
org.apache.xml.serialize.ElementState,1,0,0,0,1,1.0,-1,-1.0,0,0,0.0,0.0,0.007403123192596878,0.0,4,0,4
org.w3c.dom.html.HTMLOListElement,1,0,0,0,1,1.0,-1,-1.0,0,0,0.0,0.0,0.0015037593984962407,0.0,1,0,1
org.w3c.dom.html.HTMLImageElement,1,0,0,0,1,1.0,-1,-1.0,0,0,0.0,0.0,0.030845406198422885,0.0,2,0,2
org.apache.wml.dom.WMLGoElementImpl,4,6,12,0.5,1,0.25,138,34.5,6,0.5,0.3333333333333333,0.08333333333333333,0.02820063858275827,8.379382190415798e-05,1,3,4
org.apache.xerces.dom.DeferredProcessingInstructionImpl,4,5,12,0.4166666666666667,1,0.25,361,90.25,7,0.5833333333333334,0.16666666666666666,0.041666666666666664,0.034371643394199784,1.1906820721024906e-05,1,3,4
org.w3c.dom.html.HTMLIsIndexElement,2,1,2,0.5,1,0.5,15,7.5,1,0.5,0.0,0.0,0.0015037593984962407,1.1323489446507835e-06,1,1,2
org.apache.wml.dom.WMLMetaElementImpl,4,6,12,0.5,1,0.25,138,34.5,6,0.5,0.3333333333333333,0.08333333333333333,0.02820063858275827,8.379382190415798e-05,1,3,4
org.w3c.dom.html.HTMLFieldSetElement,2,1,2,0.5,1,0.5,15,7.5,1,0.5,0.0,0.0,0.0015037593984962407,1.1323489446507835e-06,1,1,2
org.w3c.dom.Attr,2,2,2,1.0,1,0.5,12,6.0,0,0.0,0.0,0.0,0.18326234748548015,6.877132590512424e-05,30,1,31
org.xml.sax.helpers.AttributeListImpl,2,1,2,0.5,1,0.5,0,0.0,1,0.5,0.0,0.0,0.0,0.0,0,1,1
org.apache.wml.WMLWmlElement,1,0,0,0,1,1.0,-1,-1.0,0,0,0.0,0.0,0.019562419562419563,0.0,1,0,1
org.apache.wml.dom.WMLTdElementImpl,4,6,12,0.5,1,0.25,138,34.5,6,0.5,0.3333333333333333,0.08333333333333333,0.02820063858275827,8.379382190415798e-05,1,3,4
org.apache.xml.serialize.Encodings,3,3,6,0.5,1,0.3333333333333333,2,0.6666666666666666,3,0.5,0.0,0.0,0.008664518438954529,4.982335356463447e-05,1,2,3
org.w3c.dom.html.HTMLFormElement,2,1,2,0.5,1,0.5,14,7.0,1,0.5,0.0,0.0,0.05607567305360174,0.0003076214632967962,14,1,15
org.apache.xerces.dom.DocumentImpl,29,95,812,0.11699507389162561,1,0.034482758620689655,64,2.206896551724138,717,0.8830049261083743,0.08013668430335096,0.0027633339414948606,0.11245390195840994,0.01500317302801677,23,28,51
org.apache.xml.serialize.OutputFormat,10,11,90,0.12222222222222222,1,0.1,24,2.4,79,0.8777777777777778,0.0,0.0,0.015037593984962405,0.00037571337983513,10,9,19
org.w3c.dom.html.HTMLFrameSetElement,1,0,0,0,1,1.0,-1,-1.0,0,0,0.0,0.0,0.043236409608091025,0.0,2,0,2
org.w3c.dom.html.HTMLLIElement,1,0,0,0,1,1.0,-1,-1.0,0,0,0.0,0.0,0.0015037593984962407,0.0,1,0,1
org.apache.wml.WMLOneventElement,1,0,0,0,1,1.0,-1,-1.0,0,0,0.0,0.0,0.019562419562419563,0.0,1,0,1
javax.xml.parsers.SAXParser,8,11,56,0.19642857142857142,1,0.125,17,2.125,45,0.8035714285714286,0.0,0.0,0.004511278195488722,2.5436511531266487e-05,3,7,10
org.apache.xerces.parsers.DOMParser,40,150,1560,0.09615384615384616,1,0.025,361,9.025,1410,0.9038461538461539,0.0,0.0,0.04437322815234808,0.026449539879163833,18,39,57
org.xml.sax.SAXException,1,0,0,0,1,1.0,-1,-1.0,0,0,0.0,0.0,0.09648868363802908,0.0,37,0,37
org.apache.xerces.dom.DocumentFragmentImpl,4,8,12,0.6666666666666666,1,0.25,43,10.75,4,0.3333333333333333,0.0,0.0,0.08995713583022978,0.0,1,3,4
org.apache.html.dom.HTMLScriptElementImpl,7,10,42,0.23809523809523808,1,0.14285714285714285,94,13.428571428571429,32,0.7619047619047619,0.0,0.0,0.0,0.0,0,6,6
org.apache.html.dom.HTMLTitleElementImpl,7,12,42,0.2857142857142857,1,0.14285714285714285,92,13.142857142857142,30,0.7142857142857143,0.2,0.028571428571428574,0.042105263157894736,0.0002542321092461505,1,6,7
org.apache.wml.dom.WMLSmallElementImpl,4,6,12,0.5,1,0.25,138,34.5,6,0.5,0.3333333333333333,0.08333333333333333,0.02820063858275827,8.379382190415798e-05,1,3,4
org.apache.html.dom.HTMLButtonElementImpl,5,6,20,0.3,1,0.2,94,18.8,14,0.7,0.0,0.0,0.0,0.0,0,4,4
org.apache.xerces.dom.ParentNode,7,21,42,0.5,1,0.14285714285714285,43,6.142857142857143,21,0.5,0.03333333333333333,0.0047619047619047615,0.09923106735911945,9.514157597090823e-05,7,6,13
org.apache.html.dom.HTMLTableCaptionElementImpl,4,5,12,0.4166666666666667,1,0.25,94,23.5,7,0.5833333333333334,0.0,0.0,0.002255639097744361,0.0,1,3,4
org.apache.html.dom.HTMLLIElementImpl,4,5,12,0.4166666666666667,1,0.25,94,23.5,7,0.5833333333333334,0.0,0.0,0.0,0.0,0,3,3
org.apache.html.dom.HTMLHRElementImpl,4,5,12,0.4166666666666667,1,0.25,94,23.5,7,0.5833333333333334,0.0,0.0,0.0,0.0,0,3,3
org.apache.wml.dom.WMLAnchorElementImpl,4,6,12,0.5,1,0.25,138,34.5,6,0.5,0.3333333333333333,0.08333333333333333,0.02820063858275827,8.379382190415798e-05,1,3,4
org.w3c.dom.html.HTMLButtonElement,2,1,2,0.5,1,0.5,15,7.5,1,0.5,0.0,0.0,0.0015037593984962407,1.1323489446507835e-06,1,1,2
org.apache.html.dom.HTMLObjectElementImpl,5,6,20,0.3,1,0.2,93,18.6,14,0.7,0.0,0.0,0.0,0.0,0,4,4
org.apache.html.dom.HTMLTextAreaElementImpl,5,6,20,0.3,1,0.2,94,18.8,14,0.7,0.0,0.0,0.0,0.0,0,4,4
org.apache.wml.WMLDoElement,1,0,0,0,1,1.0,-1,-1.0,0,0,0.0,0.0,0.019562419562419563,0.0,1,0,1
org.w3c.dom.html.HTMLBodyElement,1,0,0,0,1,1.0,-1,-1.0,0,0,0.0,0.0,0.043236409608091025,0.0,2,0,2
org.apache.wml.WMLBElement,1,0,0,0,1,1.0,-1,-1.0,0,0,0.0,0.0,0.019562419562419563,0.0,1,0,1
org.w3c.dom.html.HTMLTextAreaElement,2,1,2,0.5,1,0.5,15,7.5,1,0.5,0.0,0.0,0.0015037593984962407,1.1323489446507835e-06,1,1,2
org.w3c.dom.html.HTMLUListElement,1,0,0,0,1,1.0,-1,-1.0,0,0,0.0,0.0,0.0015037593984962407,0.0,1,0,1
org.apache.html.dom.HTMLDListElementImpl,4,5,12,0.4166666666666667,1,0.25,94,23.5,7,0.5833333333333334,0.0,0.0,0.0,0.0,0,3,3
org.apache.xerces.dom.DeferredCommentImpl,4,5,12,0.4166666666666667,1,0.25,361,90.25,7,0.5833333333333334,0.16666666666666666,0.041666666666666664,0.034371643394199784,1.1906820721024906e-05,1,3,4
org.apache.html.dom.HTMLMetaElementImpl,4,5,12,0.4166666666666667,1,0.25,94,23.5,7,0.5833333333333334,0.0,0.0,0.0,0.0,0,3,3
org.w3c.dom.Entity,1,0,0,0,1,1.0,-1,-1.0,0,0,0.0,0.0,0.11062375160363111,0.0,7,0,7
org.apache.html.dom.HTMLInputElementImpl,5,6,20,0.3,1,0.2,94,18.8,14,0.7,0.0,0.0,0.0,0.0,0,4,4
org.apache.wml.dom.WMLInputElementImpl,4,6,12,0.5,1,0.25,138,34.5,6,0.5,0.3333333333333333,0.08333333333333333,0.02820063858275827,8.379382190415798e-05,1,3,4
org.apache.html.dom.HTMLFieldSetElementImpl,5,6,20,0.3,1,0.2,94,18.8,14,0.7,0.0,0.0,0.0,0.0,0,4,4
org.apache.xerces.dom.EntityReferenceImpl,10,37,90,0.4111111111111111,1,0.1,43,4.3,53,0.5888888888888889,0.0,0.0,0.09012559488609163,7.075465223848228e-06,2,9,11
org.apache.xerces.jaxp.DocumentBuilderImpl,18,57,306,0.18627450980392157,1,0.05555555555555555,372,20.666666666666668,249,0.8137254901960784,0.0,0.0,0.0015037593984962407,0.00024990851339478927,1,17,18
org.apache.xerces.dom.ElementDefinitionImpl,6,19,30,0.6333333333333333,1,0.16666666666666666,43,7.166666666666667,11,0.36666666666666664,0.1,0.016666666666666666,0.10962885573843492,0.0001938877960822883,4,5,9
org.xml.sax.helpers.XMLFilterImpl,14,25,182,0.13736263736263737,1,0.07142857142857142,13,0.9285714285714286,157,0.8626373626373627,0.0,0.0,0.0,0.0,0,13,13
org.apache.xerces.dom.ElementNSImpl,4,9,12,0.75,1,0.25,43,10.75,3,0.25,0.0,0.0,0.09021006123556313,2.6687650906330124e-05,2,3,5
org.w3c.dom.Element,3,3,6,0.5,1,0.3333333333333333,12,4.0,3,0.5,0.5,0.16666666666666666,0.20134744756628412,0.0002712066408393069,39,2,41
org.apache.xerces.dom.NotationImpl,5,12,20,0.6,1,0.2,43,8.6,8,0.4,0.0,0.0,0.09933347300138892,0.00013420581718208332,4,4,8
org.apache.wml.dom.WMLTemplateElementImpl,4,6,12,0.5,1,0.25,138,34.5,6,0.5,0.3333333333333333,0.08333333333333333,0.02820063858275827,8.379382190415798e-05,1,3,4
org.w3c.dom.Document,13,22,156,0.14102564102564102,1,0.07692307692307693,12,0.9230769230769231,134,0.8589743589743589,0.3484848484848485,0.026806526806526808,0.19518375019180606,0.0035398861173953984,52,12,64
org.apache.html.dom.HTMLElementImpl,7,12,42,0.2857142857142857,1,0.14285714285714285,92,13.142857142857142,30,0.7142857142857143,0.06666666666666667,0.009523809523809523,0.07859649122807018,0.0023176558723256788,53,6,59
org.w3c.dom.html.HTMLPreElement,1,0,0,0,1,1.0,-1,-1.0,0,0,0.0,0.0,0.0015037593984962407,0.0,1,0,1
org.w3c.dom.html.HTMLBRElement,1,0,0,0,1,1.0,-1,-1.0,0,0,0.0,0.0,0.0015037593984962407,0.0,1,0,1
org.apache.html.dom.HTMLLabelElementImpl,5,6,20,0.3,1,0.2,94,18.8,14,0.7,0.0,0.0,0.0,0.0,0,4,4
org.apache.html.dom.HTMLUListElementImpl,4,5,12,0.4166666666666667,1,0.25,94,23.5,7,0.5833333333333334,0.0,0.0,0.0,0.0,0,3,3
org.apache.html.dom.HTMLOListElementImpl,4,5,12,0.4166666666666667,1,0.25,94,23.5,7,0.5833333333333334,0.0,0.0,0.0,0.0,0,3,3
org.w3c.dom.html.HTMLTableCellElement,1,0,0,0,1,1.0,-1,-1.0,0,0,0.0,0.0,0.031034641819272107,0.0,3,0,3
org.apache.wml.WMLRefreshElement,1,0,0,0,1,1.0,-1,-1.0,0,0,0.0,0.0,0.019562419562419563,0.0,1,0,1
