name,Size,Ties,Pairs,Density,WeakComp,nWeakComp,2StepReach,ReachEffic,Broker,nBroker,EgoBetween,nEgoBetween,Closeness_Centrality,Betweenness_Centrality,in_degree,out_degree,degree
org.gjt.sp.jedit.Registers,5,6,20,0.3,1,0.2,326,65.2,14,0.7,0.0,0.0,0.09030489771058006,0.0032869921201297307,3,4,7
gnu.regexp.RETokenRepeated,4,8,12,0.6666666666666666,1,0.25,2,0.5,4,0.3333333333333333,0.0,0.0,0.0904560119420234,0.0,1,3,4
gnu.regexp.REMatchEnumeration,4,8,12,0.6666666666666666,1,0.25,24,6.0,4,0.3333333333333333,0.0,0.0,0.08980358249498102,0.0,1,3,4
bsh.BSHType,8,23,56,0.4107142857142857,1,0.125,74,9.25,33,0.5892857142857143,0.0,0.0,0.0859731241023162,0.00012473105796799986,8,7,15
gnu.regexp.RETokenOneOf,5,12,20,0.6,1,0.2,3,0.6,8,0.4,0.0,0.0,0.0904560119420234,0.0,1,4,5
bsh.BSHArrayDimensions,8,29,56,0.5178571428571429,1,0.125,74,9.25,27,0.48214285714285715,0.0,0.0,0.08490089693097211,6.695821102609518e-06,2,7,9
org.gjt.sp.jedit.options.StyleTableModel,3,3,6,0.5,1,0.3333333333333333,1,0.3333333333333333,3,0.5,0.0,0.0,0.05541612471833953,0.0009113645923723857,2,2,4
gnu.regexp.CharIndexedString,2,1,2,0.5,1,0.5,0,0.0,1,0.5,0.0,0.0,0.0904560119420234,0.0,1,1,2
org.gjt.sp.jedit.gui.DockableWindowContainer,2,1,2,0.5,1,0.5,0,0.0,1,0.5,0.0,0.0,0.111263822228213,1.3686893157374633e-06,5,1,6
org.gjt.sp.jedit.textarea.TextRendererAWT,2,3,2,1.5,1,0.5,0,0.0,-1,-0.5,0.0,0.0,0.09807408528510349,0.0,1,1,2
org.gjt.sp.jedit.EditPlugin,4,7,12,0.5833333333333334,1,0.25,326,81.5,5,0.4166666666666667,0.5,0.125,0.0812025472782139,0.08400467544270256,11,3,14
bsh.BSHLHSPrimarySuffix,12,51,132,0.38636363636363635,1,0.08333333333333333,74,6.166666666666667,81,0.6136363636363636,0.0,0.0,0.0849972657129596,2.931859647439738e-05,2,11,13
org.gjt.sp.jedit.browser.VFSBrowser,21,48,420,0.11428571428571428,1,0.047619047619047616,347,16.523809523809526,372,0.8857142857142857,0.225,0.010714285714285714,0.026256251488449633,0.00979396524261476,10,20,30
org.gjt.sp.jedit.options.DockingOptionPane,4,3,12,0.25,1,0.25,326,81.5,9,0.75,0.0,0.0,0.05998698953080334,0.0035370842459558085,1,3,4
org.gjt.sp.jedit.options.WindowTableModel,5,5,20,0.25,1,0.2,326,65.2,15,0.75,0.0,0.0,0.05296429121779695,0.0017635561833277216,1,4,5
bsh.Interpreter,20,78,380,0.20526315789473684,1,0.05,74,3.7,302,0.7947368421052632,0.3535575048732943,0.017677875243664716,0.12225729158059985,0.046954417622615534,44,20,64
org.gjt.sp.jedit.gui.HelpViewer,16,29,240,0.12083333333333333,1,0.0625,338,21.125,211,0.8791666666666667,0.3285714285714286,0.02053571428571429,0.010121457489878543,0.006924883592973697,5,15,20
org.gjt.sp.jedit.msg.CreateDockableWindow,4,5,12,0.4166666666666667,1,0.25,326,81.5,7,0.5833333333333334,0.0,0.0,0.10959436870126482,0.0019414772713998302,3,3,6
org.gjt.sp.jedit.options.EditingOptionPane,3,2,6,0.3333333333333333,1,0.3333333333333333,326,108.66666666666667,4,0.6666666666666666,0.0,0.0,0.06002619671350322,0.00015366470474829629,1,2,3
org.gjt.sp.jedit.textarea.JEditTextArea,33,91,1056,0.08617424242424243,1,0.030303030303030304,326,9.878787878787879,965,0.9138257575757576,0.6278057795698925,0.019024417562724015,0.15155128873211207,0.04700542380906518,19,32,51
org.gjt.sp.jedit.GUIUtilities,14,23,182,0.12637362637362637,1,0.07142857142857142,365,26.071428571428573,159,0.8736263736263736,0.0,0.0,0.0,0.0,0,13,13
org.gjt.sp.jedit.EBComponent,2,2,2,1.0,1,0.5,0,0.0,0,0.0,0.0,0.0,0.16777665317139,1.0265169868030975e-05,20,1,21
org.gjt.sp.jedit.gui.KeyEventWorkaround,1,0,0,0,1,1.0,-1,-1.0,0,0,0.0,0.0,0.15024774910870747,0.0,5,0,5
org.gjt.sp.jedit.gui.PastePrevious,4,5,12,0.4166666666666667,1,0.25,327,81.75,7,0.5833333333333334,0.0,0.0,0.0,0.0,0,3,3
org.gjt.sp.jedit.EditPane,13,46,156,0.2948717948717949,1,0.07692307692307693,326,25.076923076923077,110,0.7051282051282052,0.27777777777777785,0.02136752136752137,0.13831337495731916,0.008232871537558193,3,12,15
org.gjt.sp.jedit.EBMessage,2,2,2,1.0,1,0.5,0,0.0,0,0.0,0.0,0.0,0.1683377791017291,1.6561140720423306e-05,19,1,20
org.gjt.sp.jedit.options.AbbrevsOptionPane,8,13,56,0.23214285714285715,1,0.125,326,40.75,43,0.7678571428571429,0.38095238095238093,0.047619047619047616,0.06102330961572088,0.012317011126662038,4,7,11
org.gjt.sp.jedit.gui.CloseDialog,5,7,20,0.35,1,0.2,329,65.8,13,0.65,0.5,0.1,0.006072874493927126,0.002726429116949027,3,4,7
org.gjt.sp.jedit.search.SearchDialog,16,34,240,0.14166666666666666,1,0.0625,326,20.375,206,0.8583333333333333,0.22142857142857145,0.013839285714285715,0.10754107842114745,0.011193483739746653,6,15,21
gnu.regexp.RETokenLookAhead,6,11,30,0.36666666666666664,1,0.16666666666666666,24,4.0,19,0.6333333333333333,0.0,0.0,0.08988597110277458,0.0,1,5,6
gnu.regexp.RESyntax,1,1,0,0,1,1.0,-1,-1.0,-1,0,0.0,0.0,0.10734899137093548,0.0,4,1,5
org.gjt.sp.jedit.search.AllBufferSet,3,3,6,0.5,1,0.3333333333333333,326,108.66666666666667,3,0.5,0.0,0.0,0.08639706582470359,0.0004063980750753463,1,2,3
bsh.ReturnControl,2,1,2,0.5,1,0.5,0,0.0,1,0.5,0.0,0.0,0.10132197518645507,2.0256601872914464e-05,9,1,10
org.gjt.sp.jedit.gui.EditAbbrevDialog,4,4,12,0.3333333333333333,1,0.25,2,0.5,8,0.6666666666666666,0.3333333333333333,0.08333333333333333,0.04843316485192916,0.0018193302729440223,2,3,5
org.gjt.sp.jedit.gui.SelectLineRange,5,7,20,0.35,1,0.2,326,65.2,13,0.65,0.0,0.0,0.11241135981843318,0.0015485350918253659,1,4,5
bsh.BSHSwitchStatement,9,27,72,0.375,1,0.1111111111111111,74,8.222222222222221,45,0.625,0.0,0.0,0.08480474642482153,7.566871075344542e-07,1,8,9
org.gjt.sp.jedit.io.FavoritesVFS,3,3,6,0.5,1,0.3333333333333333,327,109.0,3,0.5,0.0,0.0,0.0258200446170371,3.217953373323414e-05,5,2,7
org.gjt.sp.jedit.options.GeneralOptionPane,2,1,2,0.5,1,0.5,1,0.5,1,0.5,0.0,0.0,0.060158632992404634,5.719166069331531e-05,1,1,2
org.gjt.sp.jedit.gui.CurrentDirectoryMenu,5,4,20,0.2,1,0.2,328,65.6,16,0.8,0.0,0.0,0.0,0.0,0,4,4
org.gjt.sp.jedit.gui.JCheckBoxList,3,4,6,0.6666666666666666,1,0.3333333333333333,1,0.3333333333333333,2,0.3333333333333333,0.0,0.0,0.007422402159244263,8.21213589442478e-05,3,2,5
bsh.Node,1,1,0,0,1,1.0,-1,-1.0,-1,0,0.0,0.0,0.10051303472356105,0.0,4,1,5
org.gjt.sp.jedit.options.ColorOptionPane,5,6,20,0.3,1,0.2,16,3.2,14,0.7,0.16666666666666666,0.03333333333333333,0.06068279798568556,0.003629470774768087,2,4,6
org.gjt.sp.jedit.textarea.Gutter,5,8,20,0.4,1,0.2,326,65.2,12,0.6,0.125,0.025,0.11268721591614714,0.0014112653298091543,2,4,6
bsh.BSHBinaryExpression,11,47,110,0.42727272727272725,1,0.09090909090909091,74,6.7272727272727275,63,0.5727272727272728,0.0,0.0,0.08480474642482153,4.296647584661022e-06,1,10,11
bsh.This,9,39,72,0.5416666666666666,1,0.1111111111111111,74,8.222222222222221,33,0.4583333333333333,0.02827380952380952,0.0031415343915343914,0.11654877991146678,0.00012291496624794373,10,9,19
bsh.BSHTryStatement,11,48,110,0.43636363636363634,1,0.09090909090909091,74,6.7272727272727275,62,0.5636363636363636,0.0,0.0,0.08480474642482153,2.4635815367983484e-06,1,10,11
bsh.BSHWhileStatement,9,29,72,0.4027777777777778,1,0.1111111111111111,74,8.222222222222221,43,0.5972222222222222,0.0,0.0,0.08480474642482153,7.566871075344542e-07,1,8,9
org.gjt.sp.jedit.proto.jeditresource.Handler,2,1,2,0.5,1,0.5,328,164.0,1,0.5,0.0,0.0,0.0,0.0,0,1,1
org.gjt.sp.jedit.options.BrowserOptionPane,2,1,2,0.5,1,0.5,1,0.5,1,0.5,0.0,0.0,0.060158632992404634,5.719166069331531e-05,1,1,2
org.gjt.sp.jedit.textarea.TextRenderer,2,3,2,1.5,1,0.5,0,0.0,-1,-0.5,0.0,0.0,0.12626382905020675,0.0008828046086506639,6,2,8
org.gjt.sp.jedit.gui.EnhancedMenuItem,3,3,6,0.5,1,0.3333333333333333,328,109.33333333333333,3,0.5,0.0,0.0,0.004048582995951417,0.0013399468401069767,2,2,4
org.gjt.sp.jedit.browser.BrowserListener,2,2,2,1.0,1,0.5,347,173.5,0,0.0,0.0,0.0,0.017854251012145748,0.0,2,1,3
bsh.Primitive,6,8,30,0.26666666666666666,1,0.16666666666666666,74,12.333333333333334,22,0.7333333333333333,0.0,0.0,0.12097349126513313,0.001973685571689206,37,6,43
bsh.Reflect,14,61,182,0.33516483516483514,1,0.07142857142857142,74,5.285714285714286,121,0.6648351648351648,0.17115384615384616,0.012225274725274725,0.11573816243140249,0.0041532426198601135,12,13,25
gnu.regexp.CharUnit,1,0,0,0,1,1.0,-1,-1.0,0,0,0.0,0.0,0.0904560119420234,0.0,1,0,1
org.gjt.sp.util.WorkThreadPool,5,9,20,0.45,1,0.2,4,0.8,11,0.55,0.9166666666666666,0.18333333333333332,0.09105549117288503,0.001289139137436351,7,4,11
bsh.Capabilities,1,0,0,0,1,1.0,-1,-1.0,0,0,0.0,0.0,0.1156966419115273,0.0,5,0,5
org.gjt.sp.jedit.gui.FontSelectorDialog,4,5,12,0.4166666666666667,1,0.25,5,1.25,7,0.5833333333333334,0.6666666666666666,0.16666666666666666,0.0452280059710117,0.0019216397992953987,3,3,6
bsh.ClassPathException,2,1,2,0.5,1,0.5,74,37.0,1,0.5,0.0,0.0,0.11493874304392541,0.0,2,1,3
org.gjt.sp.jedit.gui.EnhancedDialog,4,6,12,0.5,1,0.25,2,0.5,6,0.5,1.0,0.25,0.12899957267404724,0.0029686871258345583,19,3,22
org.gjt.sp.jedit.browser.BrowserView,13,36,156,0.23076923076923078,1,0.07692307692307693,347,26.692307692307693,120,0.7692307692307693,0.35984848484848486,0.02768065268065268,0.02349243554229704,0.0033604809600325776,7,12,19
org.gjt.sp.jedit.options.PrintOptionPane,3,2,6,0.3333333333333333,1,0.3333333333333333,10,3.3333333333333335,4,0.6666666666666666,0.0,0.0,0.060158632992404634,0.0014737851024815918,1,2,3
com.microstar.xml.XmlException,1,0,0,0,1,1.0,-1,-1.0,0,0,0.0,0.0,0.023057945344129555,0.0,5,0,5
org.gjt.sp.jedit.msg.PropertiesChanged,3,3,6,0.5,1,0.3333333333333333,2,0.6666666666666666,3,0.5,0.0,0.0,0.1527256234617719,0.0002839391107123163,8,2,10
org.gjt.sp.jedit.AbstractOptionPane,2,1,2,0.5,1,0.5,0,0.0,1,0.5,0.0,0.0,0.06808528691604644,0.00015192451404685844,17,1,18
gnu.regexp.REToken,3,5,6,0.8333333333333334,1,0.3333333333333333,1,0.3333333333333333,1,0.16666666666666666,0.0,0.0,0.09819838056680162,0.0,14,3,17
org.gjt.sp.jedit.syntax.XModeHandler,10,22,90,0.24444444444444444,1,0.1,331,33.1,68,0.7555555555555555,0.0,0.0,0.0020242914979757085,8.554308223359145e-06,1,9,10
org.gjt.sp.jedit.Macros,11,22,110,0.2,1,0.09090909090909091,331,30.09090909090909,88,0.8,0.0,0.0,0.0,0.0,0,10,10
org.gjt.sp.jedit.syntax.TokenMarker,8,15,56,0.26785714285714285,1,0.125,326,40.75,41,0.7321428571428571,0.14285714285714285,0.017857142857142856,0.12971762849104507,0.009855765564637135,5,7,12
org.gjt.sp.jedit.options.ColorTableModel,2,1,2,0.5,1,0.5,0,0.0,1,0.5,0.0,0.0,0.05375375306178409,0.0008869106765978763,2,1,3
bsh.ParserTreeConstants,1,0,0,0,1,1.0,-1,-1.0,0,0,0.0,0.0,0.09984673795673832,0.0,2,0,2
org.gjt.sp.jedit.search.SearchAndReplace,15,33,210,0.15714285714285714,1,0.06666666666666667,326,21.733333333333334,177,0.8428571428571429,0.0,0.0,0.10830198227790086,0.02832064516869518,9,14,23
bsh.ParserTokenManager,5,5,20,0.25,1,0.2,3,0.6,15,0.75,0.0,0.0,0.08528457945315522,2.053033973606195e-06,1,4,5
gnu.regexp.CharIndexedStringBuffer,2,1,2,0.5,1,0.5,0,0.0,1,0.5,0.0,0.0,0.0904560119420234,0.0,1,1,2
org.gjt.sp.jedit.EditBus,3,4,6,0.6666666666666666,1,0.3333333333333333,1,0.3333333333333333,2,0.3333333333333333,0.0,0.0,0.0020242914979757085,1.7108616446718293e-06,1,2,3
org.gjt.sp.jedit.gui.VariableGridLayout,1,0,0,0,1,1.0,-1,-1.0,0,0,0.0,0.0,0.08680192269784226,0.0,1,0,1
org.gjt.sp.jedit.options.GutterOptionPane,3,2,6,0.3333333333333333,1,0.3333333333333333,10,3.3333333333333335,4,0.6666666666666666,0.0,0.0,0.060158632992404634,0.0014737851024815918,1,2,3
org.gjt.sp.jedit.options.StyleOptionPane,5,7,20,0.35,1,0.2,11,2.2,13,0.65,0.41666666666666663,0.08333333333333333,0.06267723985436602,0.004643122082003261,4,4,8
bsh.BSHArrayInitializer,7,22,42,0.5238095238095238,1,0.14285714285714285,74,10.571428571428571,20,0.47619047619047616,0.0,0.0,0.08509385351490614,2.0895972753385704e-05,3,6,9
org.gjt.sp.jedit.pluginmgr.PluginListHandler,7,16,42,0.38095238095238093,1,0.14285714285714285,344,49.142857142857146,26,0.6190476190476191,0.03333333333333333,0.0047619047619047615,0.009071824861298544,6.159101920818585e-05,1,6,7
bsh.ASCII_UCodeESC_CharStream,1,0,0,0,1,1.0,-1,-1.0,0,0,0.0,0.0,0.101452408879856,0.0,3,0,3
org.gjt.sp.jedit.BeanShellAction,4,6,12,0.5,1,0.25,327,81.75,6,0.5,0.0,0.0,0.002699055330634278,0.0013467902866856638,1,3,4
org.gjt.sp.jedit.gui.BufferSwitcher,4,5,12,0.4166666666666667,1,0.25,326,81.5,7,0.5833333333333334,0.6666666666666666,0.16666666666666666,0.1050801841781006,0.003079550960409293,2,3,5
gnu.regexp.RETokenEnd,5,13,20,0.65,1,0.2,24,4.8,7,0.35,0.0,0.0,0.08980358249498102,0.0,1,4,5
org.gjt.sp.jedit.View,22,68,462,0.1471861471861472,1,0.045454545454545456,326,14.818181818181818,394,0.8528138528138528,0.6035714285714286,0.027435064935064937,0.2005241942612662,0.1425125275563218,55,22,77
org.gjt.sp.jedit.io.VFS,6,13,30,0.43333333333333335,1,0.16666666666666666,326,54.333333333333336,17,0.5666666666666667,0.30000000000000004,0.05000000000000001,0.13214400139807184,0.01826965025024249,18,5,23
bsh.LHS,10,37,90,0.4111111111111111,1,0.1,74,7.4,53,0.5888888888888889,0.08611111111111111,0.008611111111111111,0.10071632964777055,0.00022618613015751903,8,9,17
gnu.regexp.RETokenEndSub,4,8,12,0.6666666666666666,1,0.25,2,0.5,4,0.3333333333333333,0.0,0.0,0.0904560119420234,0.0,1,3,4
gnu.regexp.RETokenRange,4,8,12,0.6666666666666666,1,0.25,2,0.5,4,0.3333333333333333,0.0,0.0,0.0904560119420234,0.0,1,3,4
org.gjt.sp.jedit.options.ContextAddDialog,5,6,20,0.3,1,0.2,12,2.4,14,0.7,0.25,0.05,0.05048444929931495,0.001010092715014248,2,4,6
org.gjt.sp.jedit.gui.RecentFilesMenu,6,7,30,0.23333333333333334,1,0.16666666666666666,335,55.833333333333336,23,0.7666666666666667,0.0,0.0,0.0,0.0,0,5,5
bsh.commands.dir,3,6,6,1.0,1,0.3333333333333333,75,25.0,0,0.0,0.0,0.0,0.0,0.0,0,2,2
gnu.regexp.REException,2,2,2,1.0,1,0.5,24,12.0,0,0.0,0.0,0.0,0.1360773729194782,0.009606209508793047,4,1,5
bsh.BSHLHSPrimaryExpression,8,29,56,0.5178571428571429,1,0.125,74,9.25,27,0.48214285714285715,0.0,0.0,0.0849972657129596,2.1458113008063587e-05,3,7,10
bsh.BshClassManager,4,5,12,0.4166666666666667,1,0.25,74,18.5,7,0.5833333333333334,0.0,0.0,0.11895566496126672,0.0007027437528131453,8,4,12
bsh.Name,16,90,240,0.375,1,0.0625,74,4.625,150,0.625,0.04023809523809524,0.0025148809523809525,0.11627731536198356,0.0008787750567357892,6,15,21
org.gjt.sp.jedit.gui.OpenWithEncodingMenu,2,1,2,0.5,1,0.5,0,0.0,1,0.5,0.0,0.0,0.0020242914979757085,0.0,1,1,2
gnu.regexp.REMatch,2,2,2,1.0,1,0.5,0,0.0,0,0.0,0.0,0.0,0.11740890688259109,0.00017315875114529966,19,2,21
gnu.regexp.REFilterReader,5,10,20,0.5,1,0.2,25,5.0,10,0.5,0.0,0.0,0.0,0.0,0,4,4
org.gjt.sp.jedit.gui.CheckBoxListModel,3,4,6,0.6666666666666666,1,0.3333333333333333,1,0.3333333333333333,2,0.3333333333333333,0.0,0.0,0.005696262122210714,0.0,1,2,3
org.gjt.sp.jedit.search.SearchMatcher,1,0,0,0,1,1.0,-1,-1.0,0,0,0.0,0.0,0.09912380772661772,0.0,4,0,4
bsh.ParseException,2,2,2,1.0,1,0.5,0,0.0,0,0.0,0.0,0.0,0.10078050838519144,7.783926445623786e-06,2,1,3
bsh.Token,1,1,0,0,1,1.0,-1,-1.0,-1,0,0.0,0.0,0.14644105332364443,0.0,7,1,8
bsh.JThis,7,27,42,0.6428571428571429,1,0.14285714285714285,75,10.714285714285714,15,0.35714285714285715,0.0,0.0,0.0,0.0,0,6,6
org.gjt.sp.jedit.msg.EditorExitRequested,3,3,6,0.5,1,0.3333333333333333,327,109.0,3,0.5,0.0,0.0,0.0020242914979757085,8.212135894424781e-07,1,2,3
org.gjt.sp.jedit.browser.BrowserIORequest,4,4,12,0.3333333333333333,1,0.25,347,86.75,8,0.6666666666666666,0.3333333333333333,0.08333333333333333,0.016531713900134953,0.00020366097018173455,1,3,4
org.gjt.sp.jedit.gui.DockableWindowManager,10,26,90,0.28888888888888886,1,0.1,326,32.6,64,0.7111111111111111,0.5046296296296295,0.05046296296296295,0.14394997017501557,0.022658558746687284,12,9,21
bsh.BSHArguments,5,13,20,0.65,1,0.2,74,14.8,7,0.35,0.0,0.0,0.0852876891721155,2.4342861413290546e-07,5,4,9
org.gjt.sp.jedit.textarea.ScrollListener,2,2,2,1.0,1,0.5,326,163.0,0,0.0,0.0,0.0,0.11241135981843318,0.0,2,1,3
org.gjt.sp.jedit.gui.AbbrevEditor,1,0,0,0,1,1.0,-1,-1.0,0,0,0.0,0.0,0.07747772282982335,0.0,3,0,3
org.gjt.sp.jedit.gui.EnhancedButton,3,3,6,0.5,1,0.3333333333333333,328,109.33333333333333,3,0.5,0.0,0.0,0.0020242914979757085,1.3686893157374633e-06,1,2,3
org.gjt.sp.jedit.options.ToolBarOptionPane,9,14,72,0.19444444444444445,1,0.1111111111111111,22,2.4444444444444446,58,0.8055555555555556,0.23214285714285712,0.025793650793650792,0.06222666827283154,0.008153639090705418,4,8,12
bsh.ReflectError,1,0,0,0,1,1.0,-1,-1.0,0,0,0.0,0.0,0.09796650717703351,0.0,7,0,7
org.gjt.sp.jedit.ActionListHandler,3,2,6,0.3333333333333333,1,0.3333333333333333,331,110.33333333333333,4,0.6666666666666666,0.0,0.0,0.0020242914979757085,5.474757262949853e-06,1,2,3
org.gjt.sp.jedit.gui.MarkersMenu,5,4,20,0.2,1,0.2,329,65.8,16,0.8,0.0,0.0,0.0,0.0,0,4,4
org.gjt.sp.jedit.browser.VFSFileChooserDialog,11,26,110,0.23636363636363636,1,0.09090909090909091,351,31.90909090909091,84,0.7636363636363637,0.2388888888888889,0.021717171717171718,0.008097165991902834,0.002729155089836204,4,10,14
org.gjt.sp.jedit.search.HyperSearchResult,2,2,2,1.0,1,0.5,327,163.5,0,0.0,0.0,0.0,0.004048582995951417,0.001218458366712056,2,1,3
org.gjt.sp.jedit.gui.HistoryTextField,6,9,30,0.3,1,0.16666666666666666,7,1.1666666666666667,21,0.7,0.6000000000000001,0.10000000000000002,0.14687498050566739,0.003643108786164194,9,5,14
bsh.BSHImportDeclaration,9,43,72,0.5972222222222222,1,0.1111111111111111,74,8.222222222222221,29,0.4027777777777778,0.0,0.0,0.08480474642482153,2.5394545314750994e-06,1,8,9
bsh.BSHAssignment,10,36,90,0.4,1,0.1,74,7.4,54,0.6,0.0,0.0,0.08480474642482153,1.384003043914125e-06,1,9,10
org.gjt.sp.jedit.gui.BeanShellErrorDialog,4,4,12,0.3333333333333333,1,0.25,326,81.5,8,0.6666666666666666,0.0,0.0,0.08063220454052672,0.000977244171436549,1,3,4
org.gjt.sp.jedit.options.LoadSaveOptionPane,2,1,2,0.5,1,0.5,1,0.5,1,0.5,0.0,0.0,0.0,0.0,0,1,1
bsh.SimpleNode,8,22,56,0.39285714285714285,1,0.125,74,9.25,34,0.6071428571428571,0.3571428571428571,0.04464285714285714,0.12087585325765521,0.0046422651089890925,45,8,53
bsh.BSHForStatement,11,42,110,0.38181818181818183,1,0.09090909090909091,74,6.7272727272727275,68,0.6181818181818182,0.0,0.0,0.08480474642482153,8.987720583523096e-05,1,10,11
bsh.BSHVariableDeclarator,8,26,56,0.4642857142857143,1,0.125,74,9.25,30,0.5357142857142857,0.0,0.0,0.08490089693097211,4.349496561345296e-06,2,7,9
org.gjt.sp.util.WorkThreadProgressListener,2,2,2,1.0,1,0.5,4,2.0,0,0.0,0.0,0.0,0.09013404646000395,0.0,3,1,4
org.gjt.sp.jedit.syntax.ParserRuleSet,4,4,12,0.3333333333333333,1,0.25,326,81.5,8,0.6666666666666666,0.0,0.0,0.12755566801619433,0.004286255895629227,5,3,8
org.gjt.sp.jedit.gui.IOProgressMonitor,4,6,12,0.5,1,0.25,326,81.5,6,0.5,0.16666666666666666,0.041666666666666664,0.08535323510377316,0.006824487692210534,3,3,6
org.gjt.sp.jedit.pluginmgr.PluginListDownloadProgress,6,10,30,0.3333333333333333,1,0.16666666666666666,359,59.833333333333336,20,0.6666666666666666,0.47500000000000003,0.07916666666666668,0.008097165991902834,0.00417619698072351,4,5,9
org.gjt.sp.jedit.msg.BufferUpdate,4,9,12,0.75,1,0.25,326,81.5,3,0.25,0.3333333333333333,0.08333333333333333,0.14933346499456898,0.0038171221853895362,9,3,12
org.gjt.sp.jedit.search.SearchFileSet,3,6,6,1.0,1,0.3333333333333333,326,108.66666666666667,0,0.0,0.0,0.0,0.08805376890859053,0.00014832533478639038,5,2,7
bsh.Parser,48,206,2256,0.09131205673758866,1,0.020833333333333332,74,1.5416666666666667,2050,0.9086879432624113,0.5870336108541474,0.012229866892794738,0.10011041589988959,0.03652567987105234,1,47,48
org.gjt.sp.jedit.syntax.ParserRuleFactory,4,5,12,0.4166666666666667,1,0.25,326,81.5,7,0.5833333333333334,0.0,0.0,0.098752775238344,0.00014001691699994256,2,3,5
bsh.TokenMgrError,1,0,0,0,1,1.0,-1,-1.0,0,0,0.0,0.0,0.10138472882056325,0.0,2,0,2
org.gjt.sp.jedit.BufferHistory,9,15,72,0.20833333333333334,1,0.1111111111111111,333,37.0,57,0.7916666666666666,0.20535714285714285,0.022817460317460316,0.008097165991902834,0.0011195878602732452,4,8,12
bsh.BSHThrowStatement,6,18,30,0.6,1,0.16666666666666666,74,12.333333333333334,12,0.4,0.0,0.0,0.08480474642482153,6.540354088541445e-07,1,5,6
org.gjt.sp.jedit.options.ToolBarAddDialog,8,12,56,0.21428571428571427,1,0.125,22,2.75,44,0.7857142857142857,0.14285714285714285,0.017857142857142856,0.04868543985313642,0.0019380640710842483,2,7,9
bsh.BSHTernaryExpression,6,18,30,0.6,1,0.16666666666666666,74,12.333333333333334,12,0.4,0.0,0.0,0.08480474642482153,2.4342861413290546e-07,1,5,6
org.gjt.sp.jedit.search.DirectoryListSet,4,3,12,0.25,1,0.25,326,81.5,9,0.75,0.0,0.0,0.08755012485382262,0.0011824260346789985,3,3,6
org.gjt.sp.jedit.gui.StatusBar,7,12,42,0.2857142857142857,1,0.14285714285714285,326,46.57142857142857,30,0.7142857142857143,0.6,0.08571428571428572,0.13789801947696687,0.011931847225273075,3,6,9
bsh.XThis,5,16,20,0.8,1,0.2,76,15.2,4,0.2,0.027777777777777776,0.005555555555555555,0.0020242914979757085,3.171937489221571e-05,1,4,5
org.gjt.sp.jedit.Mode,3,3,6,0.5,1,0.3333333333333333,326,108.66666666666667,3,0.5,0.5,0.16666666666666666,0.13290894496622277,0.008726064067955813,15,2,17
bsh.BSHLiteral,7,21,42,0.5,1,0.14285714285714285,74,10.571428571428571,21,0.5,0.0,0.0,0.08480474642482153,6.996583860453932e-07,1,6,7
org.gjt.sp.jedit.browser.FileCellRenderer,5,9,20,0.45,1,0.2,347,69.4,11,0.55,0.0,0.0,0.015391595700125646,0.0,1,4,5
org.gjt.sp.jedit.options.AbbrevsModel,3,3,6,0.5,1,0.3333333333333333,2,0.6666666666666666,3,0.5,0.0,0.0,0.05399211033272892,0.0017738213531957527,3,2,5
org.gjt.sp.jedit.TextUtilities,4,8,12,0.6666666666666666,1,0.25,326,81.5,4,0.3333333333333333,0.0,0.0,0.12990110462752466,0.017557107198934895,5,3,8
org.gjt.sp.jedit.options.TextAreaOptionPane,3,2,6,0.3333333333333333,1,0.3333333333333333,10,3.3333333333333335,4,0.6666666666666666,0.0,0.0,0.060158632992404634,0.0014737851024815918,1,2,3
gnu.regexp.CharIndexedReader,2,1,2,0.5,1,0.5,0,0.0,1,0.5,0.0,0.0,0.09053884711779449,0.0,2,1,3
bsh.EvalError,2,3,2,1.5,1,0.5,74,37.0,-1,-0.5,0.0,0.0,0.12367067067401719,0.001259380538082803,51,1,52
org.gjt.sp.jedit.syntax.KeywordMap,4,5,12,0.4166666666666667,1,0.25,326,81.5,7,0.5833333333333334,0.0,0.0,0.10081238306439069,0.015390158576344121,3,3,6
org.gjt.sp.jedit.browser.BrowserPopupMenu,5,5,20,0.25,1,0.2,347,69.4,15,0.75,0.25,0.05,0.017854251012145748,0.002568001480786098,3,4,7
org.gjt.sp.jedit.JARClassLoader,5,8,20,0.4,1,0.2,326,65.2,12,0.6,0.41666666666666663,0.08333333333333333,0.09174833263902091,0.055777374470659405,6,4,10
org.gjt.sp.jedit.gui.DefaultInputHandler,4,9,12,0.75,1,0.25,326,81.5,3,0.25,0.08333333333333333,0.020833333333333332,0.13727964270801182,0.00030172755965432376,2,3,5
org.gjt.sp.jedit.gui.GrabKeyDialog,4,6,12,0.5,1,0.25,3,0.75,6,0.5,0.5,0.125,0.05573721271714807,0.0018114603093785328,6,3,9
bsh.ConsoleInterface,1,0,0,0,1,1.0,-1,-1.0,0,0,0.0,0.0,0.10071323167732416,0.0,1,0,1
bsh.BSHBlock,9,32,72,0.4444444444444444,1,0.1111111111111111,74,8.222222222222221,40,0.5555555555555556,0.0,0.0,0.09656040115166654,0.0010271100262750554,5,8,13
bsh.BSHFormalParameters,6,19,30,0.6333333333333333,1,0.16666666666666666,74,12.333333333333334,11,0.36666666666666664,0.0,0.0,0.09631201426767512,0.0002647989305009095,3,5,8
bsh.ReflectManager,3,4,6,0.6666666666666666,1,0.3333333333333333,74,24.666666666666668,2,0.3333333333333333,0.0,0.0,0.09631201426767512,0.001420699509735487,3,3,6
org.gjt.sp.jedit.pluginmgr.PluginManager,9,17,72,0.2361111111111111,1,0.1111111111111111,359,39.888888888888886,55,0.7638888888888888,0.21428571428571427,0.023809523809523808,0.008097165991902834,0.007997492821876295,3,8,11
bsh.BSHPrimaryExpression,7,24,42,0.5714285714285714,1,0.14285714285714285,74,10.571428571428571,18,0.42857142857142855,0.0,0.0,0.08480474642482153,2.4342861413290546e-07,1,6,7
org.gjt.sp.jedit.search.CurrentBufferSet,4,9,12,0.75,1,0.25,326,81.5,3,0.25,0.0,0.0,0.10703972141219105,0.0004898593786235924,3,3,6
org.gjt.sp.jedit.search.SearchBar,10,26,90,0.28888888888888886,1,0.1,326,32.6,64,0.7111111111111111,0.5625,0.05625,0.13831337495731916,0.03250075972217308,4,9,13
org.gjt.sp.jedit.textarea.MarkerHighlight,4,7,12,0.5833333333333334,1,0.25,326,81.5,5,0.4166666666666667,0.0,0.0,0.1050801841781006,0.00016067434931532303,1,3,4
org.gjt.sp.jedit.gui.AboutDialog,4,4,12,0.3333333333333333,1,0.25,328,82.0,8,0.6666666666666666,0.0,0.0,0.0,0.0,0,3,3
org.gjt.sp.jedit.BeanShell,13,38,156,0.24358974358974358,1,0.07692307692307693,326,25.076923076923077,118,0.7564102564102564,0.0,0.0,0.098752775238344,0.08355497019475468,5,12,17
org.gjt.sp.jedit.msg.EditPaneUpdate,3,3,6,0.5,1,0.3333333333333333,326,108.66666666666667,3,0.5,0.5,0.16666666666666666,0.13789801947696687,0.0001240441121447272,2,2,4
bsh.BSHTypedVariableDeclaration,10,46,90,0.5111111111111111,1,0.1,74,7.4,44,0.4888888888888889,0.0,0.0,0.08480474642482153,1.5397162486755612e-06,1,9,10
org.gjt.sp.jedit.EditAction,3,6,6,1.0,1,0.3333333333333333,326,108.66666666666667,0,0.0,0.0,0.0,0.11394550989039692,0.016929564036428563,13,2,15
org.gjt.sp.jedit.gui.MacrosMenu,6,8,30,0.26666666666666666,1,0.16666666666666666,331,55.166666666666664,22,0.7333333333333333,0.0,0.0,0.0020242914979757085,9.033349483867259e-06,1,5,6
org.gjt.sp.jedit.options.ModeOptionPane,5,7,20,0.35,1,0.2,326,65.2,13,0.65,0.125,0.025,0.06046088279898613,0.0025618735557883607,2,4,6
org.gjt.sp.jedit.gui.OptionsDialog,22,31,462,0.0670995670995671,1,0.045454545454545456,326,14.818181818181818,431,0.9329004329004329,0.045238095238095244,0.0020562770562770564,0.06920880254081381,0.06507760007176946,3,21,24
org.gjt.sp.jedit.ModeCatalogHandler,3,2,6,0.3333333333333333,1,0.3333333333333333,330,110.0,4,0.6666666666666666,0.0,0.0,0.0020242914979757085,1.3686893157374633e-06,1,2,3
org.gjt.sp.jedit.textarea.TextAreaHighlight,2,1,2,0.5,1,0.5,326,163.0,1,0.5,0.0,0.0,0.09030489771058006,4.264444853747725e-05,3,1,4
org.gjt.sp.jedit.EBPlugin,4,5,12,0.4166666666666667,1,0.25,326,81.5,7,0.5833333333333334,0.0,0.0,0.0691046508439879,0.00013892196554735251,3,3,6
org.gjt.sp.jedit.MiscUtilities,3,3,6,0.5,1,0.3333333333333333,1,0.3333333333333333,3,0.5,0.0,0.0,0.1516386825960607,0.001556972083821663,22,2,24
gnu.regexp.RETokenStart,4,8,12,0.6666666666666666,1,0.25,2,0.5,4,0.3333333333333333,0.0,0.0,0.0904560119420234,0.0,1,3,4
org.gjt.sp.jedit.textarea.TextRenderer2D,2,2,2,1.0,1,0.5,1,0.5,0,0.0,0.0,0.0,0.0,0.0,0,1,1
org.gjt.sp.jedit.search.BoyerMooreSearchMatcher,3,3,6,0.5,1,0.3333333333333333,76,25.333333333333332,3,0.5,0.0,0.0,0.08729232904076793,0.00037735314943643326,1,2,3
org.gjt.sp.jedit.options.StyleEditor,3,2,6,0.3333333333333333,1,0.3333333333333333,4,1.3333333333333333,4,0.6666666666666666,0.0,0.0,0.049308358581793804,9.854563073309737e-05,1,2,3
org.gjt.sp.jedit.proto.jeditresource.PluginResURLConnection,4,6,12,0.5,1,0.25,327,81.75,6,0.5,0.0,0.0,0.0020242914979757085,0.001346790286685664,1,3,4
org.gjt.sp.jedit.Buffer,28,76,756,0.10052910052910052,1,0.03571428571428571,326,11.642857142857142,680,0.8994708994708994,0.3183760683760684,0.011370573870573872,0.16637695828199262,0.14823340195939474,25,28,53
org.gjt.sp.jedit.gui.BufferOptions,6,10,30,0.3333333333333333,1,0.16666666666666666,326,54.333333333333336,20,0.6666666666666666,0.15000000000000002,0.025000000000000005,0.08472332192957557,0.002579257179825138,2,5,7
gnu.regexp.CharIndexed,1,0,0,0,1,1.0,-1,-1.0,0,0,0.0,0.0,0.10464213091029001,0.0,24,0,24
bsh.InterpreterError,1,0,0,0,1,1.0,-1,-1.0,0,0,0.0,0.0,0.11795810871980578,0.0,16,0,16
org.gjt.sp.jedit.gui.HistoryModel,2,2,2,1.0,1,0.5,2,1.0,0,0.0,0.0,0.0,0.11147442543429614,6.70657764711357e-05,4,2,6
com.microstar.xml.XmlHandler,1,0,0,0,1,1.0,-1,-1.0,0,0,0.0,0.0,0.020882164926486254,0.0,2,0,2
org.gjt.sp.jedit.syntax.ParserRule,1,0,0,0,1,1.0,-1,-1.0,0,0,0.0,0.0,0.12857760532773305,0.0,6,0,6
org.gjt.sp.jedit.options.ShortcutsOptionPane,9,18,72,0.25,1,0.1111111111111111,326,36.22222222222222,54,0.75,0.25595238095238093,0.028439153439153438,0.06086155133973487,0.011791102033442129,4,8,12
org.gjt.sp.jedit.gui.ViewRegisters,8,13,56,0.23214285714285715,1,0.125,330,41.25,43,0.7678571428571429,0.23809523809523808,0.02976190476190476,0.004048582995951417,0.0021670979341524873,2,7,9
org.gjt.sp.jedit.gui.EnhancedMenu,1,0,0,0,1,1.0,-1,-1.0,0,0,0.0,0.0,0.01417004048582996,0.0,7,0,7
org.gjt.sp.jedit.gui.DockableWindow,1,0,0,0,1,1.0,-1,-1.0,0,0,0.0,0.0,0.12035588680325522,0.0,12,0,12
org.gjt.sp.jedit.Autosave,1,0,0,0,1,1.0,-1,-1.0,0,0,0.0,0.0,0.0020242914979757085,0.0,1,0,1
org.gjt.sp.jedit.gui.CompleteWord,4,6,12,0.5,1,0.25,326,81.5,6,0.5,0.6666666666666666,0.16666666666666666,0.11324300982942039,0.004405810907358895,3,3,6
bsh.BSHMethodDeclaration,10,48,90,0.5333333333333333,1,0.1,74,7.4,42,0.4666666666666667,0.1111111111111111,0.01111111111111111,0.09618829941312447,0.000266167619816647,2,9,11
org.gjt.sp.jedit.options.ContextOptionPane,6,9,30,0.3,1,0.16666666666666666,12,2.0,21,0.7,0.35000000000000003,0.05833333333333334,0.06477863056810425,0.005595558759592078,6,5,11
bsh.BSHSwitchLabel,5,13,20,0.65,1,0.2,74,14.8,7,0.35,0.0,0.0,0.08490089693097211,2.4342861413290546e-07,2,4,6
org.gjt.sp.jedit.io.UrlVFS,2,1,2,0.5,1,0.5,327,163.5,1,0.5,0.0,0.0,0.002699055330634278,0.0,1,1,2
org.gjt.sp.util.WorkThread,4,6,12,0.5,1,0.25,4,1.0,6,0.5,0.3333333333333333,0.08333333333333333,0.09530710943776681,0.0008985738648384103,5,3,8
bsh.BSHPrimarySuffix,14,66,182,0.3626373626373626,1,0.07142857142857142,74,5.285714285714286,116,0.6373626373626373,0.0,0.0,0.08490089693097211,5.212908038560028e-05,2,13,15
org.gjt.sp.jedit.Abbrevs,6,7,30,0.23333333333333334,1,0.16666666666666666,326,54.333333333333336,23,0.7666666666666667,0.0,0.0,0.1155221144297609,0.009498199035937903,4,5,9
bsh.BSHPrimitiveType,2,2,2,1.0,1,0.5,74,37.0,0,0.0,0.0,0.0,0.08562903498355334,0.0,3,1,4
org.gjt.sp.jedit.io.BufferIORequest,5,9,20,0.45,1,0.2,326,65.2,11,0.55,0.3333333333333333,0.06666666666666667,0.12495249111790464,0.0022690718057430982,2,4,6
org.gjt.sp.jedit.search.BufferListSet,4,9,12,0.75,1,0.25,326,81.5,3,0.25,0.0,0.0,0.07306291246750989,0.002451680071628135,2,3,5
org.gjt.sp.jedit.gui.FontSelector,2,2,2,1.0,1,0.5,7,3.5,0,0.0,0.0,0.0,0.055035714616589,0.0036133397935469037,5,1,6
org.gjt.sp.jedit.textarea.Selection,2,3,2,1.5,1,0.5,326,163.0,-1,-0.5,0.0,0.0,0.11989566706483018,0.0036945687864010897,15,2,17
org.gjt.sp.jedit.syntax.Token,1,0,0,0,1,1.0,-1,-1.0,0,0,0.0,0.0,0.13243493348756505,0.0,9,0,9
org.gjt.sp.jedit.textarea.TextAreaPainter,8,23,56,0.4107142857142857,1,0.125,326,40.75,33,0.5892857142857143,0.09523809523809523,0.011904761904761904,0.11366346654908407,0.0024499245461132935,6,7,13
bsh.BSHIfStatement,7,19,42,0.4523809523809524,1,0.14285714285714285,74,10.571428571428571,23,0.5476190476190477,0.0,0.0,0.08509385351490614,8.284478344090502e-06,4,6,10
org.gjt.sp.jedit.syntax.SyntaxStyle,1,0,0,0,1,1.0,-1,-1.0,0,0,0.0,0.0,0.131934458588249,0.0,9,0,9
org.gjt.sp.jedit.Marker,2,3,2,1.5,1,0.5,326,163.0,-1,-0.5,0.0,0.0,0.120525040645223,0.0003398953276181844,2,1,3
gnu.regexp.RE,26,80,650,0.12307692307692308,1,0.038461538461538464,24,0.9230769230769231,570,0.8769230769230769,0.14333333333333334,0.005512820512820513,0.11235746387846822,0.019884337931738372,8,25,33
org.gjt.sp.jedit.msg.EditorExiting,3,3,6,0.5,1,0.3333333333333333,2,0.6666666666666666,3,0.5,0.0,0.0,0.0020242914979757085,1.50555824731121e-06,1,2,3
gnu.regexp.RETokenPOSIX,4,8,12,0.6666666666666666,1,0.25,2,0.5,4,0.3333333333333333,0.0,0.0,0.0904560119420234,0.0,1,3,4
gnu.regexp.REFilterInputStream,5,10,20,0.5,1,0.2,25,5.0,10,0.5,0.0,0.0,0.0,0.0,0,4,4
org.gjt.sp.jedit.msg.SearchSettingsChanged,3,3,6,0.5,1,0.3333333333333333,2,0.6666666666666666,3,0.5,0.0,0.0,0.13919587603798128,0.00015532843936158345,2,2,4
gnu.regexp.RETokenAny,4,8,12,0.6666666666666666,1,0.25,2,0.5,4,0.3333333333333333,0.0,0.0,0.0904560119420234,0.0,1,3,4
bsh.NameSpace,19,85,342,0.24853801169590642,1,0.05263157894736842,74,3.8947368421052633,257,0.7514619883040936,0.38208061002178645,0.02010950579062034,0.14359077870204678,0.04224724888965573,34,19,53
bsh.ParserConstants,1,0,0,0,1,1.0,-1,-1.0,0,0,0.0,0.0,0.10199003633205392,0.0,13,0,13
org.gjt.sp.jedit.msg.MacrosChanged,3,3,6,0.5,1,0.3333333333333333,2,0.6666666666666666,3,0.5,0.0,0.0,0.004554655870445344,1.0059866470670358e-05,2,2,4
org.gjt.sp.jedit.search.CharIndexedSegment,2,1,2,0.5,1,0.5,0,0.0,1,0.5,0.0,0.0,0.09656713900134953,0.00017315875114529966,1,1,2
org.gjt.sp.jedit.pluginmgr.PluginManagerProgress,4,6,12,0.5,1,0.25,4,1.0,6,0.5,1.0,0.25,0.019122325043377675,0.0002915308242520797,7,3,10
gnu.regexp.RETokenWordBoundary,4,8,12,0.6666666666666666,1,0.25,2,0.5,4,0.3333333333333333,0.0,0.0,0.0904560119420234,0.0,1,3,4
org.gjt.sp.jedit.gui.AddAbbrevDialog,5,7,20,0.35,1,0.2,326,65.2,13,0.65,0.16666666666666666,0.03333333333333333,0.09138316514593027,0.0030559081856188705,2,4,6
bsh.BSHFormalParameter,6,18,30,0.6,1,0.16666666666666666,74,12.333333333333334,12,0.4,0.0,0.0,0.08523914751635447,2.3819549989127737e-05,3,5,8
com.microstar.xml.XmlParser,2,1,2,0.5,1,0.5,0,0.0,1,0.5,0.0,0.0,0.02379575311906139,8.4174392917854e-05,5,1,6
org.gjt.sp.jedit.io.VFSManager,10,17,90,0.18888888888888888,1,0.1,331,33.1,73,0.8111111111111111,0.09722222222222221,0.00972222222222222,0.0020242914979757085,0.001346790286685664,1,9,10
org.gjt.sp.jedit.OptionGroup,2,2,2,1.0,1,0.5,0,0.0,0,0.0,0.0,0.0,0.06120890740735883,0.0,4,2,6
bsh.JJTParserState,2,2,2,1.0,1,0.5,0,0.0,0,0.0,0.0,0.0,0.10078050838519144,1.4996924359580493e-05,2,1,3
bsh.StringUtil,1,0,0,0,1,1.0,-1,-1.0,0,0,0.0,0.0,0.09627850737245155,0.0,1,0,1
org.gjt.sp.jedit.options.Abbrev,1,0,0,0,1,1.0,-1,-1.0,0,0,0.0,0.0,0.04885946411254768,0.0,2,0,2
org.gjt.sp.jedit.OptionPane,1,0,0,0,1,1.0,-1,-1.0,0,0,0.0,0.0,0.07750354284372256,0.0,5,0,5
gnu.regexp.RETokenChar,4,8,12,0.6666666666666666,1,0.25,2,0.5,4,0.3333333333333333,0.0,0.0,0.09119303673330423,0.0,2,3,5
org.gjt.sp.util.WorkRequest,2,1,2,0.5,1,0.5,5,2.5,1,0.5,0.0,0.0,0.09883203991609334,0.0008261995290926647,3,1,4
org.gjt.sp.jedit.pluginmgr.InstallPluginsDialog,8,14,56,0.25,1,0.125,350,43.75,42,0.75,0.20238095238095238,0.025297619047619048,0.007129026579827495,0.001668774448212902,3,7,10
bsh.BSHCastExpression,13,68,156,0.4358974358974359,1,0.07692307692307693,74,5.6923076923076925,88,0.5641025641025641,0.0,0.0,0.0961265610951443,0.00038195106201712543,3,12,15
com.microstar.xml.HandlerBase,3,2,6,0.3333333333333333,1,0.3333333333333333,1,0.3333333333333333,4,0.6666666666666666,0.0,0.0,0.020123839009287922,5.953798523457966e-05,6,2,8
org.gjt.sp.jedit.msg.ViewUpdate,3,3,6,0.5,1,0.3333333333333333,327,109.0,3,0.5,0.0,0.0,0.01878684565665175,2.1938134460820485e-05,2,2,4
org.gjt.sp.jedit.gui.TipOfTheDay,4,5,12,0.4166666666666667,1,0.25,329,82.25,7,0.5833333333333334,0.3333333333333333,0.08333333333333333,0.002699055330634278,0.002693580573371328,1,3,4
org.gjt.sp.jedit.gui.PluginsMenu,5,4,20,0.2,1,0.2,329,65.8,16,0.8,0.0,0.0,0.0020242914979757085,0.00033122281440846606,1,4,5
bsh.BSHUnaryExpression,10,36,90,0.4,1,0.1,74,7.4,54,0.6,0.0,0.0,0.08480474642482153,1.384003043914125e-06,1,9,10
bsh.BSHReturnStatement,8,22,56,0.39285714285714285,1,0.125,74,9.25,34,0.6071428571428571,0.0,0.0,0.08480474642482153,7.566871075344542e-07,1,7,8
gnu.regexp.RETokenBackRef,4,8,12,0.6666666666666666,1,0.25,2,0.5,4,0.3333333333333333,0.0,0.0,0.0904560119420234,0.0,1,3,4
org.gjt.sp.jedit.pluginmgr.PluginList,7,16,42,0.38095238095238093,1,0.14285714285714285,344,49.142857142857146,26,0.6190476190476191,0.03333333333333333,0.0047619047619047615,0.014408192426768277,0.0005917169790341563,6,6,12
gnu.regexp.CharIndexedCharArray,2,1,2,0.5,1,0.5,0,0.0,1,0.5,0.0,0.0,0.0904560119420234,0.0,1,1,2
bsh.TargetError,6,14,30,0.4666666666666667,1,0.16666666666666666,74,12.333333333333334,16,0.5333333333333333,0.15000000000000002,0.025000000000000005,0.11848511248910983,0.0003867568152936059,14,5,19
gnu.regexp.CharIndexedInputStream,2,1,2,0.5,1,0.5,0,0.0,1,0.5,0.0,0.0,0.09053884711779449,0.0,2,1,3
bsh.BSHAllocationExpression,17,95,272,0.3492647058823529,1,0.058823529411764705,74,4.352941176470588,177,0.6507352941176471,0.0,0.0,0.08480474642482153,7.691592170001123e-06,1,16,17
bsh.BSHMethodInvocation,11,50,110,0.45454545454545453,1,0.09090909090909091,74,6.7272727272727275,60,0.5454545454545454,0.0,0.0,0.08480474642482153,3.9765783129994365e-06,1,10,11
org.gjt.sp.jedit.msg.VFSUpdate,2,1,2,0.5,1,0.5,1,0.5,1,0.5,0.0,0.0,0.02243313201035375,1.313941743107965e-05,4,1,5
bsh.BSHReturnType,6,18,30,0.6,1,0.16666666666666666,74,12.333333333333334,12,0.4,0.0,0.0,0.08504553218979831,1.1501346147490568e-05,2,5,7
bsh.BSHStatementExpressionList,6,17,30,0.5666666666666667,1,0.16666666666666666,74,12.333333333333334,13,0.43333333333333335,0.0,0.0,0.08480474642482153,2.4342861413290546e-07,1,5,6
bsh.BshMethod,12,55,132,0.4166666666666667,1,0.08333333333333333,74,6.166666666666667,77,0.5833333333333334,0.23515151515151514,0.019595959595959594,0.1144119038855881,0.004834740363725101,5,11,16
org.gjt.sp.jedit.gui.LogViewer,2,1,2,0.5,1,0.5,0,0.0,1,0.5,0.0,0.0,0.08729232904076793,2.053033973606195e-06,1,1,2
gnu.regexp.IntPair,1,0,0,0,1,1.0,-1,-1.0,0,0,0.0,0.0,0.0904560119420234,0.0,1,0,1
org.gjt.sp.jedit.io.FileVFS,6,16,30,0.5333333333333333,1,0.16666666666666666,326,54.333333333333336,14,0.4666666666666667,0.2,0.03333333333333333,0.12598090668266107,0.003495288342090054,5,5,10
org.gjt.sp.jedit.gui.EnhancedCheckBoxMenuItem,4,5,12,0.4166666666666667,1,0.25,329,82.25,7,0.5833333333333334,0.3333333333333333,0.08333333333333333,0.004048582995951417,0.0013563711118958263,2,3,5
org.gjt.sp.jedit.jEdit,36,101,1260,0.08015873015873017,1,0.027777777777777776,347,9.63888888888889,1159,0.9198412698412698,0.0,0.0,0.0,0.0,0,35,35
org.gjt.sp.jedit.msg.EditorStarted,3,3,6,0.5,1,0.3333333333333333,2,0.6666666666666666,3,0.5,0.0,0.0,0.0,0.0,0,2,2
bsh.BSHAmbiguousName,9,42,72,0.5833333333333334,1,0.1111111111111111,74,8.222222222222221,30,0.4166666666666667,0.0,0.0,0.0861214388649999,0.00010443363403855093,8,8,16
org.gjt.sp.jedit.io.FileRootsVFS,3,3,6,0.5,1,0.3333333333333333,326,108.66666666666667,3,0.5,0.0,0.0,0.10070184317067975,3.4217232893436585e-06,4,2,6
org.gjt.sp.jedit.search.RESearchMatcher,9,14,72,0.19444444444444445,1,0.1111111111111111,326,36.22222222222222,58,0.8055555555555556,0.0,0.0,0.12311002811214468,0.10571019082719939,2,8,10
org.gjt.sp.jedit.search.HyperSearchRequest,8,16,56,0.2857142857142857,1,0.125,327,40.875,40,0.7142857142857143,0.0,0.0,0.0,0.0,0,7,7
bsh.BlockNameSpace,3,4,6,0.6666666666666666,1,0.3333333333333333,74,24.666666666666668,2,0.3333333333333333,0.0,0.0,0.08242442607938073,0.0,2,2,4
org.gjt.sp.jedit.gui.InputHandler,4,8,12,0.6666666666666666,1,0.25,326,81.5,4,0.3333333333333333,0.3333333333333333,0.08333333333333333,0.14216730800566552,0.0004586575660558791,7,3,10
bsh.NameSource,1,0,0,0,1,1.0,-1,-1.0,0,0,0.0,0.0,0.115395374716799,0.0,2,0,2
org.gjt.sp.jedit.pluginmgr.Roster,3,4,6,0.6666666666666666,1,0.3333333333333333,4,1.3333333333333333,2,0.3333333333333333,0.5,0.16666666666666666,0.023796671165092216,0.0002503234994961268,8,2,10
bsh.CommandLineReader,1,0,0,0,1,1.0,-1,-1.0,0,0,0.0,0.0,0.10071323167732416,0.0,1,0,1
bsh.CallStack,3,5,6,0.8333333333333334,1,0.3333333333333333,74,24.666666666666668,1,0.16666666666666666,0.0,0.0,0.11952528506483226,0.00022216938251954803,35,2,37
org.gjt.sp.jedit.search.HyperSearchResults,9,17,72,0.2361111111111111,1,0.1111111111111111,330,36.666666666666664,55,0.7638888888888888,0.10714285714285714,0.011904761904761904,0.0020242914979757085,0.0003851980552097986,1,8,9
